,نماد,نام,تعداد,حجم,ارزش,دیروز,اولین,آخرین معامله - مقدار,آخرین معامله - تغییر,آخرین معامله - درصد,قیمت پایانی - مقدار,قیمت پایانی - تغییر,قیمت پایانی - درصد,کمترین,بیشترین
2,پالايش,صندوق پالايشي يکم-سهام,46511,66098673,4808535030590,69100,71700,74100,5000,7.24,72750,3650,5.28,70220,74400
3,كزغال,زغال سنگ پروده طبس,35903,43111697,1322196893632,31276,30338,31430,154,0.49,30669,-607,-1.94,30338,31650
4,دارا يكم,صندوق واسطه گري مالي يكم-سهام,30587,29264686,3948853983600,132630,135000,134720,2090,1.58,134940,2310,1.74,132250,137400
5,خساپا,سايپا,22879,742179565,1373596115237,1816,1860,1830,14,0.77,1851,35,1.93,1770,1919
6,فملي,ملي‌ صنايع‌ مس‌ ايران‌,19659,162813593,2108268856630,12350,12710,13090,740,5.99,12950,600,4.86,12470,13090
7,خودرو,ايران‌ خودرو,18029,635037324,1235010867838,1858,1910,1969,111,5.97,1945,87,4.68,1840,1969
8,خگستر,گسترش‌سرمايه‌گذاري‌ايران‌خودرو,15129,379617106,859455418011,2251,2265,2277,26,1.16,2264,13,0.58,2184,2349
9,بركت,گروه دارويي بركت,14131,44704900,1261764334760,27090,27500,28710,1620,5.98,28220,1130,4.17,27140,28710
10,شستا,سرمايه گذاري تامين اجتماعي,13181,62731280,694622571740,10670,10930,11110,440,4.12,11070,400,3.75,10710,11290
11,فولاد,فولاد مباركه اصفهان,12946,138985009,1760231182120,12020,12300,12740,720,5.99,12660,640,5.32,12090,12740
12,ثاميد,توسعه و عمران اميد,12939,77363166,104429336331,1332,1335,1360,28,2.1,1350,18,1.35,1313,1376
13,حكشتي,كشتيراني جمهوري اسلامي ايران,12650,50085913,809485410480,16320,15840,16100,-220,-1.35,16160,-160,-0.98,15840,17000
14,كرمان,س. توسعه و عمران استان كرمان,10092,394003227,440751912733,1122,1112,1113,-9,-0.8,1119,-3,-0.27,1095,1150
15,امينح,ح . تامين سرمايه امين,8791,6768506,31819646257,4747,4750,4662,-85,-1.79,4701,-46,-0.97,4600,4800
16,خبهمن,گروه‌بهمن‌,8234,362138485,487116601398,1337,1311,1338,1,0.07,1345,8,0.6,1300,1400
17,وبصادر,بانك صادرات ايران,7745,236478948,532666359233,2232,2240,2242,10,0.45,2252,20,0.9,2216,2319
18,وتجارت,بانك تجارت,7736,190805010,475788265786,2453,2460,2490,37,1.51,2494,41,1.67,2400,2570
19,بوعلي,پتروشيمي بوعلي سينا,7607,2847512,122115437870,42230,41910,42990,760,1.8,42880,650,1.54,41910,43200
20,شپنا,پالايش نفت اصفهان,7192,79874482,810956654220,9640,10100,10210,570,5.91,10150,510,5.29,9900,10210
21,آبادا,توليد نيروي برق آبادان,7082,3350075,40905493740,12560,12190,12190,-370,-2.95,12270,-290,-2.31,12190,12490
22,وكبهمن,مديريت سرمايه گذاري كوثربهمن,7046,2146842,22111265599,10064,10064,10335,271,2.69,10168,104,1.03,10064,10540
23,بترانس,ايران‌ ترانسفو,6467,120771841,333280399891,2744,2675,2718,-26,-0.95,2760,16,0.58,2675,2826
24,آريا,پليمر آريا ساسول,6335,3501641,315677533261,87499,89475,90516,3017,3.45,90151,2652,3.03,88903,90580
25,وخارزم,سرمايه گذاري خوارزمي,6289,62161805,280752380809,4491,4460,4570,79,1.76,4516,25,0.56,4390,4620
26,امين يكم,صندوق درآمد ثابت امين يكم فردا,6176,379848928,3844912941556,10115,10119,10122,7,0.07,10122,7,0.07,10118,10128
27,بپيوند,برق و انرژي پيوندگستر پارس,5982,3767538,42133552404,10828,10803,11200,372,3.44,11127,299,2.76,10803,11339
28,اخابر,مخابرات ايران,5751,58236709,526589374260,9270,9000,9100,-170,-1.83,9040,-230,-2.48,9000,9380
29,كمند,صندوق س. با درآمد ثابت كمند,5664,226320499,2270789817180,10027,10033,10035,8,0.08,10034,7,0.07,10033,10036
30,شتران,پالايش نفت تهران,5399,72275830,578494953130,7590,7810,8040,450,5.93,8000,410,5.4,7740,8040
31,بگيلان,توسعه مسير برق گيلان,5392,918369,18494277472,19915,19500,19970,55,0.28,19998,83,0.42,19500,20500
32,ذوب,سهامي ذوب آهن  اصفهان,5272,169695812,560692150359,3125,3250,3312,187,5.98,3304,179,5.73,3212,3312
33,وخارزمح,ح.سرمايه گذاري خوارزمي,4830,32563260,95768970093,2710,2875,3035,325,11.99,2941,231,8.52,2748,3035
34,سيتا,سرمايه گذاري سيمان تامين,4768,4642237,69744609640,15000,15000,15000,0,0,15020,20,0.13,15000,15240
35,وپاسار,بانك  پاسارگاد,4709,52791535,884819924770,16560,16700,16810,250,1.51,16760,200,1.21,16600,16810
36,امين,تامين سرمايه امين,4528,2538590,17756126420,6990,6990,7000,10,0.14,6990,0,0,6990,7050
37,ساراب,سيمان‌ داراب‌,4523,16662576,386199110530,22410,22410,22600,190,0.85,23180,770,3.44,21800,23750
38,كماسه,تامين‌ ماسه‌ ريخته‌گري‌,4154,6051791,209803131470,43680,35010,33960,-9720,-22.25,34670,-9010,-20.63,33960,37000
39,دماوند,توليد نيروي برق دماوند,4009,8483787,262792019260,30744,31020,29822,-922,-3,30976,232,0.75,29822,31530
40,وغدير,سرمايه‌گذاري‌غدير(هلدينگ‌,3694,28166023,285612236130,9680,10000,10260,580,5.99,10140,460,4.75,9700,10260
41,فارس,صنايع پتروشيمي خليج فارس,3693,28640785,247873209680,8290,8630,8740,450,5.43,8650,360,4.34,8500,8740
42,شگويا,پتروشيمي تندگويان,3515,21737003,192647699361,8423,8750,8928,505,6,8863,440,5.22,8571,8928
43,شبندر,پالايش نفت بندرعباس,3312,21648215,437959780640,19140,20240,20280,1140,5.96,20230,1090,5.69,19770,20280
44,وپارس,بانك‌پارسيان‌,3135,97370895,236934400930,2416,2436,2421,5,0.21,2433,17,0.7,2415,2490
45,ومعادنح,ح . توسعه‌معادن‌وفلزات‌,3079,21692401,117012885690,4890,5000,5470,580,11.86,5390,500,10.22,4970,5470
46,غگل,گلوكوزان‌,2718,30030574,84457247516,2746,2857,2820,74,2.69,2812,66,2.4,2730,2867
47,قرن,پديده شيمي قرن,2689,3375093,203576453450,61760,59910,61020,-740,-1.2,60320,-1440,-2.33,59910,62680
48,خصدرا,صنعتي‌ دريايي‌ ايران‌,2589,58382272,146109163608,2439,2405,2512,73,2.99,2503,64,2.62,2405,2512
49,فخوز,فولاد  خوزستان,2555,16985033,255137249680,14450,14520,15200,750,5.19,15020,570,3.94,14520,15250
50,اعتماد,صندوق س.اعتماد آفرين پارسيان-د,2415,38802900,1410619016720,36336,36356,36354,18,0.05,36353,17,0.05,36353,36357
51,ماديرا,صنايع ماشين هاي اداري ايران,2303,17147711,128698946665,7171,7310,7601,430,6,7505,334,4.66,7190,7601
52,آسيا,بيمه آسيا,2278,41676695,74748192949,1786,1739,1785,-1,-0.06,1794,8,0.45,1739,1845
53,درهآور,دارويي ره آورد تامين,2271,5491664,165238331309,42697,30510,29595,-13102,-30.69,30089,-12608,-29.53,29595,32340
54,پترول,گروه پتروشيمي س. ايرانيان,2255,21931466,189017574640,8150,8610,8630,480,5.89,8620,470,5.77,8510,8630
55,حفاري,حفاري شمال,2179,15098848,95651845490,6330,6200,6270,-60,-0.95,6340,10,0.16,6160,6490
56,كيان,صندوق س. با درآمد ثابت كيان,2131,59213332,1680192478298,28362,28376,28376,14,0.05,28375,13,0.05,28374,28379
57,صبا,سرمايه گذاري صبا تامين,2127,10130363,77641295793,7427,7450,7700,273,3.68,7577,150,2.02,7450,7800
58,غسالم,سالمين‌,2021,19474699,75185162369,3961,3843,3844,-117,-2.95,3861,-100,-2.52,3843,3997
59,ومعادن,توسعه‌معادن‌وفلزات‌,1999,32965893,244109901170,7000,7290,7420,420,6,7400,400,5.71,7110,7420
60,شبريز,پالايش نفت تبريز,1977,12245861,316997641190,24490,24700,25950,1460,5.96,25890,1400,5.72,23900,25950
61,نوري,پتروشيمي نوري,1959,3354807,196174436650,55420,55830,58740,3320,5.99,58480,3060,5.52,55830,58740
62,بجهرم,توسعه مولد نيروگاهي جهرم,1941,26106884,58743291313,2148,2255,2276,128,5.96,2250,102,4.75,2185,2276
63,فباهنرح,ح . مس‌ شهيدباهنر,1840,6895958,114427319260,16290,16150,16910,620,3.81,16590,300,1.84,15870,17100
64,آگاس,صندوق س.هستي بخش آگاه-س,1827,1740888,111426650052,62312,63390,64690,2378,3.82,64006,1694,2.72,62550,64900
65,تملت,تامين سرمايه بانك ملت,1785,8441596,41567889295,4836,4899,4994,158,3.27,4910,74,1.53,4726,5036
66,رمپنا,گروه مپنا (سهامي عام),1754,8133684,119376856620,14660,14350,14390,-270,-1.84,14680,20,0.14,14230,15290
67,سرو,صندوق س سروسودمند مدبران-سهام,1719,2122167,133214057270,60830,62100,63760,2930,4.82,62770,1940,3.19,61500,63870
68,وساپا,سرمايه‌گذاري‌ سايپا,1709,32883130,154186067035,4434,4679,4700,266,6,4689,255,5.75,4570,4700
69,وبوعلي,سرمايه‌گذاري‌بوعلي‌,1695,17876169,104738460480,5660,5800,5960,300,5.3,5860,200,3.53,5700,5990
70,ونوين,بانك‌اقتصادنوين‌,1675,26415637,114120099905,4231,4320,4338,107,2.53,4320,89,2.1,4130,4450
71,تسه0001,امتيازتسهيلات مسكن فروردين1400,1642,51641,27981346961,540033,543600,543000,2967,0.55,541844,1811,0.34,536100,550000
72,آوا,صندوق س.سهام آواي معيار-س,1635,13523992,89171996979,6432,6501,6592,160,2.49,6594,162,2.52,6458,6698
73,سشرق,سيمان‌ شرق‌,1618,10527920,61186876240,5930,5760,5770,-160,-2.7,5810,-120,-2.02,5760,5940
74,واعتبار,سرمايه گذاري اعتبار ايران,1590,34241469,339768951110,9410,9970,9970,560,5.95,9920,510,5.42,9160,9970
75,واميدح,ح.گروه مديريت سرمايه گذار اميد,1542,18786879,123128286160,6510,6120,6860,350,5.38,6550,40,0.61,6120,7050
76,كارين,صندوق س نگين سامان-ثابت,1435,71770695,726178848842,10114,10121,10120,6,0.06,10118,4,0.04,10116,10121
77,فوكا,فولاد كاويان,1422,11100345,126699337830,11889,11414,11414,-475,-4,11414,-475,-4,11414,11414
78,واتي,سرمايه‌ گذاري‌ آتيه‌ دماوند,1381,17980882,176779097720,10130,9830,9830,-300,-2.96,9830,-300,-2.96,9830,10000
79,حتايد,تايدواترخاورميانه,1343,6019435,149932707460,25380,24620,25500,120,0.47,24910,-470,-1.85,24620,25700
80,كاوه,فولاد كاوه جنوب كيش,1341,7620511,151505101950,19290,19760,20100,810,4.2,19880,590,3.06,19300,20230
81,فباهنر,مس‌ شهيدباهنر,1306,3563106,84102691240,22850,23500,24220,1370,6,23600,750,3.28,22900,24220
82,فجر,فولاد اميركبيركاشان,1265,3910208,231395124360,56170,56500,59540,3370,6,59180,3010,5.36,56500,59540
83,فسپا,گروه‌صنعتي‌سپاهان‌,1256,2839531,97633710350,34680,33640,34400,-280,-0.81,34380,-300,-0.87,33640,35770
84,وسينا,بانك سينا,1255,26346547,69249233633,2608,2550,2660,52,1.99,2628,20,0.77,2540,2727
85,شيران,س. صنايع‌شيميايي‌ايران,1252,6300056,128317677970,19300,19520,20450,1150,5.96,20370,1070,5.54,19520,20450
86,تاپيكو,س. نفت و گاز و پتروشيمي تأمين,1239,8859196,89985129520,9830,9910,10150,320,3.26,10070,240,2.44,9900,10290
87,تاصيكو,سرمايه گذاري صدرتامين,1232,13078647,130402097380,9750,9950,9990,240,2.46,9970,220,2.26,9610,10130
88,شبهرن,نفت‌ بهران‌,1163,5724489,62559918750,10460,10850,11080,620,5.93,10930,470,4.49,10500,11080
89,والبر,سرمايه‌ گذاري‌ البرز(هلدينگ‌,1141,6372671,98946703330,16000,15520,15590,-410,-2.56,15530,-470,-2.94,15520,15670
90,ولساپا,ليزينگ رايان‌ سايپا,1127,33329211,106792861883,3303,3204,3208,-95,-2.88,3204,-99,-3,3204,3214
91,فپنتا,سپنتا,1112,372029,142171185150,405860,381510,381510,-24350,-6,382150,-23710,-5.84,381510,392000
92,ضسپا3004,اختيارخ خساپا-2500-1400/03/26,1109,60117,847037000,12,18,16,4,33.33,14,2,16.67,9,21
93,سمازن,سيمان‌مازندران‌,1102,6039726,73234976780,12100,11880,12350,250,2.07,12130,30,0.25,11840,12370
94,فنوال,نورد آلومينيوم‌,1082,1727080,47476469330,27180,27010,27370,190,0.7,27460,280,1.03,26750,28310
95,كروي,توسعه‌ معادن‌ روي‌ ايران‌,1080,2893687,72497609670,24930,24200,25000,70,0.28,25050,120,0.48,24200,26000
96,كچاد,معدني‌وصنعتي‌چادرملو,1069,4238221,88461674250,20270,21170,21200,930,4.59,20710,440,2.17,20560,21200
97,طلا,صندوق س.پشتوانه طلاي لوتوس,1051,1252512,89920593411,69824,72223,71730,1906,2.73,71792,1968,2.82,71100,72500
98,شاوان,پالايش نفت لاوان,1051,1391444,113214510746,82011,79551,82250,239,0.29,81365,-646,-0.79,79551,84960
99,فاسمين,كالسيمين‌,1048,7198559,101887646560,13450,13980,14250,800,5.95,14150,700,5.2,13620,14250
100,وثوق,سرمايه گذاري وثوق امين,1043,2098853,34077476954,16516,16187,16186,-330,-2,16236,-280,-1.7,16186,16706
101,ثمسكن,سرمايه‌گذاري‌ مسكن‌,1035,12411993,59581903261,4930,4783,4783,-147,-2.98,4800,-130,-2.64,4783,4929
102,فايرا,آلومينيوم‌ايران‌,1023,4641324,84730017420,18080,18490,18340,260,1.44,18260,180,1,18000,18630
103,خريخت,صنايع‌ريخته‌گري‌ايران‌,1019,10488921,30066422635,2925,2838,2844,-81,-2.77,2889,-36,-1.23,2838,2958
104,پارسان,گسترش نفت و گاز پارسيان,1015,7689380,137239224880,17250,17200,18210,960,5.57,17850,600,3.48,17200,18250
105,سفارس,سيمان فارس و خوزستان,1003,4340847,64844979770,14270,14300,15120,850,5.96,14940,670,4.7,14300,15120
106,كگل,معدني و صنعتي گل گهر,1001,8008642,110262827790,13220,13550,13990,770,5.82,13710,490,3.71,13400,14000
107,مدير,ص.س.مديريت ثروت ص.بازنشستگي-س,966,4593315,36282919792,7662,7710,7957,295,3.85,7899,237,3.09,7700,8012
108,آكورد,صندوق س. آرمان آتي كوثر-د,965,9790919,313434638382,31998,32013,32001,3,0.01,32013,15,0.05,32000,32020
109,ومهان,گروه توسعه مالي مهر آيندگان,936,5678788,69995081833,12049,12518,12480,431,3.58,12326,277,2.3,12000,12670
110,شصدف,صنعتي دوده فام,914,72184,2391095000,31250,33125,33125,1875,6,31334,84,0.27,33125,33125
111,ونيكي,سرمايه‌گذاري‌ ملي‌ايران‌,910,3328849,26480256540,7820,7820,7980,160,2.05,7880,60,0.77,7800,8080
112,ارزش,صندوق س ارزش آفرين بيدار-سهام,891,6385953,57934346840,8910,9160,9070,160,1.8,9070,160,1.8,8970,9160
113,دالبرح,ح . البرزدارو,881,1315160,10876297390,8190,8120,8260,70,0.85,8270,80,0.98,8120,8480
114,كگلح,ح . معدني و صنعتي گل گهر,864,3473474,36940478790,10080,10140,10900,820,8.13,10640,560,5.56,10140,10930
115,ضسپا3002,اختيارخ خساپا-1800-1400/03/26,863,37845,3877973000,78,85,105,27,34.62,102,24,30.77,76,129
116,پاكشو,گروه صنعتي پاكشو,859,6281985,40594951360,6280,6500,6360,80,1.27,6340,60,0.96,6330,6650
117,پارند,صندوق س. پارند پايدار سپهر,859,19647304,219888952092,11198,11206,11192,-6,-0.05,11192,-6,-0.05,11190,11206
118,هرمز,فولاد هرمزگان جنوب,858,4926973,74365381944,14685,15000,15350,665,4.53,14937,252,1.72,14700,15350
119,زاگرس,پتروشيمي زاگرس,856,425558,86725236037,196092,198000,206560,10468,5.34,202555,6463,3.3,198000,207800
120,شكلر,نيروكلر,853,2534490,108665397450,46980,43500,42200,-4780,-10.17,42870,-4110,-8.75,42200,43700
121,دعبيد,لابراتوارداروسازي‌  دكترعبيدي‌,852,2399653,59120230820,25280,24810,24530,-750,-2.97,24640,-640,-2.53,24530,25280
122,ارفع,شركت آهن و فولاد ارفع,794,4296407,59652282706,13349,13760,14000,651,4.88,13828,479,3.59,13220,14130
123,وصنعت,سرمايه گذاري توسعه صنعت وتجارت,787,5452979,31319373550,5580,5770,5800,220,3.94,5680,100,1.79,5580,5830
124,حتوكا,حمل‌ونقل‌توكا,779,2396361,51429644900,30440,21570,20930,-9510,-31.24,21460,-8980,-29.5,20930,22850
125,افران,صندوق س افرا نماد پايدار-ثابت,764,26562977,352944209857,13287,13287,13287,0,0,13287,0,0,13287,13291
126,زگلدشتح,ح.كشت و دام گلدشت نمونه اصفهان,758,3779206,22480438366,5896,5820,5980,84,1.42,5948,52,0.88,5732,6133
127,بپاس,بيمه پاسارگاد,731,430029,37632211170,86868,87080,88600,1732,1.99,87112,244,0.28,86868,88700
128,ميدكو,هلدينگ صنايع  معدني خاورميانه,724,10149862,338337131337,32867,32075,33900,1033,3.14,33334,467,1.42,32075,33991
129,كگهر,سنگ آهن گهرزمين,718,709360,30235354120,41960,43500,42756,796,1.9,42128,168,0.4,40996,43890
130,ما,بيمه  ما,714,4592924,35950698920,7530,7750,7980,450,5.98,7730,200,2.66,7600,7980
131,همراه,شركت ارتباطات سيار ايران,711,1677779,38451708170,22640,22650,22900,260,1.15,22750,110,0.49,22640,23190
132,دلرح,ح . داروسازي‌ اكسير,705,21506693,527062194500,24780,25000,24500,-280,-1.13,24510,-270,-1.09,24500,25000
133,شپلي,پلي اكريل ايران,701,5953364,47266378775,8065,7904,7904,-161,-2,7939,-126,-1.56,7904,8100
134,فردا,صندوق س آواي فرداي زاگرس-ثابت,701,32405525,345603495059,10658,10664,10665,7,0.07,10665,7,0.07,10664,10666
135,سپاها,سيمان‌سپاهان‌,696,4609818,36547948930,8030,7850,7880,-150,-1.87,7950,-80,-1,7790,8110
136,تسه9912,امتياز تسهيلات مسكن اسفند99,678,14310,7862267238,546751,560000,546621,-130,-0.02,549425,2674,0.49,530000,560000
137,شسپا,نفت سپاهان,672,4191766,61877177670,14010,14270,14850,840,6,14760,750,5.35,13910,14850
138,شغدير,پتروشيمي غدير,652,2915853,183705760230,59550,60600,63120,3570,5.99,63000,3450,5.79,60600,63120
139,تصميم,صندوق س با درآمد ثابت تصميم,647,9353906,152457486372,16275,16276,16299,24,0.15,16299,24,0.15,16062,16320
140,ضسپا3003,اختيارخ خساپا-2000-1400/03/26,644,31243,1611291000,38,55,60,22,57.89,52,14,36.84,38,70
141,جم,پتروشيمي جم,636,1889679,66390398990,35060,34500,35070,10,0.03,35110,50,0.14,34500,35540
142,شفن,پتروشيمي فناوران,635,160882,48985418960,304630,298900,302080,-2550,-0.84,304550,-80,-0.03,298310,312000
143,وبانك,سرمايه گذاري گروه توسعه ملي,628,2311060,17429986090,7390,7350,7550,160,2.17,7420,30,0.41,7350,7680
144,افق,فروشگاههاي زنجيره اي افق كوروش,625,1089441,74795851450,67470,66010,69190,1720,2.55,68550,1080,1.6,66010,69500
145,شپديس,پتروشيمي پرديس,613,539517,49897643270,90020,91000,92520,2500,2.78,91240,1220,1.36,90500,93810
146,وسكاب,س.ص.بازنشستگي كاركنان بانكها,604,3947649,19098937925,4736,4870,4900,164,3.46,4775,39,0.82,4700,4900
147,لوتوس,تامين سرمايه لوتوس پارسيان,596,17565209,148613523410,8720,8500,8490,-230,-2.64,8460,-260,-2.98,8460,8560
148,وتوس,توسعه‌شهري‌توس‌گستر,577,3060749,39866966740,13410,13020,13020,-390,-2.91,13080,-330,-2.46,13010,13410
149,شفارا,پتروشيمي فارابي,566,11598232,45346224034,3798,3911,3911,113,2.98,3910,112,2.95,3845,3911
150,فنورد,نوردوقطعات‌ فولادي‌,559,221044,32941312770,148250,149990,150500,2250,1.52,148770,520,0.35,145720,154890
151,فولاژ,فولاد آلياژي ايران,557,1293792,20296654740,15980,16000,15520,-460,-2.88,15890,-90,-0.56,15520,16000
152,وساخت,سرمايه‌ گذاري‌ ساختمان‌ايران‌,556,464746,20379660250,43000,43000,44690,1690,3.93,43370,370,0.86,43000,45000
153,گشان,توسعه بين المللي پديده شانديز,553,2026330,43470857490,22346,21453,21453,-893,-4,21453,-893,-4,21453,21453
154,بموتو,موتوژن‌,548,384991,19785998970,52040,50710,51040,-1000,-1.92,51780,-260,-0.5,50670,54900
155,فخاس,فولاد خراسان,546,2674457,66671592800,25680,24910,24910,-770,-3,25150,-530,-2.06,24910,25590
156,كنور,توسعه معدني و صنعتي صبانور,540,1139308,55804130010,47900,48000,48500,600,1.25,48950,1050,2.19,47730,50400
157,تيپيكو,سرمايه گذاري دارويي تامين,530,1698584,58163767100,34000,35000,34560,560,1.65,34240,240,0.71,33930,35000
158,تماوند,تامين سرمايه دماوند,526,12644551,68115575284,5487,5378,5420,-67,-1.22,5387,-100,-1.82,5378,5550
159,پارسيان,بيمه پارسيان,526,9757354,90830427620,9580,9300,9300,-280,-2.92,9310,-270,-2.82,9300,9500
160,كرماشا,صنايع پتروشيمي كرمانشاه,523,928053,29970354010,32270,32270,31650,-620,-1.92,32280,10,0.03,31500,33410
161,وصندوق,سرمايه‌گذاري‌صندوق‌بازنشستگي‌,521,5711911,79624808340,13910,13710,13800,-110,-0.79,13930,20,0.14,13700,14090
162,خكرمان,گروه اقتصادي كرمان خودرو,519,6621194,22254961501,3283,3273,3381,98,2.99,3361,78,2.38,3273,3381
163,سباقر,سيمان باقران,516,2183138,33409799390,15918,15282,15320,-598,-3.76,15304,-614,-3.86,15282,15615
164,وبشهر,توسعه‌ صنايع‌ بهشهر(هلدينگ,515,4839058,49136451950,9960,10480,10160,200,2.01,10150,190,1.91,9960,10480
165,كاريس,صندوق س.سپهر كاريزما-س,511,2499018,26628523873,10325,10359,10740,415,4.02,10656,331,3.21,10326,10790
166,فسازان,غلتك سازان سپاهان,509,641451,20587863340,31770,31070,32240,470,1.48,31910,140,0.44,31070,33000
167,سخوز,سيمان خوزستان,508,1345837,27833415260,20510,20020,21090,580,2.83,20610,100,0.49,20020,21160
168,اطلس,صندوق س.توسعه اندوخته آينده-س,499,210170,41024267555,191183,192100,198000,6817,3.57,195196,4013,2.1,191501,198500
169,كيان2,صندوق س. با درآمد ثابت كيان,490,49000000,49000000,28362,1,1,-28361,-100,1,-28361,-100,1,1
170,ورازي,بيمه رازي,490,3733408,29698598109,7710,7710,8095,385,4.99,7955,245,3.18,7710,8095
171,شيراز,پتروشيمي‌شيراز,488,1668276,83760748590,51360,50000,50000,-1360,-2.65,50350,-1010,-1.97,49820,52200
172,البرز,بيمه البرز,483,13780897,49953800175,3420,3625,3625,205,5.99,3614,194,5.67,3570,3625
173,درازك,دارويي‌ رازك‌,479,1054473,31232353030,30250,29350,30510,260,0.86,29840,-410,-1.36,29350,31900
174,كاردان,صندوق س تجارت شاخصي كاردان,465,263924,38691104360,141650,144100,147000,5350,3.78,146600,4950,3.49,142850,147990
175,وتوسم,سرمايه‌گذاري‌توسعه‌ملي‌,461,1678777,12755841480,7690,7560,7610,-80,-1.04,7670,-20,-0.26,7560,7680
176,تماوندح,ح . تامين سرمايه دماوند,458,10347865,39976935703,1000,3940,3862,2862,286.2,3863,2863,286.3,3862,3940
177,تسه9911,امتياز تسهيلات مسكن بهمن99,448,7784,4231906429,540925,545000,541000,75,0.01,543667,2742,0.51,521009,559990
178,كاما,باما,441,1586479,17958942280,11660,11320,11320,-340,-2.92,11530,-130,-1.11,11320,11320
179,شساخت,مهندسي و ساختمان صنايع نفت,440,960852,40600658666,41587,40760,42833,1246,3,42224,637,1.53,40760,42833
180,سكه0012پ01,سكه تمام بهارتحويلي 1روزه رفاه,439,157900,156549746400,974096,1001000,987500,13404,1.38,991449,17353,1.78,982000,1001000
181,شخارك,پتروشيمي‌ خارك‌,437,849739,36263624380,42860,42000,42330,-530,-1.24,42790,-70,-0.16,42000,43440
182,وثنو,سرمايه گذاري ساختماني نوين,435,7255854,33555284074,4718,4624,4625,-93,-1.97,4625,-93,-1.97,4624,4699
183,وسپه,سرمايه‌گذاري‌ سپه‌,434,2681453,16946533930,6290,6200,6340,50,0.79,6300,10,0.16,6200,6490
184,تسه9908,امتياز تسهيلات مسكن آبان99,433,11354,6171408946,539585,531600,540000,415,0.08,543545,3960,0.73,525000,559700
185,سپ,پرداخت الكترونيك سامان كيش,431,1423401,31536941290,21670,21540,22690,1020,4.71,21970,300,1.38,21540,22800
186,ضخود7075,اختيارخ خودرو-2000-1400/07/07,431,19940,4302037000,183,209,222,39,21.31,216,33,18.03,180,239
187,سشمال,سيمان‌ شمال‌,426,1493239,14021266650,9660,9380,9380,-280,-2.9,9580,-80,-0.83,9380,9570
188,بساما,بيمه سامان,424,2993651,62482356660,21514,20869,20875,-639,-2.97,20872,-642,-2.98,20869,21033
189,شاراك,پتروشيمي شازند,422,1209001,30754198720,25110,25220,25280,170,0.68,25230,120,0.48,25130,25950
190,ونفت,سرمايه‌گذاري‌ صنعت‌ نفت‌,417,1611236,21967564290,13300,13940,13700,400,3.01,13450,150,1.13,13360,13940
191,كلوند,كاشي‌ الوند,413,1076478,23230395240,20360,21580,21580,1220,5.99,21580,1220,5.99,21580,21580
192,سمتاز,سيمان ممتازان كرمان,400,526557,12329233136,23817,24317,23341,-476,-2,23574,-243,-1.02,23341,24317
193,پكرمان,گروه‌ صنعتي‌ بارز,390,1274349,30613391700,23990,24000,23860,-130,-0.54,24010,20,0.08,23390,24700
194,دسبحانح,ح. سبحان دارو,375,157735,1757007890,11050,11200,11210,160,1.45,11140,90,0.81,10880,11330
195,سامان,بانك سامان,367,3557514,30470703682,8332,8500,8581,249,2.99,8512,180,2.16,8380,8581
196,شجم,صنايع پتروشيمي تخت جمشيد,367,11893573,117127906904,10258,9848,9848,-410,-4,9848,-410,-4,9848,9848
197,حسينا,توسعه خدمات دريايي وبندري سينا,364,451251,26247091357,56521,57700,58221,1700,3.01,57383,862,1.53,56720,58800
198,شوينده,مديريت صنعت شوينده ت.ص.بهشهر,363,990482,24777154090,25760,24990,25000,-760,-2.95,25380,-380,-1.48,24990,25580
199,سرود,سيمان‌شاهرود,363,1670239,28160406160,16690,16300,16810,120,0.72,16790,100,0.6,16270,17200
200,شرانل,نفت ايرانول,360,1064104,40788852956,37962,37600,38990,1028,2.71,38271,309,0.81,37600,39490
201,دمعيار,صندوق س. توازن معيار-د,355,17042259,172212261209,10100,10110,10105,5,0.05,10105,5,0.05,10104,10110
202,شپاكسا,پاكسان‌,354,2678864,70159839580,26990,26190,26190,-800,-2.96,26190,-800,-2.96,26190,26310
203,پارس,پتروشيمي پارس,351,202460,28927748790,141140,143270,143000,1860,1.32,141640,500,0.35,142070,143990
204,شلعابح,ح . لعابيران‌,344,3550353,28645896450,8520,9300,8010,-510,-5.99,8070,-450,-5.28,8010,9300
205,گوهر,صندوق سكه طلاي كيان,343,528316,26046694166,48136,49079,47999,-137,-0.28,49301,1165,2.42,47950,50600
206,ياقوت,صندوق س ياقوت آگاه-ثابت,340,2143954,26480592085,12350,12368,12349,-1,-0.01,12351,1,0.01,12349,12368
207,وخاور,بانك خاورميانه,335,2590952,21758755130,8300,8300,8400,100,1.2,8340,40,0.48,8300,8480
208,شراز,پالايش نفت شيراز,335,220640,23221636028,106766,103564,105997,-769,-0.72,106023,-743,-0.7,103564,109942
209,خديزل,بهمن  ديزل,334,469317,18368668554,38641,37500,39270,629,1.63,38826,185,0.48,37500,40500
210,عيار,صندوق س. پشتوانه طلاي مفيد,332,240497,6165948619,25013,25800,25200,187,0.75,25638,625,2.5,25049,26379
211,شبصير,توليدات پتروشيمي قائد بصير,331,208779,14070309037,65402,63500,67000,1598,2.44,65958,556,0.85,63500,69320
212,تنوين,تامين سرمايه نوين,324,4752121,34369599690,7210,7210,7210,0,0,7230,20,0.28,7190,7320
213,بفجر,فجر انرژي خليج فارس,322,1103849,24090935750,20980,21390,22000,1020,4.86,21340,360,1.72,21110,22230
214,ضجار2002,اختيارخ وتجارت-2500-1400/02/22,320,17843,291870000,23,11,9,-14,-60.87,16,-7,-30.43,7,29
215,واحيا,م .صنايع و معادن احياء سپاهان,318,418925,62149413942,144052,148373,148373,4321,3,148355,4303,2.99,147000,148373
216,آساميد,صندوق س.مشترك آسمان اميد -د,312,13887952,166645102462,11994,11997,11999,5,0.04,11999,5,0.04,11997,12004
217,گوهران,سرمايه گذاري توسعه گوهران اميد,311,1277413,8924346989,6889,6995,6989,100,1.45,6906,17,0.25,6800,7190
218,مبين,مبين انرژي خليج فارس,309,1265044,20132435720,15450,15470,16070,620,4.01,15530,80,0.52,15460,16300
219,سحرخيز,صندوق س. گروه زعفران سحرخيز,304,878616,7437663408,8641,8570,8396,-245,-2.84,8465,-176,-2.04,8321,8580
220,فردا2,صندوق س آواي فرداي زاگرس-ثابت,300,30000000,30000000,10658,1,1,-10657,-99.99,1,-10657,-99.99,1,1
221,وكار,بانك‌ كارآفرين‌,296,6869865,19236461297,2884,2882,2798,-86,-2.98,2850,-34,-1.18,2798,2882
222,سيدكو,سرمايه گذاري توسعه صنايع سيمان,289,1190788,6939185790,5710,5630,5780,70,1.23,5730,20,0.35,5630,5920
223,فيروزه,صندوق شاخص30 شركت فيروزه- سهام,284,176580,22928124710,126170,128900,130430,4260,3.38,129850,3680,2.92,128000,131500
224,زر,صندوق س.پشتوانه سكه طلاي زر,281,177754,7580544302,41571,43000,42050,479,1.15,42646,1075,2.59,42030,43860
225,خزاميا,زامياد,280,1617143,13713372640,8740,8480,8480,-260,-2.97,8670,-70,-0.8,8480,8480
226,وحكمت,بيمه حكمت صبا,277,3191477,10581177952,3377,3310,3311,-66,-1.95,3343,-34,-1.01,3310,3374
227,تسه9910,امتياز تسهيلات مسكن دي99,274,3785,2060917067,542296,546000,558000,15704,2.9,544496,2200,0.41,530556,568999
228,تسه9909,امتياز تسهيلات مسكن آذر99,273,4774,2605293049,542393,535500,541000,-1393,-0.26,545725,3332,0.61,524600,569000
229,شنفت,نفت‌ پارس‌,270,258211,12362017520,46590,46600,48240,1650,3.54,46900,310,0.67,45450,48500
230,وهور,مديريت انرژي اميد  تابان هور,263,8131905,15962929515,2023,1963,1963,-60,-2.97,2005,-18,-0.89,1963,1963
231,فروي,ذوب روي اصفهان,257,207210,11430739650,56871,55165,55165,-1706,-3,56467,-404,-0.71,55165,55165
232,پرداخت,به پرداخت ملت,243,1558255,38305667670,31590,24990,24250,-7340,-23.24,24580,-7010,-22.19,24250,24990
233,اتكام,شركت بيمه اتكايي امين,240,1421126,6570611394,4745,4603,4710,-35,-0.74,4729,-16,-0.34,4603,4786
234,ضخود4002,اختيارخ خودرو-1800-1400/04/02,238,14587,2636324000,129,199,192,63,48.84,181,52,40.31,135,210
235,آساس,صندوق س.آسمان آرماني سهام-س,234,79126,12789115593,158617,160001,163080,4463,2.81,161630,3013,1.9,158804,163500
236,ختوقا,قطعات‌ اتومبيل‌ ايران‌,230,8020991,19515071103,2508,2433,2433,-75,-2.99,2478,-30,-1.2,2433,2433
237,خمحركه,نيرو محركه‌,225,5072866,22488014978,4570,4433,4433,-137,-3,4506,-64,-1.4,4433,4433
238,ضملي3003,اختيارخ فملي-12000-1400/03/02,221,3855,3743567000,530,501,1192,662,124.91,971,441,83.21,501,1192
239,سكرما,سيمان‌ كرمان‌,220,616931,9214692140,15310,14860,14950,-360,-2.35,15240,-70,-0.46,14860,15290
240,تسه9803,امتياز تسهيلات مسكن خرداد98,209,3847,2062959002,536582,512222,533000,-3582,-0.67,536251,-331,-0.06,512222,548000
241,ثباغ,شهر سازي و خانه سازي باغميشه,203,1355852,19887596564,15120,14667,14667,-453,-3,14933,-187,-1.24,14667,14960
242,ضخود7074,اختيارخ خودرو-1800-1400/07/07,203,9094,2900362000,234,289,347,113,48.29,319,85,36.32,260,360
243,خودكفا,اقتصادي و خودكفايي آزادگان,193,867776,15002111488,18008,17288,17288,-720,-4,17717,-291,-1.62,17288,17288
244,دلر,داروسازي‌ اكسير,189,109668,3733055990,35000,33950,33950,-1050,-3,34930,-70,-0.2,33950,35450
245,ارمغان,ص سرمايه گذاري ارمغان ايرانيان,183,4292475,43085492555,10022,10033,10039,17,0.17,10037,15,0.15,10026,10045
246,تسه9902,امتياز تسهيلات مسكن ارديبهشت99,173,2836,1536973002,543535,545000,533222,-10313,-1.9,541951,-1584,-0.29,527777,570711
247,اخزا910,اسنادخزانه-م10بودجه99-020807,169,194597,117586672920,607104,606118,603000,-4104,-0.68,604257,-2847,-0.47,600000,606500
248,ونيرو,سرمايه‌گذاري‌نيرو,167,7494256,18720651488,2575,2498,2498,-77,-2.99,2545,-30,-1.17,2498,2498
249,آريان,سرمايه گذاري پارس آريان,163,7927354,80201040418,9636,10117,10117,481,4.99,10117,481,4.99,10117,10117
250,پكوير,كوير تاير,162,662144,8005320960,12860,12090,12090,-770,-5.99,12730,-130,-1.01,12090,12090
251,بمپنا,توليد برق عسلويه  مپنا,160,128099,8730999038,70259,68152,68152,-2107,-3,69881,-378,-0.54,68152,70000
252,مارون,پتروشيمي مارون,159,109208,15957792328,147758,149148,147493,-265,-0.18,147491,-267,-0.18,143801,149148
253,تسه9810,امتياز تسهيلات مسكن دي98,150,2777,1503188621,533796,540000,548666,14870,2.79,541299,7503,1.41,522724,550000
254,تسه9907,امتياز تسهيلات مسكن مهر99,146,1913,1039832858,539781,521000,520000,-19781,-3.66,543561,3780,0.7,520000,566000
255,شصفها,پتروشيمي‌ اصفهان‌,143,69133,8706748962,124605,122150,127096,2491,2,125375,770,0.62,122113,127097
256,خراسان,پتروشيمي خراسان,142,101664,6981907150,67920,66210,69050,1130,1.66,68030,110,0.16,66210,70980
257,خاتم,صندوق س خاتم ايساتيس پويا-ثابت,141,3292535,36512309191,11084,11087,11090,6,0.05,11089,5,0.05,11087,11098
258,فاراك,ماشين‌ سازي‌ اراك‌,141,3000600,6955390800,2389,2318,2318,-71,-2.97,2379,-10,-0.42,2318,2318
259,تسه9903,امتياز تسهيلات مسكن خرداد99,140,2840,1538620667,544960,527644,559999,15039,2.76,541768,-3192,-0.59,520000,559999
260,ضخود7077,اختيارخ خودرو-3000-1400/07/07,138,8278,517140000,47,55,64,17,36.17,62,15,31.91,53,71
261,نهال,صندوق س. طلاي سرخ نوويرا,138,173545,1550462950,8904,9000,8800,-104,-1.17,8934,30,0.34,8800,9056
262,اتكاي,بيمه اتكايي ايرانيان,133,294146,4676723608,16282,16400,16200,-82,-0.5,16245,-37,-0.23,15794,16500
263,سپاس,صندوق س. پاداش سهامداري توسعه1,133,3606152,36184831541,10029,10033,10035,6,0.06,10034,5,0.05,10032,10036
264,لبوتان,گروه‌صنعتي‌بوتان‌,133,156291,8975409730,59170,59000,57420,-1750,-2.96,58840,-330,-0.56,57400,59000
265,چكاپا,گروه صنايع كاغذ پارس,131,871895,4394350800,5190,5040,5040,-150,-2.89,5180,-10,-0.19,5040,5040
266,شكبير,پتروشيمي اميركبير,128,401173,33111671951,82617,84940,83000,383,0.46,82590,-27,-0.03,80965,84940
267,ضپاس2002,اختيارخ وپارس-3000-1400/02/29,123,6279,6838000,2,1,1,-1,-50,1,-1,-50,1,2
268,دقاضيح,ح . داروسازي شهيد قاضي,120,1679960,42357701000,25824,26400,25200,-624,-2.42,25214,-610,-2.36,25200,27373
269,ضخود7072,اختيارخ خودرو-1400-1400/07/07,119,1355,890849000,585,660,710,125,21.37,657,72,12.31,600,710
270,بكهنوج,توليد برق ماهتاب كهنوج,119,1712049,2715309714,1635,1586,1586,-49,-3,1632,-3,-0.18,1586,1586
271,وصنا,گروه‌صنايع‌بهشهرايران‌,119,2285180,12499934600,5630,5470,5470,-160,-2.84,5590,-40,-0.71,5470,5470
272,كدما,معدني‌ دماوند,118,117855,11158511400,97600,94680,94680,-2920,-2.99,96920,-680,-0.7,94680,94680
273,وبازار,صندوق س شاخصي بازارآشنا,116,365339,3342635190,9060,9240,9120,60,0.66,9150,90,0.99,9100,9240
274,تسه9904,امتياز تسهيلات مسكن تير99,115,1401,760652374,540230,525651,537000,-3230,-0.6,542935,2705,0.5,525651,559000
275,اخزا902,اسنادخزانه-م2بودجه99-011019,113,340843,242533805261,713355,716300,710000,-3355,-0.47,711570,-1785,-0.25,709100,716300
276,دارا,صندوق س. دارا الگوريتم-د,112,2553844,25611882919,10041,10049,10030,-11,-0.11,10029,-12,-0.12,10015,10049
277,كتوكا,توليدي و خدمات صنايع نسوز توكا,111,400494,9611856000,38994,24000,24000,-14994,-38.45,34308,-4686,-12.02,24000,24000
278,ضخود7076,اختيارخ خودرو-2500-1400/07/07,108,3900,542404000,110,130,138,28,25.45,139,29,26.36,113,169
279,ثاخت,بين‌المللي‌توسعه‌ساختمان,108,948074,2264948786,2462,2389,2389,-73,-2.97,2459,-3,-0.12,2389,2389
280,وپست,پست بانك ايران,106,2664308,52433581440,20280,19680,19680,-600,-2.96,19680,-600,-2.96,19680,19680
281,خرينگ,رينگ‌سازي‌مشهد,104,118004,5811697000,52390,49250,49250,-3140,-5.99,52000,-390,-0.74,49250,49250
282,صايند,صندوق س. گنجينه آينده روشن-د,104,668420,6479270370,9727,9746,9698,-29,-0.3,9693,-34,-0.35,9662,9746
283,شلرد,كود شيميايي اوره لردگان,104,2986092,20335286520,6306,6810,6810,504,7.99,6724,418,6.63,6810,6810
284,وپويا,سرمايه گذاري پويا,102,858963,5339314008,6408,6216,6216,-192,-3,6387,-21,-0.33,6216,6216
285,جوين,كشت و صنعت جوين,101,4406780,21046781280,4974,4776,4776,-198,-3.98,4776,-198,-3.98,4776,4776
286,گكوثر,هتل پارسيان كوثر اصفهان,99,1126134,2500017480,2288,2220,2220,-68,-2.97,2284,-4,-0.17,2220,2220
287,ضشنا2002,اختيارخ شپنا-12000-1400/02/27,98,3770,109453000,14,5,34,20,142.86,29,15,107.14,5,45
288,آتيمس,صندوق س.آرمان آتيه درخشان مس-س,97,21679,3764109243,172153,172000,174499,2346,1.36,173629,1476,0.86,172000,175936
289,ثبهساز,بهساز كاشانه تهران,96,575718,1270609626,2275,2207,2207,-68,-2.99,2273,-2,-0.09,2207,2207
290,وآيند,بانك  آينده,96,226175,3550947500,16354,15700,15700,-654,-4,16330,-24,-0.15,15700,15700
291,زرين,صندوق س. سهام زرين كوروش-س,95,638737,6180170133,9313,9400,9600,287,3.08,9676,363,3.9,9161,9950
292,چخزر,صنايع چوب خزر كاسپين,93,170624,8860674944,53537,51931,51931,-1606,-3,53242,-295,-0.55,51931,51931
293,فيروزا,صندوق بادرآمد ثابت فيروزه آسيا,93,1424081,32538320014,22797,22801,22875,78,0.34,22849,52,0.23,22731,22899
294,سپيدما,صندوق س. سپيد دماوند-د,92,3039481,31279399952,10288,10290,10291,3,0.03,10291,3,0.03,10290,10295
295,تسه9906,امتياز تسهيلات مسكن شهريور99,91,960,527136738,545176,520122,525000,-20176,-3.7,549101,3925,0.72,520122,569999
296,اوصتا,صندوق انديشه ورزان صباتامين -د,90,2257678,41988525161,18598,18598,18601,3,0.02,18598,0,0,18598,18610
297,انرژي3,سايراشخاص بورس انرژي,86,17306,4191167080,249670,242180,242180,-7490,-3,249130,-540,-0.22,242180,242180
298,وملي,گروه‌ صنعتي‌ ملي‌ (هلدينگ‌,85,60830,10056415600,170430,165320,165320,-5110,-3,169370,-1060,-0.62,165320,165320
299,كالا,بورس كالاي ايران,83,98841,3054186900,31850,30900,30900,-950,-2.98,31790,-60,-0.19,30900,30900
300,افق ملت,صندوق س در سهام افق ملت,83,28113,3476872870,121880,124790,124000,2120,1.74,123670,1790,1.47,122320,124790
301,ساروج,بين المللي ساروج بوشهر,81,122142,2118084114,17385,17040,17600,215,1.24,17380,-5,-0.03,17038,17769
302,سبزوا,سيمان لار سبزوار,80,374241,1203933297,3316,3217,3217,-99,-2.99,3314,-2,-0.06,3217,3217
303,آكورد2,صندوق س. آرمان آتي كوثر-د,80,8000000,8000000,31998,1,1,-31997,-100,1,-31997,-100,1,1
304,سكه0011پ02,سكه تمام بهارتحويلي 1روزه ملت,79,15500,15349508800,975932,1011002,986900,10968,1.12,990291,14359,1.47,981303,1011002
305,بكام,كارخانجات توليدي شهيد قندي,79,475331,1813387765,3932,3815,3815,-117,-2.98,3928,-4,-0.1,3815,3815
306,تسه9806,امتياز تسهيلات مسكن شهريور98,78,1661,904284685,549844,554997,542011,-7833,-1.42,544422,-5422,-0.99,525022,554997
307,تسه9804,امتياز تسهيلات مسكن تير98,76,1007,549861906,544300,549998,545000,700,0.13,546040,1740,0.32,523111,554380
308,تسه9905,امتياز تسهيلات مسكن مرداد99,75,512,277183966,544340,518897,537300,-7040,-1.29,541375,-2965,-0.54,518897,568999
309,خاذين,سايپاآذين‌,74,319888,1428299920,4750,4465,4465,-285,-6,4741,-9,-0.19,4465,4465
310,تسه9811,امتياز تسهيلات مسكن بهمن98,73,492,265874993,539910,517111,545000,5090,0.94,540396,486,0.09,517111,550000
311,مرقام,ايران‌ارقام‌,72,129413,2374728550,19520,18350,18350,-1170,-5.99,19460,-60,-0.31,18350,18350
312,دالبر,البرزدارو,72,467187,6671430360,14720,14280,14280,-440,-2.99,14660,-60,-0.41,14280,14280
313,كفپارس,فرآورده‌هاي‌ نسوز پارس‌,71,760479,2409197472,3265,3168,3168,-97,-2.97,3260,-5,-0.15,3168,3168
314,ضملي3004,اختيارخ فملي-14000-1400/03/02,69,2419,420072000,103,150,250,147,142.72,174,71,68.93,114,289
315,تسه9808,امتياز تسهيلات مسكن آبان98,68,835,450407891,544938,520000,538001,-6937,-1.27,539411,-5527,-1.01,520000,550000
316,پيزد,مجتمع صنايع لاستيك يزد,67,21947,1306790221,61384,59543,59543,-1841,-3,61334,-50,-0.08,59543,59543
317,اخزا901,اسنادخزانه-م1بودجه99-010621,67,88303,67173050601,760480,761000,760003,-477,-0.06,760711,231,0.03,759103,761200
318,تسه9901,امتياز تسهيلات مسكن فروردين99,67,504,277783300,551298,525686,540000,-11298,-2.05,551157,-141,-0.03,525686,575000
319,ضشنا2001,اختيارخ شپنا-10000-1400/02/27,66,1466,617978000,159,150,540,381,239.62,422,263,165.41,150,580
320,شپترو,پتروشيمي آبادان,65,632809,2820429713,4547,4457,4457,-90,-1.98,4534,-13,-0.29,4457,4457
321,بورس,بورس اوراق بهادار تهران,65,44126,1452627920,33930,32920,32920,-1010,-2.98,33900,-30,-0.09,32920,32920
322,اخزا903,اسنادخزانه-م3بودجه99-011110,64,158323,111445194400,704545,704600,702238,-2307,-0.33,703910,-635,-0.09,702238,704600
323,وتوكا,سرمايه‌گذاري‌توكافولاد(هلدينگ,64,283925,2853446250,10360,10050,10050,-310,-2.99,10340,-20,-0.19,10050,10050
324,هاي وب,داده گسترعصرنوين-هاي وب,64,225104,2287056640,10470,10160,10160,-310,-2.96,10460,-10,-0.1,10160,10160
325,لپارس,پارس‌ الكتريك‌,63,51368,4536308080,91040,88310,88310,-2730,-3,90780,-260,-0.29,88310,88310
326,شاروم,پتروشيمي اروميه,62,59948,1123365572,19318,18739,18739,-579,-3,19305,-13,-0.07,18739,18739
327,تسه9812,امتياز تسهيلات مسكن اسفند98,61,385,209587485,542422,535010,547999,5577,1.03,544383,1961,0.36,535000,558000
328,ستران,سيمان‌ تهران‌,61,205569,4666416300,23400,22700,22700,-700,-2.99,23330,-70,-0.3,22700,22700
329,واميد,گروه مديريت سرمايه گذاري اميد,59,252734,3047972040,12430,12060,12060,-370,-2.98,12420,-10,-0.08,12060,12060
330,زعف0008پ16,زعفران0008نگين بيرجند(پ),57,11903,1413172215,119095,116101,118899,-196,-0.16,118724,-371,-0.31,116101,119050
331,اخزا905,اسنادخزانه-م5بودجه99-020218,57,189858,125652602024,668535,665124,663000,-5535,-0.83,661824,-6711,-1,650000,667000
332,ثشاهد,سرمايه‌ گذاري‌ شاهد,56,151799,2560849130,17390,16870,16870,-520,-2.99,17360,-30,-0.17,16870,16870
333,ورنا,سرمايه‌گذاري‌ رنا(هلدينگ‌,55,335445,1781212950,5470,5310,5310,-160,-2.93,5460,-10,-0.18,5310,5310
334,قشرين,قند شيرين خراسان,55,483613,5439195411,11476,11247,11247,-229,-2,11409,-67,-0.58,11247,11247
335,تليسه,دامداري تليسه نمونه,55,318511,1343479398,4348,4218,4218,-130,-2.99,4344,-4,-0.09,4218,4218
336,تسه9807,امتياز تسهيلات مسكن مهر98,55,399,216308814,541741,522559,550000,8259,1.52,542127,386,0.07,522559,550000
337,سكه0012پ04,سكه تمام بهارتحويلي1روز صادرات,51,11100,11024412800,975601,991009,984000,8399,0.86,993190,17589,1.8,982001,1001896
338,وتوصا,گروه س توسعه صنعتي ايران,51,254256,2763762720,11200,10870,10870,-330,-2.95,11180,-20,-0.18,10870,10870
339,تسه9809,امتياز تسهيلات مسكن آذر98,51,289,155916381,553307,526000,530000,-23307,-4.21,539503,-13804,-2.49,526000,549999
340,چكارن,كارتن‌ ايران‌,50,393978,1272548940,3329,3230,3230,-99,-2.97,3326,-3,-0.09,3230,3230
341,سخند,صندوق س.سپهرخبرگان نفت-د,50,1582750,15855402830,10027,10030,10005,-22,-0.22,10018,-9,-0.09,10001,10035
342,اخزا911,اسنادخزانه-م11بودجه99-020906,50,81437,48186451081,596602,594116,592000,-4602,-0.77,591702,-4900,-0.82,590000,594121
343,تسه9805,امتياز تسهيلات مسكن مرداد98,50,659,359664604,549770,523000,542150,-7620,-1.39,545773,-3997,-0.73,523000,551800
344,شپاس,نفت پاسارگاد,49,308117,6373092028,21323,20684,20684,-639,-3,21238,-85,-0.4,20684,20684
345,فرابورس,فرابورس ايران,49,31181,945844454,31272,30334,30334,-938,-3,31254,-18,-0.06,30334,30334
346,كرازي,كارخانجات‌توليدي‌شيشه‌رازي‌,49,97640,2125622800,22440,21770,21770,-670,-2.99,22410,-30,-0.13,21770,21770
347,سكه0112پ03,سكه تمام بهارتحويلي1روزه سامان,48,13200,13113773500,975870,999600,990990,15120,1.55,993468,17598,1.8,984000,1000000
348,فسرب,ملي‌ سرب‌وروي‌ ايران‌,48,26304,2009362560,78750,76390,76390,-2360,-3,78650,-100,-0.13,76390,76390
349,پتاير,ايران‌ تاير,48,170375,603468250,3651,3542,3542,-109,-2.99,3650,-1,-0.03,3542,3542
350,اخزا908,اسنادخزانه-م8بودجه99-020606,47,128071,80322039935,628591,627777,627000,-1591,-0.25,627168,-1423,-0.23,626500,628010
351,ولانا,شركت ليزينگ آريا دانا,47,61874,2370887932,39100,38318,38318,-782,-2,39003,-97,-0.25,38318,38318
352,غپينو,پارس‌ مينو,46,146177,898988550,6340,6150,6150,-190,-3,6340,0,0,6150,6150
353,فزرين,زرين معدن آسيا,46,67335,1759530885,26939,26131,26131,-808,-3,26910,-29,-0.11,26131,26131
354,دانا,بيمه دانا,45,704673,4509907200,6590,6400,6400,-190,-2.88,6570,-20,-0.3,6400,6400
355,وپترو,سرمايه‌گذاري صنايع پتروشيمي‌,45,662466,8784299160,13660,13260,13260,-400,-2.93,13590,-70,-0.51,13260,13260
356,وهنر,گروه توسعه هنر ايران,45,210063,1702980741,8272,8107,8107,-165,-1.99,8258,-14,-0.17,8107,8107
357,اراد50,مرابحه عام دولت5-ش.خ0302,44,736400,736400000000,1000000,1000000,1000000,0,0,1000000,0,0,1000000,1000000
358,ديران,ايران‌دارو,42,59586,1026070920,17750,17220,17220,-530,-2.99,17730,-20,-0.11,17220,17220
359,خكاوه,سايپا ديزل,41,408363,1413344343,3605,3461,3461,-144,-3.99,3594,-11,-0.31,3461,3461
360,تايرا,تراكتورسازي‌ايران‌,39,287517,7509944040,26920,26120,26120,-800,-2.97,26800,-120,-0.45,26120,26120
361,سپر,صندوق س سپر سرمايه بيدار- ثابت,39,324334,3821957741,11781,11784,11784,3,0.03,11784,3,0.03,11784,11785
362,زپارس,ملي كشت و صنعت و دامپروري پارس,38,304545,38939123700,131810,127860,127860,-3950,-3,128460,-3350,-2.54,127860,127860
363,خوساز,محورسازان‌ايران‌خودرو,37,3056787,23781802860,8020,7780,7780,-240,-2.99,7900,-120,-1.5,7780,7780
364,سپيدار,سپيدار سيستم آسيا,37,18104,1032290080,58783,57020,57020,-1763,-3,58745,-38,-0.06,57020,57020
365,ضملي3002,اختيارخ فملي-10000-1400/03/02,37,230,663031000,2243,2700,3121,878,39.14,2883,640,28.53,2600,3200
366,اخزا909,اسنادخزانه-م9بودجه99-020316,37,59131,38716896463,657186,656529,654200,-2986,-0.45,654765,-2421,-0.37,653099,658000
367,ضجار2001,اختيارخ وتجارت-2000-1400/02/22,37,2708,1234420000,421,351,460,39,9.26,456,35,8.31,351,500
368,سخاش,سيمان‌خاش‌,37,54787,7511845570,141350,137110,137110,-4240,-3,140660,-690,-0.49,137110,137110
369,غزر,صنعتي زر ماكارون,37,15507,385814160,25640,24880,24880,-760,-2.96,25630,-10,-0.04,24880,24880
370,اخزا907,اسنادخزانه-م7بودجه99-020704,36,62741,38620368725,620083,616555,616000,-4083,-0.66,615552,-4531,-0.73,613119,617500
371,وسبحان,سرمايه گذاري سبحان,36,862952,2350681248,2808,2724,2724,-84,-2.99,2804,-4,-0.14,2724,2724
372,اخزا914,اسنادخزانه-م14بودجه99-021025,36,17787,10294150843,579989,580100,575002,-4987,-0.86,578746,-1243,-0.21,575002,580100
373,دامين,داروسازي‌ امين‌,36,127334,646856720,5230,5080,5080,-150,-2.87,5230,0,0,5080,5080
374,اخزا815,اسنادخزانه-م15بودجه98-010406,35,36767,29194506446,795723,793601,799498,3775,0.47,794041,-1682,-0.21,792004,799498
375,زعف0008پ19,زعفران0008نگين تروند قاينات(پ),35,5400,643593800,116210,119495,117500,1290,1.11,119184,2974,2.56,117500,119500
376,كبافق,معادن‌ بافق‌,35,21729,1018220940,48300,46860,46860,-1440,-2.98,48270,-30,-0.06,46860,46860
377,ودي,بيمه  دي,34,272868,5522848320,20865,20240,20240,-625,-3,20794,-71,-0.34,20240,20240
378,قنقش,قند نقش جهان,34,1459509,105055457820,73448,71980,71980,-1468,-2,71980,-1468,-2,71980,71980
379,دسينا,داروسازي‌ سينا,34,262872,6069714480,23800,23090,23090,-710,-2.98,23710,-90,-0.38,23090,23090
380,خبازرس,بازرسي مهندسي و صنعتي ايران,34,106664,2716412088,25986,25467,25467,-519,-2,25900,-86,-0.33,25467,25467
381,ملت,بيمه ملت,33,73388,1108892680,15570,15110,15110,-460,-2.95,15560,-10,-0.06,15110,15110
382,ضخود7073,اختيارخ خودرو-1600-1400/07/07,33,813,365224000,391,401,479,88,22.51,449,58,14.83,400,499
383,غشهداب,كشت و صنعت شهداب ناب خراسان,33,331477,1273203157,3959,3841,3841,-118,-2.98,3956,-3,-0.08,3841,3841
384,وكادو,تكادو,33,332342,5148642264,16137,15492,15492,-645,-4,15964,-173,-1.07,15492,15492
385,ضشنا2000,اختيارخ شپنا-9000-1400/02/27,32,258,316070000,579,990,1450,871,150.43,1225,646,111.57,404,1469
386,خفولا,خدمات فني فولاد يزد,32,69521,2902710313,43492,41753,41753,-1739,-4,43229,-263,-0.6,41753,41753
387,ثروتم,صندوق س. ثروت آفرين پارسيان-س,31,66620,4887263050,71297,72192,74799,3502,4.91,73360,2063,2.89,72000,74799
388,نوين,بيمه نوين,30,292554,1678967406,5916,5739,5739,-177,-2.99,5910,-6,-0.1,5739,5739
389,فراز,صندوق س.سهام فراز داريك-س,30,50032,516020006,10309,10313,10313,4,0.04,10314,5,0.05,10313,10319
390,سمگا,گروه سرمايه گذاري ميراث فرهنگي,30,61612,1713060048,28663,27804,27804,-859,-3,28634,-29,-0.1,27804,27804
391,رتاپ,تجارت الكترونيك  پارسيان,29,132345,881417700,6860,6660,6660,-200,-2.92,6860,0,0,6660,6660
392,بذر,صندوق س بذر اميد آفرين-سهام,28,8906,824644320,90610,91010,92650,2040,2.25,92590,1980,2.19,91010,93170
393,وسديد,گروه ‌صنعتي‌سديد,28,185546,516931156,2902,2786,2786,-116,-4,2900,-2,-0.07,2786,2786
394,ضملي7002,اختيارخ فملي-10000-1400/07/11,28,354,1456617000,3584,3590,4300,716,19.98,4115,531,14.82,3590,4450
395,كهمدا,شيشه‌ همدان‌,28,139361,1371312240,10140,9840,9840,-300,-2.96,10130,-10,-0.1,9840,9840
396,حريل,ريل پردازسير,27,182934,977965164,5511,5346,5346,-165,-2.99,5508,-3,-0.05,5346,5346
397,وپخش,داروپخش‌ (هلدينگ‌,25,7750,762445000,101420,98380,98380,-3040,-3,101370,-50,-0.05,98380,98380
398,ضپاس2001,اختيارخ وپارس-2500-1400/02/29,24,1488,112313000,58,99,60,2,3.45,75,17,29.31,40,99
399,كحافظ,كاشي‌ وسراميك‌ حافظ‌,24,79651,926341130,11980,11630,11630,-350,-2.92,11970,-10,-0.08,11630,11630
400,سيستم,همكاران سيستم,24,62337,1550321190,25630,24870,24870,-760,-2.97,25610,-20,-0.08,24870,24870
401,اخزا816,اسنادخزانه-م16بودجه98-010503,22,15011,11718308025,781020,782000,780000,-1020,-0.13,780648,-372,-0.05,779071,782000
402,ساوه,سيمان ساوه,22,17828,964940500,55798,54125,54125,-1673,-3,55765,-33,-0.06,54125,54125
403,سيمرغ,سيمرغ,21,12269,217406680,18260,17720,17720,-540,-2.96,18260,0,0,17720,17720
404,اخزا821,اسنادخزانه-م21بودجه98-020906,21,19315,11492568733,599001,599000,597700,-1301,-0.22,595007,-3994,-0.67,590001,600000
405,پرديس,سرمايه گذاري پرديس,21,57655,303841850,5430,5270,5270,-160,-2.95,5430,0,0,5270,5270
406,وبيمه,سرمايه‌ گذاري‌ صنعت‌ بيمه‌,20,82076,222918416,2799,2716,2716,-83,-2.97,2799,0,0,2716,2716
407,ولپارس,ليزينگ پارسيان,20,59492,287286868,4978,4829,4829,-149,-2.99,4977,-1,-0.02,4829,4829
408,سقاين,سيمان‌ قائن‌,20,10579,674622830,65740,63770,63770,-1970,-3,65710,-30,-0.05,63770,63770
409,كمنگنز,معادن‌منگنزايران‌,20,8485,722922000,87830,85200,85200,-2630,-2.99,87790,-40,-0.05,85200,85200
410,ختور,رادياتور ايران‌,19,13263,252129630,19590,19010,19010,-580,-2.96,19590,0,0,19010,19010
411,گنجين,صندوق س. گنجينه يكم آويد-د,19,45340,580529905,12786,12791,12802,16,0.13,12804,18,0.14,12791,12805
412,زدشت,كشت و صنعت دشت خرم دره,19,15002,428172082,29423,28541,28541,-882,-3,29415,-8,-0.03,28541,28541
413,تصميم2,صندوق س با درآمد ثابت تصميم,19,18500000,18500000,16275,1,1,-16274,-99.99,1,-16274,-99.99,1,1
414,اخزا820,اسنادخزانه-م20بودجه98-020806,18,31031,18852395668,609906,605002,608000,-1906,-0.31,607534,-2372,-0.39,605001,611600
415,اخزا809,اسنادخزانه-م9بودجه98-000923,18,6579,5824345310,888354,885100,885100,-3254,-0.37,885293,-3061,-0.34,885100,887735
416,قجام,فرآوردههاي غذايي وقندتربت‌جام‌,18,600850,9123306400,15493,15184,15184,-309,-1.99,15193,-300,-1.94,15184,15184
417,فلوله,لوله‌وماشين‌سازي‌ايران‌,18,43732,939363360,22140,21480,21480,-660,-2.98,22130,-10,-0.05,21480,21480
418,لكما,كارخانجات‌مخابراتي‌ايران‌,17,58104,347520024,6103,5981,5981,-122,-2,6101,-2,-0.03,5981,5981
419,وبهمن,سرمايه‌گذاري‌بهمن‌,17,264727,3666468950,14270,13850,13850,-420,-2.94,14240,-30,-0.21,13850,13850
420,دتوليد,داروسازي توليد دارو,17,18173,468009269,26549,25753,25753,-796,-3,26541,-8,-0.03,25753,25753
421,زعف0008پ09,زعفران0008نگين نوين(پ),17,5900,701742200,120000,119000,119000,-1000,-0.83,118939,-1061,-0.88,117500,119989
422,وملت,سرمايه گذاري ملت,17,104988,441159576,4377,4202,4202,-175,-4,4369,-8,-0.18,4202,4202
423,غدشت,دشت‌ مرغاب‌,17,1868,521975240,288070,279430,279430,-8640,-3,287980,-90,-0.03,279430,279430
424,ضجار2003,اختيارخ وتجارت-3000-1400/02/22,17,1000,1000000,1,1,1,0,0,1,0,0,1,1
425,ضفلا3003,اختيارخ فولاد-7133-1400/03/19,16,115,315721000,2097,2300,2900,803,38.29,2745,648,30.9,2300,2900
426,سخواف,سيمان مجد خواف,16,199000,3284296000,16840,16504,16504,-336,-2,16784,-56,-0.33,16504,16504
427,كمينا,شيشه سازي مينا,16,20204,486754768,25095,24092,24092,-1003,-4,25070,-25,-0.1,24092,24092
428,تملي712,تسهيلات مسكن ب. ملي-اسفند97,16,210,124745970,582245,553133,611357,29112,5,594028,11783,2.02,553133,611357
429,بخاور,بيمه زندگي خاورميانه,16,151791,996052542,6764,6562,6562,-202,-2.99,6760,-4,-0.06,6562,6562
430,گدنا,تهيه توزيع غذاي دنا آفرين فدك,16,7041,231691146,33923,32906,32906,-1017,-3,33918,-5,-0.01,32906,32906
431,زگلدشت,كشت و دام گلدشت نمونه اصفهان,16,18616,251669704,13937,13519,13519,-418,-3,13935,-2,-0.01,13519,13519
432,كيسون,شركت كيسون,16,12452,137071616,11466,11008,11008,-458,-3.99,11463,-3,-0.03,11008,11008
433,زكوثر,سرمايه گذاري كشاورزي كوثر,16,15623,327926770,21630,20990,20990,-640,-2.96,21630,0,0,20990,20990
434,تكمبا,كمباين‌ سازي‌ ايران‌,16,234349,1783395890,7840,7610,7610,-230,-2.93,7830,-10,-0.13,7610,7610
435,غگرجي,بيسكويت‌  گرجي‌,16,171865,3033417250,18190,17650,17650,-540,-2.97,18160,-30,-0.16,17650,17650
436,ضملي3000,اختيارخ فملي-8000-1400/03/02,16,391,1951640000,4329,4900,5050,721,16.66,4991,662,15.29,4900,5190
437,دتماد,توليدمواداوليه‌داروپخش‌,16,22691,975486090,44310,42990,42990,-1320,-2.98,44280,-30,-0.07,42990,42990
438,گوهر2,صندوق سكه طلاي كيان,15,150000,150000,48136,1,1,-48135,-100,1,-48135,-100,1,1
439,شسينا,صنايع‌شيميايي‌سينا,15,8261,1060629790,132360,128390,128390,-3970,-3,132270,-90,-0.07,128390,128390
440,باران,بيمه زندگي باران50%تاديه,15,504846,1991617470,3758,3945,3945,187,4.98,3776,18,0.48,3945,3945
441,زشريف,كشت وصنعت شريف آباد,15,83723,423136042,5210,5054,5054,-156,-2.99,5209,-1,-0.02,5054,5054
442,اراد35,مرابحه عام دولت3-ش.خ 0103,15,98000,92964550000,978000,948600,948650,-29350,-3,948618,-29382,-3,948500,948650
443,ولبهمن,شركت بهمن ليزينگ,15,222642,1645101738,7617,7389,7389,-228,-2.99,7609,-8,-0.11,7389,7389
444,اخزا808,اسنادخزانه-م8بودجه98-000817,15,3860,3490047753,903848,904980,903900,52,0.01,904157,309,0.03,903900,905000
445,وگردش,بانك گردشگري,15,14347,227959483,16213,15889,15889,-324,-2,16212,-1,-0.01,15889,15889
446,ضمخا2001,اختيارخ اخابر-10000-1400/02/29,15,1055,29100000,101,30,25,-76,-75.25,28,-73,-72.28,20,50
447,دفرا,فرآورده‌هاي‌ تزريقي‌ ايران‌,15,21557,544960960,26060,25280,25280,-780,-2.99,26050,-10,-0.04,25280,25280
448,كسرام,پارس‌ سرام‌,15,132095,1067327600,8320,8080,8080,-240,-2.88,8310,-10,-0.12,8080,8080
449,وآرين,شركت توسعه اقتصادي آرين,15,105000,359100000,3489,3420,3420,-69,-1.98,3488,-1,-0.03,3420,3420
450,ضسپا3001,اختيارخ خساپا-1600-1400/03/26,15,510,156143000,227,231,292,65,28.63,306,79,34.8,231,333
451,ضملي7004,اختيارخ فملي-14000-1400/07/11,15,172,228540000,1018,1200,1550,532,52.26,1329,311,30.55,1200,1550
452,خشرق,الكتريك‌ خودرو شرق‌,15,141457,2051126500,14940,14500,14500,-440,-2.95,14920,-20,-0.13,14500,14500
453,ثنور,سرمايه گذاري كوه نور,15,20577,195255153,9682,9489,9489,-193,-1.99,9680,-2,-0.02,9489,9489
454,اخزا814,اسنادخزانه-م14بودجه98-010318,14,7258,5812913090,803193,803200,803205,12,0,800897,-2296,-0.29,800000,803500
455,اخزا817,اسنادخزانه-م17بودجه98-010512,14,9106,7073457238,777134,776000,776007,-1127,-0.15,776791,-343,-0.04,776000,781999
456,فروس,فروسيليس‌ ايران‌,14,95525,489088000,5270,5120,5120,-150,-2.85,5270,0,0,5120,5120
457,ثرود,سرمايه‌گذاري مسكن زاينده رود,14,79297,1620830680,21072,20440,20440,-632,-3,21051,-21,-0.1,20440,20440
458,خمحور,توليدمحورخودرو,14,3553,218829270,63490,61590,61590,-1900,-2.99,63480,-10,-0.02,61590,61590
459,زشگزا,شير و گوشت زاگرس شهركرد,14,12932,103287884,8233,7987,7987,-246,-2.99,8232,-1,-0.01,7987,7987
460,دلقما,دارويي‌ لقمان‌,14,24425,612823250,25860,25090,25090,-770,-2.98,25850,-10,-0.04,25090,25090
461,شكربن,كربن‌ ايران‌,13,66022,5553770640,86720,84120,84120,-2600,-3,86420,-300,-0.35,84120,84120
462,غچين,كشت‌ و صنعت‌ چين‌ چين,13,24432,470560320,19850,19260,19260,-590,-2.97,19840,-10,-0.05,19260,19260
463,تملي709,تسهيلات مسكن ب. ملي-آذر97,13,145,125886970,826844,868186,868186,41342,5,868186,41342,5,868186,868186
464,آسام,صندوق س.آرمان سپهر آشنا-م,13,2730,281696700,102499,102998,103000,501,0.49,103186,687,0.67,102006,104000
465,ريشمك,توليد و صادرات ريشمك,13,4399,241364332,56564,54868,54868,-1696,-3,56556,-8,-0.01,54868,54868
466,كپارس,كاشي‌ پارس‌,13,2367,352754010,153630,149030,149030,-4600,-2.99,153600,-30,-0.02,149030,149030
467,فرآور,فرآوري‌موادمعدني‌ايران‌,13,29885,1013101500,34940,33900,33900,-1040,-2.98,34920,-20,-0.06,33900,33900
468,اخزا812,اسنادخزانه-م12بودجه98-001111,13,8307,7202685200,867927,868000,864980,-2947,-0.34,867062,-865,-0.1,864980,868000
469,بميلا,توسعه بازرگاني آهن وفولادميلاد,13,171466,2352684986,14001,13721,13721,-280,-2,13967,-34,-0.24,13721,13721
470,تبرك,گروه كارخانجات صنعتي تبرك,13,11823,227108007,19803,19209,19209,-594,-3,19800,-3,-0.02,19209,19209
471,اخزا806,اسنادخزانه-م6بودجه98-000519,13,12752,12119729779,950030,951000,951000,970,0.1,950418,388,0.04,950005,951501
472,اخزا811,اسنادخزانه-م11بودجه98-001013,13,41380,36294980971,877771,877401,877000,-771,-0.09,877114,-657,-0.07,877000,877401
473,صنوين,صندوق سرمايه‌گذاري صنوين-مختلط,13,11533,1197142360,102350,102550,104650,2300,2.25,103800,1450,1.42,102550,104700
474,اخزا818,اسنادخزانه-م18بودجه98-010614,13,4519,3453241086,764973,763013,763301,-1672,-0.22,764160,-813,-0.11,763013,766500
475,غصينو,صنعتي مينو,13,7213,468765657,66998,64989,64989,-2009,-3,66988,-10,-0.01,64989,64989
476,زقيام,كشت و دام قيام اصفهان,12,17214,481768218,28852,27987,27987,-865,-3,28843,-9,-0.03,27987,27987
477,آپ,آسان پرداخت پرشين,12,8430,142382700,17410,16890,16890,-520,-2.99,17410,0,0,16890,16890
478,زعف0008پ20,زعفران0008نگين وحدت جام(پ),12,1550,182637750,117214,119480,117000,-214,-0.18,117831,617,0.53,116800,119488
479,زعف0008پ12,زعفران0008پوشالمعمول سحرخيز(پ),12,10688,966845954,89238,85000,92000,2762,3.1,90461,1223,1.37,85000,92000
480,ضترا8058,اختيارخ شتران-8000-1400/08/09,12,85,165040000,1207,1800,2080,873,72.33,1942,735,60.89,1800,2080
481,ضفلا3004,اختيارخ فولاد-8560-1400/03/19,12,125,136861000,1013,1450,1150,137,13.52,1095,82,8.09,300,1450
482,بنيرو,نيروترانس‌,12,24472,356801760,15030,14580,14580,-450,-2.99,15030,0,0,14580,14580
483,كلر,كلر پارس,12,3324,418774140,129881,125985,125985,-3896,-3,129847,-34,-0.03,125985,125985
484,اعتلا,شركت سرمايه گذاري اعتلاء البرز,12,16548,116531016,7259,7042,7042,-217,-2.99,7258,-1,-0.01,7042,7042
485,ضصاد3001,اختيارخ وبصادر-2000-1400/03/12,11,118,42008000,313,400,385,72,23,356,43,13.74,350,400
486,ثفارس,عمران‌وتوسعه‌فارس‌,11,13071,126788700,10000,9700,9700,-300,-3,10000,0,0,9700,9700
487,ضمخا7075,اختيارخ اخابر-9000-1400/07/28,11,335,393812000,1195,1200,1210,15,1.26,1176,-19,-1.59,1100,1210
488,قصفها,قنداصفهان‌,11,1042,158321480,156630,151940,151940,-4690,-2.99,156610,-20,-0.01,151940,151940
489,شلعاب,لعابيران‌,11,18115,384943750,21900,21250,21250,-650,-2.97,21890,-10,-0.05,21250,21250
490,غبشهر,صنعتي‌ بهشهر,11,17114,420319840,25310,24560,24560,-750,-2.96,25300,-10,-0.04,24560,24560
491,قثابت,قند ثابت‌ خراسان‌,11,11180,732849000,67570,65550,65550,-2020,-2.99,67540,-30,-0.04,65550,65550
492,كسرا,سراميك‌هاي‌صنعتي‌اردكان‌,11,15531,313260270,20790,20170,20170,-620,-2.98,20790,0,0,20170,20170
493,سفانو,سيمان فارس نو,11,8467,287793330,35040,33990,33990,-1050,-3,35030,-10,-0.03,33990,33990
494,كطبس,ذغال‌سنگ‌ نگين‌ ط‌بس‌,11,1450,114883500,81680,79230,79230,-2450,-3,81670,-10,-0.01,79230,79230
495,سجام,مجتمع سيمان غرب آسيا,11,613805,2565704900,4265,4180,4180,-85,-1.99,4254,-11,-0.26,4180,4180
496,اميد,تامين سرمايه اميد,11,29089,218749280,7750,7520,7520,-230,-2.97,7750,0,0,7520,7520
497,اراد33,مرابحه عام دولت3-ش.خ 0303,11,14700,13032882600,871918,890000,870000,-1918,-0.22,886591,14673,1.68,870000,910033
498,ختراك,ريخته‌گري‌ تراكتورسازي‌ ايران‌,11,41899,632255910,15550,15090,15090,-460,-2.96,15540,-10,-0.06,15090,15090
499,زملارد,كشاورزي و دامپروري ملارد شير,11,5892,214616100,37551,36425,36425,-1126,-3,37546,-5,-0.01,36425,36425
500,ساروم,سيمان‌اروميه‌,11,2123,73009970,35450,34390,34390,-1060,-2.99,35450,0,0,34390,34390
501,رافزا,رايان هم افزا,11,1682,174019720,106659,103460,103460,-3199,-3,106648,-11,-0.01,103460,103460
502,دتوزيع,توزيع دارو پخش,11,6110,298357410,50341,48831,48831,-1510,-3,50332,-9,-0.02,48831,48831
503,شتولي,تولي‌پرس‌,10,6091,214135196,35873,35156,35156,-717,-2,35858,-15,-0.04,35156,35156
504,ضجار2000,اختيارخ وتجارت-1800-1400/02/22,10,296,185242000,714,688,625,-89,-12.46,626,-88,-12.32,620,690
505,خمهر,مهركام‌پارس‌,10,57808,136311264,2430,2358,2358,-72,-2.96,2430,0,0,2358,2358
506,ضپاس2000,اختيارخ وپارس-2000-1400/02/29,10,434,192117000,506,497,440,-66,-13.04,443,-63,-12.45,200,498
507,خعمرا,توسعه و عمران شهرستان نائين,10,29328,701203152,22771,23909,23909,1138,5,22809,38,0.17,23909,23909
508,دسبحان,سبحان دارو,10,25074,457349760,18800,18240,18240,-560,-2.98,18790,-10,-0.05,18240,18240
509,ضصاد3003,اختيارخ وبصادر-3000-1400/03/12,10,241,1874000,11,15,9,-2,-18.18,8,-3,-27.27,5,15
510,اخزا721,اسنادخزانه-م21بودجه97-000728,10,2484,2268502597,913679,914000,915996,2317,0.25,913246,-433,-0.05,912888,915996
511,وسرمد,بيمه  سرمد,10,10604,63411920,6229,5980,5980,-249,-4,6228,-1,-0.02,5980,5980
512,وگستر,گسترش سرمايه گذاري ايرانيان,10,34296,631217880,18974,18405,18405,-569,-3,18967,-7,-0.04,18405,18405
513,سدور,سيمان‌ دورود,10,10216,191958640,19370,18790,18790,-580,-2.99,19370,0,0,18790,18790
514,ضترا3002,اختيارخ شتران-8000-1400/03/09,10,41,18705000,257,400,500,243,94.55,456,199,77.43,400,500
515,ولتجار,واسپاري تجارت وسرمايه ايرانيان,9,22441,177283900,8229,7900,7900,-329,-4,8226,-3,-0.04,7900,7900
516,بزاگرس,نيروگاه زاگرس كوثر,9,12793,88783420,7154,6940,6940,-214,-2.99,7154,0,0,6940,6940
517,غويتا,ويتانا,9,3644,63489412,17961,17423,17423,-538,-3,17960,-1,-0.01,17423,17423
518,زفكا,كشت و دامداري فكا,9,156647,1929264452,12696,12316,12316,-380,-2.99,12681,-15,-0.12,12316,12316
519,غگلپا,شير پاستوريزه پگاه گلپايگان,9,2537,161840304,65764,63792,63792,-1972,-3,65757,-7,-0.01,63792,63792
520,كپرور,فرآوري زغال سنگ پروده طبس,9,23501,831042362,36455,35362,35362,-1093,-3,36436,-19,-0.05,35362,35362
521,اخزا904,اسنادخزانه-م4بودجه99-011215,9,15199,10487318586,693937,685362,690013,-3924,-0.57,690001,-3936,-0.57,685362,695999
522,چفيبر,فيبر ايران‌,9,10545,141830250,13860,13450,13450,-410,-2.96,13860,0,0,13450,13450
523,دپارس,پارس‌ دارو,9,2676,123550920,47590,46170,46170,-1420,-2.98,47590,0,0,46170,46170
524,اخزا718,اسنادخزانه-م18بودجه97-000525,8,8475,8051086341,946564,945703,950000,3436,0.36,949981,3417,0.36,945703,950000
525,زبينا,كشاورزي و دامپروري بينالود,8,63137,239289230,3907,3790,3790,-117,-2.99,3906,-1,-0.03,3790,3790
526,شكف,كف,8,2616,271389072,105859,103742,103742,-2117,-2,105804,-55,-0.05,103742,103742
527,ضصاد3002,اختيارخ وبصادر-2500-1400/03/12,8,257,13747000,76,50,76,0,0,53,-23,-30.26,50,76
528,غشهد,شهد ايران ‌,8,11461,80914660,7270,7060,7060,-210,-2.89,7270,0,0,7060,7060
529,دسبحا,گروه دارويي سبحان,8,25061,463879110,19080,18510,18510,-570,-2.99,19070,-10,-0.05,18510,18510
530,ضمخا7071,اختيارخ اخابر-24000-1400/07/28,8,388,41720000,100,120,110,10,10,108,8,8,101,120
531,شگل,گلتاش‌,8,38109,373087110,10090,9790,9790,-300,-2.97,10090,0,0,9790,9790
532,دسانكو,داروسازي سبحان انكولوژي,8,8981,128823464,14787,14344,14344,-443,-3,14786,-1,-0.01,14344,14344
533,غالبر,لبنيات‌ كالبر,8,7003,137328830,20210,19610,19610,-600,-2.97,20210,0,0,19610,19610
534,قاسم,قاسم ايران,8,10504,132938624,13047,12656,12656,-391,-3,13046,-1,-0.01,12656,12656
535,فاما,صنعتي‌ آما,8,5654,101772000,18550,18000,18000,-550,-2.96,18550,0,0,18000,18000
536,قشكر,شكرشاهرود,8,50928,189706800,3840,3725,3725,-115,-2.99,3840,0,0,3725,3725
537,ثنوسا,نوسازي‌وساختمان‌تهران‌,8,63914,805316400,12980,12600,12600,-380,-2.93,12970,-10,-0.08,12600,12600
538,ضشنا8001,اختيارخ شپنا-8000-1400/08/16,7,20,66760000,2520,2980,4250,1730,68.65,3338,818,32.46,2980,4250
539,غشان,شيرپاستوريزه‌پگاه‌خراسان‌,7,24544,183098240,7690,7460,7460,-230,-2.99,7690,0,0,7460,7460
540,حفارس,حمل و نقل بين المللي خليج فارس,7,22775,106587000,4824,4680,4680,-144,-2.99,4824,0,0,4680,4680
541,ثجوان,تامين مسكن جوانان,7,17964,191424384,11099,10656,10656,-443,-3.99,11095,-4,-0.04,10656,10656
542,الماس,صندوق س.امين تدبيرگران فردا-س,7,481,51516595,106120,107150,107000,880,0.83,107103,983,0.93,107000,107300
543,تاپكيش,تجارت الكترونيك پارسيان كيش,7,3562,62894234,18203,17657,17657,-546,-3,18202,-1,-0.01,17657,17657
544,زعف0008پ05,زعفران0008نگين زرين(پ),7,938,112544620,120071,120990,119890,-181,-0.15,119984,-87,-0.07,119800,120990
545,فولاي,صنايع فولاد آلياژي يزد,7,1342,65786182,50537,49021,49021,-1516,-3,50535,-2,0,49021,49021
546,اخزا716,اسنادخزانه-م16بودجه97-000407,7,3110,3032365987,974847,975999,973006,-1841,-0.19,975037,190,0.02,973006,976000
547,هجرت,پخش هجرت,7,1500,40848000,28074,27232,27232,-842,-3,28073,-1,0,27232,27232
548,اخزا722,اسنادخزانه-م22بودجه97-000428,7,2849,2743605000,962506,963500,963000,494,0.05,963006,500,0.05,963000,963500
549,زعف0008پ15,زعفران0008پوشالمعمول طلاسرخ(پ),7,3411,310731200,88980,85028,93500,4520,5.08,91097,2117,2.38,85028,93500
550,تملي612,تسهيلات مسكن بانك ملي-اسفند96,7,74,42243048,600896,570852,570852,-30044,-5,570852,-30044,-5,570852,570852
551,ضجار7041,اختيارخ وتجارت-3000-1400/07/21,7,428,60080000,100,100,140,40,40,140,40,40,100,185
552,ضترا3000,اختيارخ شتران-6000-1400/03/09,7,73,160100000,2000,2200,2200,200,10,2193,193,9.65,2150,2200
553,ضفلا3005,اختيارخ فولاد-9986-1400/03/19,7,214,91305000,126,255,500,374,296.83,427,301,238.89,255,500
554,ساينا,صنايع بهداشتي ساينا,7,2700,391813200,149604,145116,145116,-4488,-3,149568,-36,-0.02,145116,145116
555,اپرداز,آتيه داده پرداز,7,202340,4185200560,21323,20684,20684,-639,-3,21268,-55,-0.26,20684,20684
556,دابور,داروسازي‌ ابوريحان‌,7,1365,50327550,38010,36870,36870,-1140,-3,38010,0,0,36870,36870
557,ضملي3001,اختيارخ فملي-9000-1400/03/02,7,91,357932000,2900,3202,4180,1280,44.14,3933,1033,35.62,3202,4180
558,شپارس,بين‌ المللي‌ محصولات‌  پارس‌,7,72309,1563320580,22280,21620,21620,-660,-2.96,22260,-20,-0.09,21620,21620
559,اطلس2,صندوق س.توسعه اندوخته آينده-س,7,70000,70000,191183,1,1,-191182,-100,1,-191182,-100,1,1
560,طلا2,صندوق س.پشتوانه طلاي لوتوس,7,700000,700000,69824,1,1,-69823,-100,1,-69823,-100,1,1
561,دارو,كارخانجات‌داروپخش‌,7,2316,75107880,33430,32430,32430,-1000,-2.99,33430,0,0,32430,32430
562,زنگان,صنعت روي زنگان,7,1757,178035053,104462,101329,101329,-3133,-3,104450,-12,-0.01,101329,101329
563,سكرد,سيمان كردستان,6,17681,167969500,9790,9500,9500,-290,-2.96,9790,0,0,9500,9500
564,تملي708,تسهيلات مسكن ب. ملي-آبان97,6,65,52096980,763326,801492,801492,38166,5,801492,38166,5,801492,801492
565,كي بي سي,شركت كي بي سي,6,3804,95567892,25899,25123,25123,-776,-3,25897,-2,-0.01,25123,25123
566,ضمخا7066,اختيارخ اخابر-12000-1400/07/28,6,39,31460000,602,880,800,198,32.89,807,205,34.05,750,880
567,ضصاد8033,اختيارخ وبصادر-2500-1400/08/12,6,138,29522000,150,195,279,129,86,214,64,42.67,195,279
568,نطرين,عطرين نخ قم,6,4767,56078988,12127,11764,11764,-363,-2.99,12127,0,0,11764,11764
569,ضمخا7076,اختيارخ اخابر-10000-1400/07/28,6,195,194677000,900,998,999,99,11,998,98,10.89,997,999
570,كاذر,فرآورده‌هاي‌نسوزآذر,6,2304,73175040,32740,31760,31760,-980,-2.99,32740,0,0,31760,31760
571,غبهنوش,بهنوش‌ ايران‌,6,661,45846960,71500,69360,69360,-2140,-2.99,71500,0,0,69360,69360
572,ضترا8056,اختيارخ شتران-6000-1400/08/09,6,26,76300000,2098,2700,3000,902,42.99,2935,837,39.9,2700,3000
573,وآفري,بيمه كارآفرين,6,31370,102172090,3323,3257,3257,-66,-1.99,3323,0,0,3257,3257
574,كفرا,فراورده‌ هاي‌ نسوزايران‌,6,4694,215783180,47390,45970,45970,-1420,-3,47380,-10,-0.02,45970,45970
575,كوثر,بيمه كوثر,6,10213,145300351,14667,14227,14227,-440,-3,14666,-1,-0.01,14227,14227
576,شتوكا,توكا رنگ فولاد سپاهان,6,4195,209838095,51568,50021,50021,-1547,-3,51561,-7,-0.01,50021,50021
577,جهرم,پتروشيمي جهرم,6,29188,50757932,1774,1739,1739,-35,-1.97,1774,0,0,1739,1739
578,فبيرا,بسته‌ بندي‌ ايران‌,6,13602,40479552,3100,2976,2976,-124,-4,3100,0,0,2976,2976
579,غنوش,نوش‌ مازندران‌,6,1582,87247300,56850,55150,55150,-1700,-2.99,56850,0,0,55150,55150
580,ضملي7003,اختيارخ فملي-12000-1400/07/11,6,22,64800000,1647,3500,3000,1353,82.15,2945,1298,78.81,2800,3500
581,فجام,جام‌دارو,6,4108,40956760,10270,9970,9970,-300,-2.92,10270,0,0,9970,9970
582,كيميا,معدني كيمياي زنجان گستران,6,5128,87975968,17686,17156,17156,-530,-3,17685,-1,-0.01,17156,17156
583,شفا,سرمايه گذاري شفادارو,6,1078,48682480,46550,45160,45160,-1390,-2.99,46550,0,0,45160,45160
584,دجابر,داروسازي‌ جابرابن‌حيان‌,6,10698,210108720,20240,19640,19640,-600,-2.96,20240,0,0,19640,19640
585,ومشان,س. فني و مهندسي مشانير,5,908,62628392,71847,68974,68974,-2873,-4,71838,-9,-0.01,68974,68974
586,غپاك,لبنيات‌ پاك‌,5,3027,90174330,30710,29790,29790,-920,-3,30710,0,0,29790,29790
587,حآسا,آسيا سير ارس,5,2859,111280857,40126,38923,38923,-1203,-3,40123,-3,-0.01,38923,38923
588,غپآذر,شير پگاه آذربايجان شرقي,5,1304,83124784,65717,63746,63746,-1971,-3,65714,-3,0,63746,63746
589,سهگمت,سيمان‌هگمتان‌,5,5990,143879800,24760,24020,24020,-740,-2.99,24760,0,0,24020,24020
590,وزمين,بانك ايران زمين,5,317170,4031865040,12971,12712,12712,-259,-2,12920,-51,-0.39,12712,12712
591,برن0003پ01,برنج طارم0003تجارت مازندران(پ),5,368,103828000,282200,281000,282200,0,0,282141,-59,-0.02,281000,283000
592,پخش,پخش البرز,5,12573,387348984,31760,30808,30808,-952,-3,31752,-8,-0.03,30808,30808
593,فسا,پتروشيمي فسا,5,19439,33746104,1771,1736,1736,-35,-1.98,1771,0,0,1736,1736
594,وايران,ليزينگ ايرانيان,5,3163,38620230,12580,12210,12210,-370,-2.94,12580,0,0,12210,12210
595,قيستو,شركت قند بيستون,5,4073,75346427,19269,18499,18499,-770,-4,19263,-6,-0.03,18499,18499
596,تكنو,تكنوتار,5,49475,1053322750,21940,21290,21290,-650,-2.96,21930,-10,-0.05,21290,21290
597,تكنار,مجتمع معادن مس تكنار,5,481,55412643,117554,115203,115203,-2351,-2,117547,-7,-0.01,115203,115203
598,لسرما,سرما آفرين‌,5,6683,156114880,24080,23360,23360,-720,-2.99,24080,0,0,23360,23360
599,اخزا713,اسنادخزانه-م13بودجه97-000518,5,1154,1096846167,951398,952000,951000,-398,-0.04,950473,-925,-0.1,950021,952000
600,لخانه,لوازم‌ خانگي‌ پارس‌,5,3190,85638740,27964,26846,26846,-1118,-4,27959,-5,-0.02,26846,26846
601,افران2,صندوق س افرا نماد پايدار-ثابت,5,21000000,21000000,13287,1,1,-13286,-99.99,1,-13286,-99.99,1,1
602,تكشا,گسترش‌صنايع‌وخدمات‌كشاورزي‌,5,625,28156250,46440,45050,45050,-1390,-2.99,46440,0,0,45050,45050
603,لخزر,پارس‌ خزر,5,160,28944000,186490,180900,180900,-5590,-3,186490,0,0,180900,180900
604,اخزا810,اسنادخزانه-م10بودجه98-001006,5,1959,1721813277,880111,878020,880000,-111,-0.01,878925,-1186,-0.13,878020,880000
605,مداران,داده‌پردازي‌ايران‌,4,15757,383998090,25120,24370,24370,-750,-2.99,25110,-10,-0.04,24370,24370
606,فافزا,فولاد افزا سپاهان,4,4051,197834636,49832,48836,48836,-996,-2,49822,-10,-0.02,48836,48836
607,بكاب,صنايع‌جوشكاب‌يزد,4,145,50613700,359850,349060,349060,-10790,-3,359840,-10,0,349060,349060
608,دبالك,مواد اوليه دارويي البرز بالك,4,11360,229347040,20813,20189,20189,-624,-3,20810,-3,-0.01,20189,20189
609,قشير,قند شيروان قوچان و بجنورد,4,8680,216236160,25682,24912,24912,-770,-3,25679,-3,-0.01,24912,24912
610,دتوزيعح,ح . توزيع دارو پخش,4,51715,2378890000,31405,46000,46000,14595,46.47,46000,14595,46.47,46000,46000
611,كگاز,شيشه‌ و گاز,4,2501,45568220,18780,18220,18220,-560,-2.98,18780,0,0,18220,18220
612,سدبير,س. تدبيرگران فارس وخوزستان,4,2902,251670146,89405,86723,86723,-2682,-3,89391,-14,-0.02,86723,86723
613,لابسا,آبسال‌,4,1233,63252900,52880,51300,51300,-1580,-2.99,52880,0,0,51300,51300
614,پاسا,ايران‌ياساتايرورابر,4,884,22877920,26680,25880,25880,-800,-3,26680,0,0,25880,25880
615,هپارس102,اختيارف ت پارس-177010-01/02/05,4,12696,64825776,4923,5106,5106,183,3.72,5106,183,3.72,5106,5106
616,زعف0008پ08,زعفران0008نگين روستا(پ),4,1090,130241040,117819,119487,119486,1667,1.41,119487,1668,1.42,119485,119488
617,ضشنا8002,اختيارخ شپنا-9000-1400/08/16,4,102,287008000,1851,2770,3529,1678,90.65,2814,963,52.03,2770,3529
618,دفارا,داروسازي‌ فارابي‌,4,1999,124957490,64440,62510,62510,-1930,-3,64440,0,0,62510,62510
619,ضترا8055,اختيارخ شتران-5000-1400/08/09,4,40,170000000,3002,4250,4250,1248,41.57,4250,1248,41.57,4250,4250
620,افرا,افرانت,4,1998,66461472,34292,33264,33264,-1028,-3,34291,-1,0,33264,33264
621,غمارگ,مارگارين‌,4,2955,89772900,31310,30380,30380,-930,-2.97,31310,0,0,30380,30380
622,ضپاس7028,اختيارخ وپارس-2000-1400/07/28,4,49,29490000,519,650,600,81,15.61,602,83,15.99,600,650
623,وحافظ,بيمه حافظ,4,1253,80773392,65779,64464,64464,-1315,-2,65768,-11,-0.02,64464,64464
624,شستان,پتروشيمي گلستان,4,17145,64585215,3843,3767,3767,-76,-1.98,3842,-1,-0.03,3767,3767
625,لپيام,گسترش صنايع پيام,4,755,40600125,54872,53775,53775,-1097,-2,54870,-2,0,53775,53775
626,وآذر,سرمايه‌گذاري‌توسعه‌آذربايجان‌,4,384,31399680,84290,81770,81770,-2520,-2.99,84290,0,0,81770,81770
627,پسهند,صنايع‌ لاستيكي‌  سهند,4,1675,62310000,38350,37200,37200,-1150,-3,38350,0,0,37200,37200
628,بالاس,مهندسي ساختمان تاسيسات راه آهن,4,445,24895970,57676,55946,55946,-1730,-3,57675,-1,0,55946,55946
629,قهكمت,قندهكمتان‌,4,468,20919600,46080,44700,44700,-1380,-2.99,46080,0,0,44700,44700
630,سيلام,سيمان‌ ايلام‌,4,5180,56306600,11200,10870,10870,-330,-2.95,11200,0,0,10870,10870
631,ضپاس2004,اختيارخ وپارس-4000-1400/02/29,4,130,130000,2,1,1,-1,-50,1,-1,-50,1,1
632,اخزا906,اسنادخزانه-م6بودجه99-020321,4,1194,908496856,760076,798078,759999,-77,-0.01,760885,809,0.11,741541,798078
633,آ س پ,آ.س.پ,4,2965,46408180,16136,15652,15652,-484,-3,16136,0,0,15652,15652
634,وليز,ليزينگ‌ايران‌,4,15953,147724780,9540,9260,9260,-280,-2.94,9540,0,0,9260,9260
635,ضشنا8004,اختيارخ شپنا-12000-1400/08/16,4,14,28000000,1500,2000,2000,500,33.33,2000,500,33.33,2000,2000
636,وآوا,سرمايه گذاري آوا نوين,4,3261,28132647,8893,8627,8627,-266,-2.99,8893,0,0,8627,8627
637,سمايه,بانك سرمايه,4,30790,150008880,4971,4872,4872,-99,-1.99,4970,-1,-0.02,4872,4872
638,ضمخا7070,اختيارخ اخابر-20000-1400/07/28,4,11,3113000,526,300,251,-275,-52.28,283,-243,-46.2,251,302
639,ضغدر3002,اختيارخ وغدير-8200-1400/03/26,4,30,68200000,2156,2020,2250,94,4.36,2273,117,5.43,2020,2550
640,گكيش,توريستي ورفاهي آبادگران كيش,4,4976,236255504,48447,47479,47479,-968,-2,48435,-12,-0.02,47479,47479
641,ساربيل,سيمان آرتا اردبيل,4,2800,145236000,53470,51870,51870,-1600,-2.99,53470,0,0,51870,51870
642,اخزا805,اسنادخزانه-م5بودجه98-000422,4,1077,1039336085,968000,965002,969000,1000,0.1,965029,-2971,-0.31,965001,969000
643,رنيك,جنرال مكانيك,4,2255,48793690,22307,21638,21638,-669,-3,22306,-1,0,21638,21638
644,خزر,فنرسازي‌زر,4,1149,53037840,47580,46160,46160,-1420,-2.98,47580,0,0,46160,46160
645,سبهان,سيمان‌ بهبهان‌,4,730,100652400,142140,137880,137880,-4260,-3,142130,-10,-0.01,137880,137880
646,كسعدي,كاشي‌ سعدي‌,4,1882,38976220,21350,20710,20710,-640,-3,21350,0,0,20710,20710
647,نمرينو,ايران‌ مرينوس‌,3,1194,131041500,113140,109750,109750,-3390,-3,113130,-10,-0.01,109750,109750
648,داراب,پتروشيمي داراب,3,20000,48040000,2451,2402,2402,-49,-2,2451,0,0,2402,2402
649,ضغدر3004,اختيارخ وغدير-11200-1400/03/26,3,33,22155000,450,555,650,200,44.44,671,221,49.11,555,700
650,ضسپا3000,اختيارخ خساپا-1400-1400/03/26,3,15,7020000,414,468,468,54,13.04,468,54,13.04,468,468
651,غاذر,كشت‌وصنعت‌پياذر,3,399,21637770,55900,54230,54230,-1670,-2.99,55900,0,0,54230,54230
652,ضپنا8001,اختيارخ رمپنا-12000-1400/08/05,3,31,145500000,4012,4500,4800,788,19.64,4694,682,17,4500,4800
653,ضغدر3003,اختيارخ وغدير-9200-1400/03/26,3,52,77800000,1194,1500,1400,206,17.25,1496,302,25.29,1400,1500
654,دروز,داروسازي‌ روزدارو,3,2625,90483750,35530,34470,34470,-1060,-2.98,35530,0,0,34470,34470
655,عيار2,صندوق س. پشتوانه طلاي مفيد,3,30000,30000,25013,1,1,-25012,-100,1,-25012,-100,1,1
656,چكاوه,صنايع‌كاغذسازي‌كاوه‌,3,24563,438940810,18420,17870,17870,-550,-2.99,18420,0,0,17870,17870
657,ثغرب,شركت سرمايه گذاري مسكن شمالغرب,3,4852,37471996,7961,7723,7723,-238,-2.99,7961,0,0,7723,7723
658,غفارس,شير پاستوريزه پگاه فارس,3,1851,32899674,18323,17774,17774,-549,-3,18323,0,0,17774,17774
659,ثعمرا,عمران و توسعه شاهد,3,3010,38100580,13049,12658,12658,-391,-3,13049,0,0,12658,12658
660,هنوري102,اختيارف ت نوري73761-01/02/15,3,28511,148827420,6070,5220,5220,-850,-14,5220,-850,-14,5220,5220
661,داسوه,داروسازي‌ اسوه‌,3,1269,45963180,37330,36220,36220,-1110,-2.97,37330,0,0,36220,36220
662,ولراز,ليزينگ رازي,3,367,20167751,56074,54953,54953,-1121,-2,56073,-1,0,54953,54953
663,افاد844,منفعت دولت8-ش.خاص ساير0205,3,563000,540480000000,970000,960000,960000,-10000,-1.03,960000,-10000,-1.03,960000,960000
664,ومعلم,بيمه معلم,3,12240,59204880,4986,4837,4837,-149,-2.99,4986,0,0,4837,4837
665,ثشرق,سرمايه گذاري مسكن شمال شرق,3,6200,41478000,6890,6690,6690,-200,-2.9,6890,0,0,6690,6690
666,ولملت,واسپاري ملت,3,4415,33642300,7850,7620,7620,-230,-2.93,7850,0,0,7620,7620
667,اخزا807,اسنادخزانه-م7بودجه98-000719,3,2552,2342781017,918058,919000,918011,-47,-0.01,918018,-40,0,918011,922000
668,رتكو,كنترل‌خوردگي‌تكين‌كو,3,100600,1734344000,17770,17240,17240,-530,-2.98,17750,-20,-0.11,17240,17240
669,بنو,بيمه تجارت نو,3,1227,37926570,31865,30910,30910,-955,-3,31864,-1,0,30910,30910
670,تپكو,توليدتجهيزات‌سنگين‌هپكو,3,3958,20989274,5411,5303,5303,-108,-2,5411,0,0,5303,5303
671,غبهار,كشت وصنعت بهاران گلبهار خراسان,3,600,20097600,34179,33496,33496,-683,-2,34178,-1,0,33496,33496
672,ضپنا8002,اختيارخ رمپنا-14000-1400/08/05,3,201,563300000,2250,3300,2600,350,15.56,2802,552,24.53,2600,3300
673,تشتاد,صنايع توليدي اشتاد ايران‌,3,1666,25614750,15688,15375,15375,-313,-2,15688,0,0,15375,15375
674,اخزا813,اسنادخزانه-م13بودجه98-010219,3,2108,1720130770,817786,816000,816001,-1785,-0.22,816001,-1785,-0.22,816000,816110
675,غگلستا,شير پاستوريزه پگاه گلستان,3,1100,30430400,28519,27664,27664,-855,-3,28518,-1,0,27664,27664
676,اراد37,مرابحه عام دولت3-ش.خ 0005,2,10000,9890000000,1000000,990000,988000,-12000,-1.2,989000,-11000,-1.1,988000,990000
677,شزنگ,تجهيزنيروي‌زنگان‌,2,44,10112080,234510,229820,229820,-4690,-2,234508,-2,0,229820,229820
678,مهان01,اجاره مهرآيندگان لوتوس0311,2,100000,100000100000,1000001,1000001,1000001,0,0,1000001,0,0,1000001,1000001
679,اوان,مبين وان كيش,2,12912,684116496,54621,52983,52983,-1638,-3,54598,-23,-0.04,52983,52983
680,ضفار3000,اختيارخ فارس-8000-1400/03/05,2,6,5998000,140,998,1000,860,614.29,1000,860,614.29,998,1000
681,داريك,صندوق س.اعتماد داريك-د,2,1281,13542170,10566,10570,10574,8,0.08,10572,6,0.06,10570,10574
682,تملي702,تسهيلات مسكن ب. ملي-ارديبهشت97,2,22,9436812,451522,428946,428946,-22576,-5,428946,-22576,-5,428946,428946
683,وارس,سرمايه گذاري ارس صبا,2,1300,21953100,17231,16887,16887,-344,-2,17231,0,0,16887,16887
684,لازما,كارخانه هاي صنعتي آزمايش,2,415,13961015,34327,33641,33641,-686,-2,34327,0,0,33641,33641
685,كپشير,پشم‌شيشه‌ايران‌,2,332,12874960,39970,38780,38780,-1190,-2.98,39970,0,0,38780,38780
686,پلاسك,پلاسكوكار,2,1693,12274250,7470,7250,7250,-220,-2.95,7470,0,0,7250,7250
687,حاريا,كشتيراني آريا,2,15927,442659111,28951,27793,27793,-1158,-4,28924,-27,-0.09,27793,27793
688,فلات,گروه صنايع معادن فلات ايرانيان,2,1514,23211134,15643,15331,15331,-312,-1.99,15643,0,0,15331,15331
689,غشاذر,پگاه‌آذربايجان‌غربي‌,2,7059,68472300,9990,9700,9700,-290,-2.9,9990,0,0,9700,9700
690,ثاباد,توريستي ورفاهي آبادگران ايران,2,1953,102630150,54170,52550,52550,-1620,-2.99,54170,0,0,52550,52550
691,قنيشا,قند  نيشابور,2,381,23804880,64410,62480,62480,-1930,-3,64410,0,0,62480,62480
692,غشصفا,شيرپاستوريزه‌پگاه‌اصفهان‌,2,7275,197298000,27950,27120,27120,-830,-2.97,27950,0,0,27120,27120
693,تملي707,تسهيلات مسكن ب. ملي-مهر97,2,17,11857390,704356,669139,738000,33644,4.78,697493,-6863,-0.97,669139,738000
694,داوه,داروسازي آوه سينا,2,765,14974110,20179,19574,19574,-605,-3,20179,0,0,19574,19574
695,زمگسا,كشاورزي‌ ودامپروي‌ مگسال‌,2,420,13238400,32490,31520,31520,-970,-2.99,32490,0,0,31520,31520
696,فملي2,ملي‌ صنايع‌ مس‌ ايران‌,2,40423000,514808560000,12350,12720,12800,450,3.64,12736,386,3.13,12720,12800
697,ضپيك7041,اختيارخ تاپيكو-9000-00/07/18,2,14,34200000,1618,2300,2500,882,54.51,2443,825,50.99,2300,2500
698,زعف0008پ11,زعفران0008نگين سحرخيز(پ),2,700,84000000,120306,120000,120000,-306,-0.25,120000,-306,-0.25,120000,120000
699,زنجان,صنايع كشاورزي وكود زنجان,2,1447,13257414,9348,9162,9162,-186,-1.99,9348,0,0,9162,9162
700,غمهرا,توليدي‌مهرام‌,2,800,94664000,121980,118330,118330,-3650,-2.99,121970,-10,-0.01,118330,118330
701,اراد374,مرابحه عام دولت3-ش.خ 0005,2,1090000,1074828000000,1000000,985800,988860,-11140,-1.11,986081,-13919,-1.39,985800,988860
702,زكشت,كشاورزي مكانيزه اصفهان كشت,2,301,11787160,40371,39160,39160,-1211,-3,40371,0,0,39160,39160
703,وايرا,سرمايه گذاري صنايع ايران,2,2726,31929638,12201,11713,11713,-488,-4,12200,-1,-0.01,11713,11713
704,وسيستا,شركت س استان سيستان وبلوچستان,2,59000,43542000,760,738,738,-22,-2.89,760,0,0,738,738
705,ثالوند,سرمايه گذاري مسكن الوند,2,400,12517600,32261,31294,31294,-967,-3,32261,0,0,31294,31294
706,تپولا,مهندسي مرآت پولاد,2,297,10231947,35154,34451,34451,-703,-2,35154,0,0,34451,34451
707,ولغدر,ليزينگ‌خودروغدير,2,31157,743717590,24600,23870,23870,-730,-2.97,24590,-10,-0.04,23870,23870
708,ضصاد3000,اختيارخ وبصادر-1800-1400/03/12,2,24,11600000,460,460,500,40,8.7,483,23,5,460,500
709,ضجار2005,اختيارخ وتجارت-4000-1400/02/22,2,4,4000,1,1,1,0,0,1,0,0,1,1
710,خكمك,كمك‌فنرايندامين‌,2,2000,52640000,27130,26320,26320,-810,-2.99,27130,0,0,26320,26320
711,فالوم,آلومتك‌,2,917,32600267,36276,35551,35551,-725,-2,36275,-1,0,35551,35551
712,تپمپي,پمپ‌ سازي‌ ايران‌,2,800,15064000,19410,18830,18830,-580,-2.99,19410,0,0,18830,18830
713,ضترا3004,اختيارخ شتران-10000-1400/03/09,2,2,444000,41,111,333,292,712.2,222,181,441.46,111,333
714,پشاهن,توليدي پلاستيك‌ شاهين,2,641,4967109,7380,7749,7749,369,5,7380,0,0,7749,7749
715,ثتوسا,س.توسعه و عمران استان اردبيل,2,410,15636580,38916,38138,38138,-778,-2,38915,-1,0,38138,38138
716,دشيمي,شيمي‌ داروئي‌ داروپخش‌,2,371,10989020,30530,29620,29620,-910,-2.98,30530,0,0,29620,29620
717,تملي704,تسهيلات مسكن ب. ملي-تير97,2,7,4177782,628237,596826,596826,-31411,-5,596826,-31411,-5,596826,596826
718,تملي804,تسهيلات مسكن ب. ملي-تير98,2,9,5125212,599440,569468,569468,-29972,-5,569468,-29972,-5,569468,569468
719,اخزا804,اسنادخزانه-م4بودجه98-000421,2,506,488315000,965315,965002,969000,3685,0.38,965049,-266,-0.03,965002,969000
720,اراد55,مرابحه عام دولت5-ش.خ 0209,2,400,385000400,970000,940010,969998,-2,0,962501,-7499,-0.77,940010,969998
721,حخزر,كشتيراني درياي خزر,2,818,22531810,28396,27545,27545,-851,-3,28396,0,0,27545,27545
722,كساوه,صنايع‌ كاشي‌ و سراميك‌ سينا,2,479,32787550,70560,68450,68450,-2110,-2.99,70560,0,0,68450,68450
723,كهرام,توليدي گرانيت بهسرام,2,96,10459392,113491,108952,108952,-4539,-4,113489,-2,0,108952,108952
724,زير0003پ01,زيره سبز0003كيميابذر(پ),2,500,292967500,623482,585935,585935,-37547,-6.02,585935,-37547,-6.02,585935,585935
725,سهرمز,سيمان‌هرمزگان‌,2,950,22876000,24820,24080,24080,-740,-2.98,24820,0,0,24080,24080
726,كساپا,سايپاشيشه‌,2,800,30248000,38970,37810,37810,-1160,-2.98,38970,0,0,37810,37810
727,كاسپين,داروسازي كاسپين تامين,1,200,5009800,25823,25049,25049,-774,-3,25823,0,0,25049,25049
728,آساميد4,صندوق س.مشترك آسمان اميد -د,1,24700000,297042200000,11994,12026,12026,32,0.27,12026,32,0.27,12026,12026
729,زعف0008پ10,زعفران0008نگين طلاي سرخ(پ),1,41,5067600,122194,123600,123600,1406,1.15,123600,1406,1.15,123600,123600
730,فلامي,لاميران‌,1,1000,43470000,44810,43470,43470,-1340,-2.99,44810,0,0,43470,43470
731,كاريس4,صندوق س.سپهر كاريزما-س,1,5000000,52500000000,10325,10500,10500,175,1.69,10500,175,1.69,10500,10500
732,ركيش,كارت اعتباري ايران كيش,1,217,5001850,23760,23050,23050,-710,-2.99,23760,0,0,23050,23050
733,آريا2,پليمر آريا ساسول,1,600000,53961000000,87499,89935,89935,2436,2.78,89935,2436,2.78,89935,89935
734,غپونه,نوش پونه مشهد,1,600,10942200,18609,18237,18237,-372,-2,18609,0,0,18237,18237
735,ولشرق,ليزينگ ايران و شرق,1,1000,8455000,8716,8455,8455,-261,-2.99,8716,0,0,8455,8455
736,اراد644,مرابحه عام دولتي64-ش.خ0111,1,20000,18835940000,944500,941797,941797,-2703,-0.29,941797,-2703,-0.29,941797,941797
737,ضترا8057,اختيارخ شتران-7000-1400/08/09,1,10,15000000,1800,1500,1500,-300,-16.67,1500,-300,-16.67,1500,1500
738,ضغدر3001,اختيارخ وغدير-7200-1400/03/26,1,10,34500000,2980,3450,3450,470,15.77,3450,470,15.77,3450,3450
739,صفارس307,صكوك اجاره فارس307- 3ماهه18%,1,300,291000000,960000,970000,970000,10000,1.04,970000,10000,1.04,970000,970000
740,كفرآور,فرآورده هاي سيمان شرق,1,220,5090140,23609,23137,23137,-472,-2,23609,0,0,23137,23137
741,ضگل3001,اختيارخ كگل-10595-1400/03/23,1,5,16512500,3025,2500,2500,-525,-17.36,2500,-525,-17.36,2500,2500
742,صايپا0122,صكوك مرابحه سايپا012-3ماهه 16%,1,910000,910000000000,1000002,1000000,1000000,-2,0,1000000,-2,0,1000000,1000000
743,اخزا723,اسنادخزانه-م23بودجه97-000824,1,1,900302,900001,900302,900302,301,0.03,900302,301,0.03,900302,900302
744,كشرق,صنعتي و معدني شمال شرق شاهرود,1,59,5265632,92008,89248,89248,-2760,-3,92008,0,0,89248,89248
745,كصدف,كاشي صدف سرام استقلال آباده,1,242,5989984,25257,24752,24752,-505,-2,25257,0,0,24752,24752
746,اراد61,مرابحه عام دولت61-ش.خ0309,1,14000,14000000000,1000000,1000000,1000000,0,0,1000000,0,0,1000000,1000000
747,ثاژن,سخت آژند,1,5000,47370000,9667,9474,9474,-193,-2,9666,-1,-0.01,9474,9474
748,سفار,سيمان‌فارس‌,1,35,5170200,152280,147720,147720,-4560,-2.99,152280,0,0,147720,147720
749,اراد79,مرابحه عام دولت79-ش.خ010612,1,2000,1920000000,980000,960000,960000,-20000,-2.04,960000,-20000,-2.04,960000,960000
750,آرمان,بيمه آرمان,1,100000,806100000,8225,8061,8061,-164,-1.99,8218,-7,-0.09,8061,8061
751,فخوز4,فولاد  خوزستان,1,20000000,300400000000,14450,15020,15020,570,3.94,15020,570,3.94,15020,15020
752,شپنا2,پالايش نفت اصفهان,1,41725185,414331087050,9640,9930,9930,290,3.01,9930,290,3.01,9930,9930
753,ضمخا7074,اختيارخ اخابر-36000-1400/07/28,1,1,350000,245,350,350,105,42.86,350,105,42.86,350,350
754,وسنا,سرمايه گذاري نيروگاهي ايران,1,648,9962352,15687,15374,15374,-313,-2,15687,0,0,15374,15374
755,بايكا,كارخانجات كابلسازي ‌ايران‌,1,290,11923930,41956,41117,41117,-839,-2,41955,-1,0,41117,41117
756,چافست,افست‌,1,4916,79196760,16600,16110,16110,-490,-2.95,16600,0,0,16110,16110
757,كترام,توليدي‌ كاشي‌ تكسرام‌,1,175,8239000,48530,47080,47080,-1450,-2.99,48530,0,0,47080,47080
758,پست0008پ04,پسته فندقي32-30سبزدانه0008(پ),1,10,15516670,1620000,1551667,1551667,-68333,-4.22,1551667,-68333,-4.22,1551667,1551667
759,انرژي2,فعالان بورس انرژي,1,1015,247091600,249670,243440,243440,-6230,-2.5,249640,-30,-0.01,243440,243440
760,دپارس2,پارس‌ دارو,1,1271000,58682070000,47590,46170,46170,-1420,-2.98,46170,-1420,-2.98,46170,46170
761,خنصير,مهندسي‌نصيرماشين‌,1,183,19253430,108460,105210,105210,-3250,-3,108460,0,0,105210,105210
762,آينده,بازرگاني آينده سازان بهشت پارس,1,287,5470220,19854,19060,19060,-794,-4,19854,0,0,19060,19060
763,قزوين,كارخانجات‌ قند قزوين‌,1,150,5758500,39570,38390,38390,-1180,-2.98,39570,0,0,38390,38390
764,شرق1400,مشاركت ليزينگ ايران وشرق140010,1,19,19152000,1008000,1008000,1008000,0,0,1008000,0,0,1008000,1008000
765,ودي2,بيمه  دي,1,5000000,101200000000,20865,20240,20240,-625,-3,20240,-625,-3,20240,20240
766,ارفع2,شركت آهن و فولاد ارفع,1,6000000,80280000000,13349,13380,13380,31,0.23,13380,31,0.23,13380,13380
767,وپاسار2,بانك  پاسارگاد,1,8217800,137483794000,16560,16730,16730,170,1.03,16730,170,1.03,16730,16730
768,تنوين2,تامين سرمايه نوين,1,6900000,49818000000,7210,7220,7220,10,0.14,7220,10,0.14,7220,7220
769,كابگن,توليدي و صنعتي آبگينه‌,1,450,2335050,5138,5189,5189,51,0.99,5138,0,0,5189,5189
770,نگين,ص.س. زمين و ساختمان نگين شهرري,1,200,9520000,47550,47600,47600,50,0.11,47600,50,0.11,47600,47600
771,واميد2,گروه مديريت سرمايه گذاري اميد,1,11400000,137484000000,12430,12060,12060,-370,-2.98,12060,-370,-2.98,12060,12060
772,ضخود4001,اختيارخ خودرو-1600-1400/04/02,1,80,32000000,350,400,400,50,14.29,400,50,14.29,400,400
773,ضمخا7077,اختيارخ اخابر-7000-1400/07/28,1,1,2700000,4800,2700,2700,-2100,-43.75,2700,-2100,-43.75,2700,2700
774,ثنام,س ساختماني ب نام آوران مهندسي,1,330,5386920,16657,16324,16324,-333,-2,16657,0,0,16324,16324
775,حپارسا,توسعه حمل و نقل ريلي پارسيان,1,160,5467680,35229,34173,34173,-1056,-3,35229,0,0,34173,34173
776,ضترا3001,اختيارخ شتران-7000-1400/03/09,1,19,28500000,1000,1500,1500,500,50,1500,500,50,1500,1500
777,غديس,پاكديس,1,390,5080920,13430,13028,13028,-402,-2.99,13430,0,0,13028,13028
778,اراد454,مرابحه عام دولت4-ش.خ 0107,1,2105000,2035482375000,988000,966975,966975,-21025,-2.13,966975,-21025,-2.13,966975,966975
779,زماهان,مجتمع توليد گوشت مرغ ماهان,1,300,5994600,20599,19982,19982,-617,-3,20599,0,0,19982,19982
780,دشيري,شيرين دارو,1,47,10866447,235919,231201,231201,-4718,-2,235916,-3,0,231201,231201
781,بالبر,كابل‌ البرز,1,100,5729000,59060,57290,57290,-1770,-3,59060,0,0,57290,57290
782,دقاضي,داروسازي شهيد قاضي,1,120,5085960,43247,42383,42383,-864,-2,43247,0,0,42383,42383
783,فنفت,صنايع تجهيزات نفت,1,172,5570908,33050,32389,32389,-661,-2,33050,0,0,32389,32389
784,وسكرشا,س.سهام عدالت استان كرمانشاه,1,5000,6115000,1260,1223,1223,-37,-2.94,1260,0,0,1223,1223
785,ضشنا2003,اختيارخ شپنا-14000-1400/02/27,1,1,1000,1,1,1,0,0,1,0,0,1,1
786,شسم,توليد سموم‌ علف‌ كش,1,80,7345680,90021,91821,91821,1800,2,90022,1,0,91821,91821
787,اراد214,مرابحه عام دولت2ش.خ صادرات0212,1,18506000,17501568344000,1000000,945724,945724,-54276,-5.43,945724,-54276,-5.43,945724,945724
788,تملي703,تسهيلات مسكن ب. ملي-خرداد97,1,11,5478715,524278,498065,498065,-26213,-5,498065,-26213,-5,498065,498065
789,وسگيلا,شركت س استان گيلان,1,7000,5229000,770,747,747,-23,-2.99,770,0,0,747,747
790,خفناور,مهندسي صنعتي روان فن آور,1,500,23711000,48389,47422,47422,-967,-2,48388,-1,0,47422,47422
791,وسلرستا,شركت س استان لرستان,1,6000,5238000,900,873,873,-27,-3,900,0,0,873,873
792,غگز,گز سكه,1,1500,30300000,20200,20200,20200,0,0,20200,0,0,20200,20200
793,خموتور,موتورسازان‌تراكتورسازي‌ايران‌,1,1371,19920630,14970,14530,14530,-440,-2.94,14970,0,0,14530,14530
794,كمرجان,بازرگاني و توليدي مرجان كار,1,419,59711690,146917,142510,142510,-4407,-3,146912,-5,0,142510,142510
795,طملي3001,اختيارف فملي-9000-1400/03/02,1,1,1000,72,1,1,-71,-98.61,1,-71,-98.61,1,1
796,ثپرديس,سرمايه گذاري مسكن پرديس,1,600,5913000,10159,9855,9855,-304,-2.99,10159,0,0,9855,9855
797,كمند2,صندوق س. با درآمد ثابت كمند,1,200000000,200000000,10027,1,1,-10026,-99.99,1,-10026,-99.99,1,1
798,ضفلا7004,اختيارخ فولاد-9986-1400/07/25,1,10,15000000,1,1500,1500,1499,149900,1500,1499,149900,1500,1500
799,ولصنم,ليزينگ‌صنعت‌ومعدن‌,1,3000,32310000,11100,10770,10770,-330,-2.97,11100,0,0,10770,10770
800,آوا2,صندوق س.سهام آواي معيار-س,1,1000000,1000000,6432,1,1,-6431,-99.98,1,-6431,-99.98,1,1
801,ضمخا7069,اختيارخ اخابر-18000-1400/07/28,1,1,301000,350,301,301,-49,-14,301,-49,-14,301,301
802,شكبير2,پتروشيمي اميركبير,1,12100000,999665700000,82617,82617,82617,0,0,82617,0,0,82617,82617
803,اخزا9082,اسنادخزانه-م8بودجه99-020606,1,142500,90630000000,628591,636000,636000,7409,1.18,636000,7409,1.18,636000,636000
