,نماد,نام,تعداد,حجم,ارزش,دیروز,اولین,آخرین معامله - مقدار,آخرین معامله - تغییر,آخرین معامله - درصد,قیمت پایانی - مقدار,قیمت پایانی - تغییر,قیمت پایانی - درصد,کمترین,بیشترین
2,فتوسا,توليد و توسعه سرب روي ايرانيان,2410158,64999838,509728729596,1000,7842,7842,6842,684.2,7842,6842,684.2,7842,7842
3,فگستر,گسترش صنايع روي ايرانيان,22886,2446653,19286965599,7508,7883,7883,375,4.99,7883,375,4.99,7883,7883
4,پالايش,صندوق پالايشي يکم-سهام,22867,20362621,1408283934370,70540,70590,68870,-1670,-2.37,69160,-1380,-1.96,67680,71050
5,بركت,گروه دارويي بركت,19318,60126139,1571043588820,25480,26100,26610,1130,4.43,26130,650,2.55,25110,26630
6,دارا يكم,صندوق واسطه گري مالي يكم-سهام,18523,9760153,1210519641360,127970,127300,122930,-5040,-3.94,124030,-3940,-3.08,121660,127840
7,كزغال,زغال سنگ پروده طبس,14416,8450733,281325037344,33791,34800,32400,-1391,-4.12,33290,-501,-1.48,32170,34800
8,فملي,ملي‌ صنايع‌ مس‌ ايران‌,11629,81237713,1011871979340,12960,13000,12330,-630,-4.86,12460,-500,-3.86,12320,13000
9,امينح,ح . تامين سرمايه امين,11391,14110415,72486210283,5175,5050,5433,258,4.99,5137,-38,-0.73,4800,5440
10,ثاميد,توسعه و عمران اميد,9577,110502386,151229624402,1333,1370,1399,66,4.95,1369,36,2.7,1293,1399
11,اپال,فرآوري معدني اپال كاني پارس,9356,21321690,405637352090,18840,19000,19160,320,1.7,19020,180,0.96,18180,19440
12,شستا,سرمايه گذاري تامين اجتماعي,8848,33177607,341635585540,10560,10600,10350,-210,-1.99,10300,-260,-2.46,10160,10620
13,خودرو,ايران‌ خودرو,8795,261264767,480799799046,1919,1890,1824,-95,-4.95,1840,-79,-4.12,1824,1925
14,خساپا,سايپا,8200,293165973,510155345844,1821,1800,1730,-91,-5,1740,-81,-4.45,1730,1820
15,كرمان,س. توسعه و عمران استان كرمان,7992,269254642,267927765464,1005,980,1005,0,0,995,-10,-1,955,1030
16,بوعلي,پتروشيمي بوعلي سينا,7480,4273124,198149318920,47100,47700,44770,-2330,-4.95,46370,-730,-1.55,44750,48040
17,شتران,پالايش نفت تهران,7138,51151336,388068635440,7870,7890,7480,-390,-4.96,7590,-280,-3.56,7480,7950
18,ولپارس,ليزينگ پارسيان,6047,13433935,54610706162,4276,4063,4063,-213,-4.98,4065,-211,-4.93,4063,4160
19,وكبهمن,مديريت سرمايه گذاري كوثربهمن,6042,5202045,54558979384,10482,10770,10387,-95,-0.91,10488,6,0.06,10350,10770
20,وتجارت,بانك تجارت,6020,238430429,531990066536,2316,2230,2201,-115,-4.97,2231,-85,-3.67,2201,2275
21,وسپهر,سرمايه گذاري مالي سپهرصادرات,6008,13580462,123502973042,9093,9095,9095,2,0.02,9094,1,0.01,9094,9097
22,امين,تامين سرمايه امين,5704,3800437,27021451220,6990,7000,7280,290,4.15,7090,100,1.43,7000,7320
23,وبصادر,بانك صادرات ايران,4943,212875531,425342665999,2062,2010,1959,-103,-5,1998,-64,-3.1,1959,2030
24,ذوب,سهامي ذوب آهن  اصفهان,4369,98106472,301938106333,3223,3198,3062,-161,-5,3078,-145,-4.5,3062,3198
25,غگيلا,شيرپاستوريزه پگاه گيلان,4315,14049492,265535398800,13345,18900,18900,5555,41.63,18900,5555,41.63,18900,18900
26,پترول,گروه پتروشيمي س. ايرانيان,4040,24890346,214351795270,8810,8760,8400,-410,-4.65,8610,-200,-2.27,8370,8960
27,آبادا,توليد نيروي برق آبادان,3916,3279087,31715827250,10170,9670,9670,-500,-4.92,9670,-500,-4.92,9670,9820
28,امين يكم,صندوق درآمد ثابت امين يكم فردا,3835,442937724,4502593824029,10161,10168,10165,4,0.04,10165,4,0.04,10163,10172
29,شبندر,پالايش نفت بندرعباس,3825,16700717,349602703110,21600,21600,20520,-1080,-5,20930,-670,-3.1,20520,21940
30,شگويا,پتروشيمي تندگويان,3794,18431811,156480207173,8501,8451,8416,-85,-1,8490,-11,-0.13,8300,8671
31,وپارس,بانك‌پارسيان‌,3730,174120594,464914633550,2661,2669,2672,11,0.41,2670,9,0.34,2660,2697
32,پيزد,مجتمع صنايع لاستيك يزد,3486,263473,14988626450,56846,59003,56107,-739,-1.3,56889,43,0.08,54006,59003
33,وسبحان,سرمايه گذاري سبحان,3431,109826002,244555584400,2326,2210,2210,-116,-4.99,2227,-99,-4.26,2210,2324
34,ميدكو,هلدينگ صنايع  معدني خاورميانه,3431,20176083,795055852139,38098,38099,40000,1902,4.99,39406,1308,3.43,38093,40002
35,بگيلان,توسعه مسير برق گيلان,3276,937300,17863684735,19452,18610,18750,-702,-3.61,19238,-214,-1.1,18610,19500
36,وپاسار,بانك  پاسارگاد,3175,47128348,812055465360,17220,17220,17240,20,0.12,17230,10,0.06,17220,17250
37,سيتا,سرمايه گذاري سيمان تامين,3149,5487582,82318018560,15000,15000,15000,0,0,15000,0,0,15000,15010
38,بپيوند,برق و انرژي پيوندگستر پارس,3053,2871939,30362691182,10991,10670,10442,-549,-4.99,10572,-419,-3.81,10442,10858
39,آريا,پليمر آريا ساسول,3036,2219790,178675841977,80610,80610,80223,-387,-0.48,80492,-118,-0.15,78800,81900
40,وخارزم,سرمايه گذاري خوارزمي,2842,38559783,145046353651,3953,3811,3759,-194,-4.91,3762,-191,-4.83,3756,3910
41,كمند,صندوق س. با درآمد ثابت كمند,2730,637317867,6422505004271,10071,10077,10077,6,0.06,10077,6,0.06,10077,10079
42,ساوه,سيمان ساوه,2696,2675923,104769792534,50812,39989,38200,-12612,-24.82,39153,-11659,-22.95,37990,41900
43,خگستر,گسترش‌سرمايه‌گذاري‌ايران‌خودرو,2591,80817063,166364613557,2154,2100,2047,-107,-4.97,2059,-95,-4.41,2047,2130
44,حكشتي,كشتيراني جمهوري اسلامي ايران,2443,7776439,114069514270,15170,15100,14420,-750,-4.94,14670,-500,-3.3,14420,15370
45,وغدير,سرمايه‌گذاري‌غدير(هلدينگ‌,2425,24976653,237499469440,9840,9580,9350,-490,-4.98,9510,-330,-3.35,9350,9870
46,حفاري,حفاري شمال,2162,13518512,78072731290,5830,5750,5820,-10,-0.17,5780,-50,-0.86,5590,6000
47,بترانس,ايران‌ ترانسفو,2148,53778753,127752976466,2489,2403,2365,-124,-4.98,2376,-113,-4.54,2365,2550
48,خبهمن,گروه‌بهمن‌,2111,83453200,98797006279,1239,1194,1178,-61,-4.92,1184,-55,-4.44,1178,1220
49,ولساپا,ليزينگ رايان‌ سايپا,2086,50120655,129758324173,2693,2620,2601,-92,-3.42,2589,-104,-3.86,2559,2699
50,فارس,صنايع پتروشيمي خليج فارس,2066,16972059,155044178910,9390,9440,8930,-460,-4.9,9140,-250,-2.66,8930,9500
51,فجر,فولاد اميركبيركاشان,1829,3667488,246824570030,67310,67000,67270,-40,-0.06,67300,-10,-0.01,65600,68460
52,بجهرم,توسعه مولد نيروگاهي جهرم,1729,26677831,54345743647,2131,2135,2060,-71,-3.33,2037,-94,-4.41,2025,2135
53,غگل,گلوكوزان‌,1721,35528949,84640993524,2503,2380,2414,-89,-3.56,2382,-121,-4.83,2378,2450
54,وپست,پست بانك ايران,1717,13461122,277997322160,21400,21570,20330,-1070,-5,20650,-750,-3.5,20330,22000
55,ومعادن,توسعه‌معادن‌وفلزات‌,1703,14024584,114122035940,8370,8330,8030,-340,-4.06,8160,-210,-2.51,7960,8510
56,وبانك,سرمايه گذاري گروه توسعه ملي,1681,11140644,75933488590,6970,6900,6800,-170,-2.44,6820,-150,-2.15,6700,7000
57,سرو,صندوق س سروسودمند مدبران-سهام,1654,1343965,80907634940,62190,61000,60000,-2190,-3.52,60200,-1990,-3.2,59820,61490
58,شصدف,صنعتي دوده فام,1652,3538887,116012452227,32128,33734,30522,-1606,-5,32782,654,2.04,30522,33734
59,صبا,سرمايه گذاري صبا تامين,1636,3582422,25851394793,7447,7422,7230,-217,-2.91,7395,-52,-0.7,7133,7422
60,ونوين,بانك‌اقتصادنوين‌,1605,45374584,179701330376,4146,4120,3940,-206,-4.97,3960,-186,-4.49,3939,4120
61,افران,صندوق س افرا نماد پايدار-ثابت,1529,57625866,768917376486,13342,13344,13344,2,0.01,13343,1,0.01,13342,13350
62,آريان,سرمايه گذاري پارس آريان,1491,17734889,193608729634,10887,10990,10745,-142,-1.3,10917,30,0.28,10571,11087
63,فخوز,فولاد  خوزستان,1418,11617468,171924352740,15120,15120,14640,-480,-3.17,14800,-320,-2.12,14600,15350
64,كچاد,معدني‌وصنعتي‌چادرملو,1417,5293126,119998347930,23020,23010,22550,-470,-2.04,22700,-320,-1.39,22340,23020
65,كيان,صندوق س. با درآمد ثابت كيان,1403,7205714,205296521990,28465,28490,28516,51,0.18,28491,26,0.09,28480,28524
66,شپنا,پالايش نفت اصفهان,1380,12834013,127698429350,10470,9950,9950,-520,-4.97,9950,-520,-4.97,9950,9950
67,ومعادنح,ح . توسعه‌معادن‌وفلزات‌,1375,7441118,45033772910,6270,6180,5980,-290,-4.63,6050,-220,-3.51,5900,6380
68,جوين,كشت و صنعت جوين,1368,14831728,71214004566,4671,4811,4811,140,3,4801,130,2.78,4685,4811
69,نوري,پتروشيمي نوري,1367,1326715,78850126880,60720,59000,59000,-1720,-2.83,59710,-1010,-1.66,58710,61000
70,اعتماد,صندوق س.اعتماد آفرين پارسيان-د,1341,18875690,689236901280,36479,36498,36520,41,0.11,36515,36,0.1,36497,36531
71,هرمز,فولاد هرمزگان جنوب,1326,13134481,207454642447,15782,15600,15551,-231,-1.46,15795,13,0.08,15551,15941
72,اخابر,مخابرات ايران,1324,12338998,91844028340,7720,7670,7340,-380,-4.92,7470,-250,-3.24,7340,7750
73,كفرا,فراورده‌ هاي‌ نسوزايران‌,1314,2312937,54462847470,45860,24500,23280,-22580,-49.24,23550,-22310,-48.65,23280,24500
74,شيران,س. صنايع‌شيميايي‌ايران,1309,7925996,161016257710,21260,21190,20200,-1060,-4.99,20310,-950,-4.47,20200,21260
75,ماديرا,صنايع ماشين هاي اداري ايران,1302,11812435,82530767661,7254,7123,6892,-362,-4.99,6987,-267,-3.68,6892,7200
76,زاگرس,پتروشيمي زاگرس,1285,967123,197072338298,213697,209000,203013,-10684,-5,203772,-9925,-4.64,203013,210900
77,سرچشمه,سرمايه گذاري مس سرچشمه,1272,9442171,62903742753,6655,6740,6500,-155,-2.33,6662,7,0.11,6401,6900
78,وسكرد,شركت س استان كردستان,1234,51528304,29102525086,581,596,572,-9,-1.55,565,-16,-2.75,552,596
79,آسيا,بيمه آسيا,1211,34405676,61539038589,1821,1810,1794,-27,-1.48,1789,-32,-1.76,1753,1826
80,شبريز,پالايش نفت تبريز,1163,3104871,74944568990,25070,24640,23850,-1220,-4.87,24310,-760,-3.03,23820,25490
81,تاپيكو,س. نفت و گاز و پتروشيمي تأمين,1148,13115241,138055872260,10560,10570,10360,-200,-1.89,10530,-30,-0.28,10230,10770
82,رمپنا,گروه مپنا (سهامي عام),1123,12569059,167803389540,14010,14000,13340,-670,-4.78,13350,-660,-4.71,13310,14000
83,پاكشو,گروه صنعتي پاكشو,1115,12124076,75698736870,6130,6040,6220,90,1.47,6200,70,1.14,5990,6400
84,وخارزمح,ح.سرمايه گذاري خوارزمي,1112,7477873,19766548725,2751,2730,2630,-121,-4.4,2643,-108,-3.93,2570,2770
85,دابور,داروسازي‌ ابوريحان‌,1054,2745228,71948871330,33800,27200,26100,-7700,-22.78,26210,-7590,-22.46,25840,28100
86,وملل,اعتباري ملل,1028,42233247,527847589011,13351,12510,12500,-851,-6.37,12498,-853,-6.39,11885,12700
87,سامان,بانك سامان,1024,7612079,71565955779,9474,9240,9190,-284,-3,9402,-72,-0.76,9190,9688
88,تسه0001,امتيازتسهيلات مسكن فروردين1400,1021,21408,12723737193,596285,590245,597000,715,0.12,594345,-1940,-0.33,575333,610000
89,سشرق,سيمان‌ شرق‌,953,16488182,82991697440,5270,5090,5030,-240,-4.55,5030,-240,-4.55,5010,5200
90,ما,بيمه  ما,941,8128660,72567547210,8830,9190,9000,170,1.93,8930,100,1.13,8820,9190
91,سفارس,سيمان فارس و خوزستان,941,6271777,90028285070,15020,14800,14310,-710,-4.73,14350,-670,-4.46,14270,14800
92,آوا,صندوق س.سهام آواي معيار-س,941,12352598,81530590807,6632,6601,6600,-32,-0.48,6600,-32,-0.48,6585,6640
93,ضخود7075,اختيارخ خودرو-2000-1400/07/07,931,40874,6357069000,185,199,142,-43,-23.24,156,-29,-15.68,139,209
94,حتايد,تايدواترخاورميانه,923,2862254,68063013240,23580,24390,23630,50,0.21,23780,200,0.85,23150,24580
95,شغدير,پتروشيمي غدير,897,1425687,95540601050,68070,69450,66170,-1900,-2.79,67010,-1060,-1.56,65900,69450
96,واتي,سرمايه‌ گذاري‌ آتيه‌ دماوند,897,20683942,195648135450,9380,9010,9480,100,1.07,9460,80,0.85,9010,9540
97,فباهنر,مس‌ شهيدباهنر,882,949921,21027176010,22640,21860,21900,-740,-3.27,22180,-460,-2.03,21740,23000
98,فباهنرح,ح . مس‌ شهيدباهنر,852,1854791,26951011570,15010,14880,14390,-620,-4.13,14530,-480,-3.2,14310,15130
99,تسه9912,امتياز تسهيلات مسكن اسفند99,846,20630,12174325666,592517,571200,570622,-21895,-3.7,590127,-2390,-0.4,570622,600000
100,پرداخت,به پرداخت ملت,823,2657879,60156461510,22520,21490,22600,80,0.36,22630,110,0.49,21490,23600
101,آگاس,صندوق س.هستي بخش آگاه-س,813,697802,43634969568,63904,63001,62398,-1506,-2.36,62532,-1372,-2.15,62250,63899
102,فاسمين,كالسيمين‌,811,3951654,52838675860,13940,13650,13250,-690,-4.95,13370,-570,-4.09,13250,14170
103,كاوه,فولاد كاوه جنوب كيش,801,5035477,96400375430,19770,19600,18910,-860,-4.35,19150,-620,-3.14,18900,19900
104,بپاس,بيمه پاسارگاد,766,1119602,107195256709,91347,94950,95914,4567,5,95689,4342,4.75,93300,95914
105,ساراب,سيمان‌ داراب‌,746,3516441,72932967430,21770,20950,20690,-1080,-4.96,20740,-1030,-4.73,20690,21740
106,وساغربي,شركت س استان آذربايجان غربي,728,63509607,42043359834,696,662,662,-34,-4.89,662,-34,-4.89,662,662
107,والبر,سرمايه‌ گذاري‌ البرز(هلدينگ‌,722,3336657,43242174570,13400,13190,13000,-400,-2.99,12960,-440,-3.28,12730,13440
108,رانفور,خدمات‌انفورماتيك‌,721,6983097,43325698430,6180,6290,6200,20,0.32,6200,20,0.32,6180,6300
109,كارين,صندوق س نگين سامان-ثابت,719,36918561,375285732516,10160,10166,10163,3,0.03,10165,5,0.05,10163,10167
110,شپديس,پتروشيمي پرديس,705,983267,92930124380,94550,94560,93880,-670,-0.71,94520,-30,-0.03,93000,96000
111,شلرد,كود شيميايي اوره لردگان,697,8163109,48131026205,6028,6040,5848,-180,-2.99,5896,-132,-2.19,5848,6050
112,خزاميا,زامياد,695,8046054,57453342780,7480,7130,7110,-370,-4.95,7140,-340,-4.55,7110,7250
113,ونيكي,سرمايه‌گذاري‌ ملي‌ايران‌,694,3732133,31824445050,8820,8900,8380,-440,-4.99,8660,-160,-1.81,8380,8950
114,سپ,پرداخت الكترونيك سامان كيش,666,1572439,37156410840,24200,23120,24200,0,0,23750,-450,-1.86,22990,24880
115,گشان,توسعه بين المللي پديده شانديز,660,1870201,42972003969,23445,22977,22977,-468,-2,22977,-468,-2,22977,23001
116,وساپا,سرمايه‌گذاري‌ سايپا,659,11059155,48972878571,4643,4450,4411,-232,-5,4428,-215,-4.63,4411,4600
117,معيار,سرمايه گذاري معيار صنعت پارس,656,872189,48833358871,56518,54823,58123,1605,2.84,55989,-529,-0.94,54823,58123
118,شبهرن,نفت‌ بهران‌,656,2507931,27656133210,11310,10930,10800,-510,-4.51,11160,-150,-1.33,10790,11490
119,گوهران,سرمايه گذاري توسعه گوهران اميد,648,1320176,9252183081,7020,7195,7030,10,0.14,7013,-7,-0.1,6900,7195
120,غبشهر,صنعتي‌ بهشهر,646,2741963,55619353320,21300,20250,20240,-1060,-4.98,20280,-1020,-4.79,20240,21000
121,وساخت,سرمايه‌ گذاري‌ ساختمان‌ايران‌,631,997905,39838412460,41740,41000,39660,-2080,-4.98,39920,-1820,-4.36,39660,41020
122,ضپاس2001,اختيارخ وپارس-2500-1400/02/29,631,30092,1408459000,101,50,56,-45,-44.55,47,-54,-53.47,22,94
123,ضسپا3003,اختيارخ خساپا-2000-1400/03/26,631,32549,1369005000,57,74,40,-17,-29.82,42,-15,-26.32,31,74
124,تاصيكو,سرمايه گذاري صدرتامين,630,4146396,40149614920,10000,9750,9720,-280,-2.8,9890,-110,-1.1,9500,10070
125,دعبيد,لابراتوارداروسازي‌  دكترعبيدي‌,625,1059510,26628343450,24670,25500,25500,830,3.36,24940,270,1.09,24550,25500
126,وصنعت,سرمايه گذاري توسعه صنعت وتجارت,610,5857662,31130989950,5470,5390,5380,-90,-1.65,5310,-160,-2.93,5230,5480
127,كگل,معدني و صنعتي گل گهر,597,2574531,36108250330,14260,14260,13760,-500,-3.51,14190,-70,-0.49,13720,14300
128,افق,فروشگاههاي زنجيره اي افق كوروش,593,797946,53789552030,68190,67130,66990,-1200,-1.76,67670,-520,-0.76,66200,68100
129,وسينا,بانك سينا,590,12658335,30567034739,2525,2468,2405,-120,-4.75,2415,-110,-4.36,2400,2533
130,شپلي,پلي اكريل ايران,584,7744844,65080030818,8083,8406,8406,323,4,8403,320,3.96,8200,8406
131,ومهان,گروه توسعه مالي مهر آيندگان,582,1861571,22725435385,12448,12440,12189,-259,-2.08,12336,-112,-0.9,12140,12590
132,وسلرستا,شركت س استان لرستان,566,36480748,28199618204,813,773,773,-40,-4.92,774,-39,-4.8,773,773
133,سشمال,سيمان‌ شمال‌,557,2756410,25414741410,9490,9520,9020,-470,-4.95,9220,-270,-2.85,9020,9750
134,وسيستا,شركت س استان سيستان وبلوچستان,553,39832650,24138585900,637,606,606,-31,-4.87,617,-20,-3.14,606,606
135,فسپا,گروه‌صنعتي‌سپاهان‌,551,991261,33250241060,33820,34440,33950,130,0.38,33540,-280,-0.83,33120,34440
136,البرز,بيمه البرز,548,6747680,23706835733,3582,3582,3500,-82,-2.29,3513,-69,-1.93,3411,3639
137,ورنا,سرمايه‌گذاري‌ رنا(هلدينگ‌,542,10481387,47047259930,4710,4500,4480,-230,-4.88,4490,-220,-4.67,4480,4640
138,ورازي,بيمه رازي,539,7311885,52893087906,7319,6980,7377,58,0.79,7234,-85,-1.16,6954,7600
139,كاما,باما,532,2445540,23354907000,10050,9550,9550,-500,-4.98,9740,-310,-3.08,9550,9550
140,لوتوس,تامين سرمايه لوتوس پارسيان,528,7448511,50869682700,6980,6660,6750,-230,-3.3,6830,-150,-2.15,6660,7020
141,وگردش,بانك گردشگري,522,2197266,33029849627,15252,14800,14916,-336,-2.2,15172,-80,-0.52,14795,15489
142,پارند,صندوق س. پارند پايدار سپهر,516,10063414,113179105144,11232,11246,11246,14,0.12,11247,15,0.13,11245,11251
143,فايرا,آلومينيوم‌ايران‌,505,5134005,93914506190,18390,18390,18310,-80,-0.44,18290,-100,-0.54,17820,18410
144,فنورد,نوردوقطعات‌ فولادي‌,496,412366,65344680710,166660,158330,158330,-8330,-5,158460,-8200,-4.92,158330,163990
145,تسه9911,امتياز تسهيلات مسكن بهمن99,489,7913,4654410394,592830,563999,572000,-20830,-3.51,588198,-4632,-0.78,563999,610000
146,كنور,توسعه معدني و صنعتي صبانور,488,575263,28644610530,49580,48610,50000,420,0.85,49680,100,0.2,48610,50870
147,وبوعلي,سرمايه‌گذاري‌بوعلي‌,472,4013274,15209483370,4090,3920,3770,-320,-7.82,3790,-300,-7.33,3730,3920
148,ضسپا3002,اختيارخ خساپا-1800-1400/03/26,469,24038,1842157000,101,60,80,-21,-20.79,77,-24,-23.76,60,106
149,وسكاب,س.ص.بازنشستگي كاركنان بانكها,465,4438443,20647054098,4757,4756,4749,-8,-0.17,4652,-105,-2.21,4566,4756
150,وثوق,سرمايه گذاري وثوق امين,464,834386,13284215847,16361,15875,15871,-490,-2.99,15921,-440,-2.69,15871,16660
151,شسپا,نفت سپاهان,458,2157071,32621356820,15320,15020,14840,-480,-3.13,15210,-110,-0.72,14710,15440
152,سپاها,سيمان‌سپاهان‌,455,3029318,19826251130,6760,6560,6500,-260,-3.85,6540,-220,-3.25,6460,6890
153,جم پيلن,پلي پروپيلن جم - جم پيلن,448,521662,35217495820,69700,68260,67300,-2400,-3.44,68270,-1430,-2.05,67000,69700
154,سخزر,سيمان‌ خزر,445,1357310,24061675080,18540,18010,17620,-920,-4.96,17730,-810,-4.37,17620,18690
155,شاراك,پتروشيمي شازند,444,894999,22281783710,25480,25490,24630,-850,-3.34,25320,-160,-0.63,24500,25850
156,شپاكسا,پاكسان‌,443,2841679,59925635020,22120,21020,21020,-1100,-4.97,21090,-1030,-4.66,21020,22000
157,ارزش,صندوق س ارزش آفرين بيدار-سهام,443,3692918,32055112350,8800,8710,8640,-160,-1.82,8680,-120,-1.36,8620,8770
158,تسه9908,امتياز تسهيلات مسكن آبان99,442,10534,6174069219,591355,584000,592500,1145,0.19,586109,-5246,-0.89,561788,599999
159,وكار,بانك‌ كارآفرين‌,438,8774434,24495511229,2791,2800,2800,9,0.32,2791,0,0,2770,2848
160,كروي,توسعه‌ معادن‌ روي‌ ايران‌,434,1077182,22721900950,21710,20850,20630,-1080,-4.97,21090,-620,-2.86,20630,21980
161,پرديس,سرمايه گذاري پرديس,429,3780969,17423124190,4770,4630,4550,-220,-4.61,4610,-160,-3.35,4540,4720
162,انرژي3,سايراشخاص بورس انرژي,429,105045,23414530500,247660,222900,222900,-24760,-10,236820,-10840,-4.38,222900,222900
163,مدير,ص.س.مديريت ثروت ص.بازنشستگي-س,424,1439236,11021499237,7761,7785,7643,-118,-1.52,7658,-103,-1.33,7565,7785
164,سصوفي,سيمان‌ صوفيان‌,422,2822659,34039254460,12680,12080,12050,-630,-4.97,12060,-620,-4.89,12050,12550
165,وصنا,گروه‌صنايع‌بهشهرايران‌,421,4128450,18940160000,4810,4600,4580,-230,-4.78,4590,-220,-4.57,4570,4900
166,فنوال,نورد آلومينيوم‌,416,1561713,41846424770,28170,27940,26770,-1400,-4.97,26800,-1370,-4.86,26770,27940
167,آكورد,صندوق س. آرمان آتي كوثر-د,414,6135318,197262426396,32135,32151,32156,21,0.07,32152,17,0.05,32151,32156
168,پارس,پتروشيمي پارس,411,274674,40277846620,145680,145680,145200,-480,-0.33,146060,380,0.26,144580,147800
169,كگلح,ح . معدني و صنعتي گل گهر,411,1496459,16526541100,11440,11370,10890,-550,-4.81,11040,-400,-3.5,10850,11370
170,طلا,صندوق س.پشتوانه طلاي لوتوس,408,331177,23470488996,73054,71196,71115,-1939,-2.65,70870,-2184,-2.99,70160,71300
171,شپترو,پتروشيمي آبادان,405,7785525,33880393095,4481,4370,4347,-134,-2.99,4352,-129,-2.88,4347,4481
172,شفن,پتروشيمي فناوران,404,99202,29907673920,300880,300890,300930,50,0.02,301060,180,0.06,298500,306000
173,جم,پتروشيمي جم,392,531900,18157658910,34720,34730,34020,-700,-2.02,34610,-110,-0.32,34000,34730
174,كاردان,صندوق س تجارت شاخصي كاردان,389,110868,15965637200,144630,141000,143000,-1630,-1.13,144010,-620,-0.43,141000,146110
175,پارسيان,بيمه پارسيان,385,4752142,38179264480,8420,8100,8050,-370,-4.39,8030,-390,-4.63,8000,8440
176,سيدكو,سرمايه گذاري توسعه صنايع سيمان,381,9379077,54280366960,5800,5810,5770,-30,-0.52,5790,-10,-0.17,5610,5920
177,پكرمان,گروه‌ صنعتي‌ بارز,372,852405,18485585420,22100,22490,21190,-910,-4.12,21750,-350,-1.58,21030,22490
178,ضسپا3004,اختيارخ خساپا-2500-1400/03/26,369,20829,161292000,11,10,15,4,36.36,8,-3,-27.27,6,15
179,تصميم,صندوق س با درآمد ثابت تصميم,368,3826894,62691773501,16376,16383,16385,9,0.05,16382,6,0.04,16380,16386
180,واعتبار,سرمايه گذاري اعتبار ايران,365,3518857,30761390640,9190,8740,8880,-310,-3.37,8740,-450,-4.9,8740,8890
181,واحيا,م .صنايع و معادن احياء سپاهان,363,529107,78867835013,151044,151700,149000,-2044,-1.35,149058,-1986,-1.31,147102,154000
182,فسازان,غلتك سازان سپاهان,359,639375,19734645700,31940,32750,30350,-1590,-4.98,30870,-1070,-3.35,30350,32750
183,اوصتا2,صندوق انديشه ورزان صباتامين -د,351,35100000,35100000,18666,1,1,-18665,-99.99,1,-18665,-99.99,1,1
184,سخوز,سيمان خوزستان,338,1591302,33411910420,21840,21390,20820,-1020,-4.67,21000,-840,-3.85,20750,22000
185,وشهر,بانك شهر,337,8374264,42357233891,5008,5120,5000,-8,-0.16,5058,50,1,4808,5120
186,نمرينو,ايران‌ مرينوس‌,336,384905,27330910010,111340,69700,73180,-38160,-34.27,71010,-40330,-36.22,66220,73180
187,ثمسكن,سرمايه‌گذاري‌ مسكن‌,329,3626641,14326938523,4141,3968,3934,-207,-5,3950,-191,-4.61,3934,4136
188,تنوين,تامين سرمايه نوين,329,5521888,40403740650,7300,7370,7350,50,0.68,7320,20,0.27,7300,7370
189,شبصير,توليدات پتروشيمي قائد بصير,328,143815,9460060851,64986,63000,65750,764,1.18,65486,500,0.77,63000,66350
190,سكه0012پ01,سكه تمام بهارتحويلي 1روزه رفاه,326,125300,124634740800,1018928,988887,994500,-24428,-2.4,994691,-24237,-2.38,982170,998900
191,تسه9909,امتياز تسهيلات مسكن آذر99,325,5759,3388358297,593479,582500,580000,-13479,-2.27,588359,-5120,-0.86,575150,600000
192,وتوس,توسعه‌شهري‌توس‌گستر,325,1131740,15442570460,13590,13660,13550,-40,-0.29,13640,50,0.37,13550,13800
193,تسه9910,امتياز تسهيلات مسكن دي99,321,4511,2648168253,591137,576300,575000,-16137,-2.73,587047,-4090,-0.69,573100,600000
194,زگلدشتح,ح.كشت و دام گلدشت نمونه اصفهان,318,1039222,5989357779,5852,5750,5759,-93,-1.59,5763,-89,-1.52,5659,5899
195,بموتو,موتوژن‌,315,415123,19222312930,48180,47600,46520,-1660,-3.45,46310,-1870,-3.88,45780,47810
196,وتوكا,سرمايه‌گذاري‌توكافولاد(هلدينگ,314,2256087,20169051140,9400,9110,8930,-470,-5,8940,-460,-4.89,8930,9250
197,شنفت,نفت‌ پارس‌,313,391570,18782784650,47200,47000,46990,-210,-0.44,47500,300,0.64,46990,48940
198,غمارگ,مارگارين‌,310,1940587,37949292510,28200,19990,19000,-9200,-32.62,19560,-8640,-30.64,19000,19990
199,خكرمان,گروه اقتصادي كرمان خودرو,310,4672732,15059974561,3309,3250,3210,-99,-2.99,3223,-86,-2.6,3210,3340
200,وتوسم,سرمايه‌گذاري‌توسعه‌ملي‌,307,3744375,24506257480,6880,6750,6550,-330,-4.8,6540,-340,-4.94,6540,6750
201,ونفت,سرمايه‌گذاري‌ صنعت‌ نفت‌,301,1853365,26008902440,14270,13950,13850,-420,-2.94,14030,-240,-1.68,13620,14420
202,امين يكم2,صندوق درآمد ثابت امين يكم فردا,300,30000000,30000000,10161,1,1,-10160,-99.99,1,-10160,-99.99,1,1
203,فردا,صندوق س آواي فرداي زاگرس-ثابت,295,10784690,115506414538,10705,10711,10712,7,0.07,10710,5,0.05,10710,10712
204,ضخود7074,اختيارخ خودرو-1800-1400/07/07,291,16730,3478561000,262,242,200,-62,-23.66,208,-54,-20.61,193,260
205,سمازن,سيمان‌مازندران‌,290,3158122,33663519010,11210,10660,10650,-560,-5,10660,-550,-4.91,10650,10900
206,وپترو,سرمايه‌گذاري صنايع پتروشيمي‌,288,3309793,36208588540,11480,10910,10910,-570,-4.97,10940,-540,-4.7,10910,11200
207,سرود,سيمان‌شاهرود,280,996922,16102548490,16570,16260,15760,-810,-4.89,16150,-420,-2.53,15750,16460
208,فولاژ,فولاد آلياژي ايران,279,857264,12241247950,15000,15000,14280,-720,-4.8,14870,-130,-0.87,14250,15140
209,خراسان,پتروشيمي خراسان,279,127887,8423100100,67740,66150,65010,-2730,-4.03,67400,-340,-0.5,64820,67470
210,شرانل,نفت ايرانول,278,1088119,42730670967,39864,38860,38800,-1064,-2.67,39270,-594,-1.49,38520,39989
211,مبين,مبين انرژي خليج فارس,275,923368,14458732010,15770,15940,15580,-190,-1.2,15760,-10,-0.06,15540,15940
212,وبهمن,سرمايه‌گذاري‌بهمن‌,273,1417584,18236111740,13530,12860,12860,-670,-4.95,12860,-670,-4.95,12860,13530
213,شفارا,پتروشيمي فارابي,272,6105755,20846078538,3512,3407,3407,-105,-2.99,3414,-98,-2.79,3407,3616
214,وسهمدا,شركت س استان همدان,272,21306005,17385700080,858,816,816,-42,-4.9,838,-20,-2.33,816,816
215,سباقر,سيمان باقران,272,1759579,24101906875,14381,13664,13662,-719,-5,13698,-683,-4.75,13662,14350
216,وثنو,سرمايه گذاري ساختماني نوين,272,3800065,15742511696,4270,4142,4142,-128,-3,4143,-127,-2.97,4142,4230
217,پارسان,گسترش نفت و گاز پارسيان,264,1904937,34014936230,18120,18450,17810,-310,-1.71,18040,-80,-0.44,17700,18450
218,ياقوت,صندوق س ياقوت آگاه-ثابت,264,1755338,21693328756,12356,12358,12359,3,0.02,12358,2,0.02,12357,12373
219,قشرين,قند شيرين خراسان,258,1857202,20699802299,11482,11160,11138,-344,-3,11146,-336,-2.93,11138,11490
220,كگهر,سنگ آهن گهرزمين,256,989697,40170706690,42381,42382,40262,-2119,-5,41758,-623,-1.47,40262,42382
221,وخاور,بانك خاورميانه,255,5160941,43028611910,8360,8340,8190,-170,-2.03,8340,-20,-0.24,8170,8480
222,آساس,صندوق س.آسمان آرماني سهام-س,247,51828,8123308681,162265,158010,156005,-6260,-3.86,156736,-5529,-3.41,156001,159000
223,وسپه,سرمايه‌گذاري‌ سپه‌,244,2893102,18092517950,6400,6300,6380,-20,-0.31,6310,-90,-1.41,6200,6440
224,وحكمت,بيمه حكمت صبا,240,2134820,6258536828,3005,2915,2918,-87,-2.9,2953,-52,-1.73,2915,3000
225,وتوصا,گروه س توسعه صنعتي ايران,236,2964173,25788305100,9150,8700,8700,-450,-4.92,8700,-450,-4.92,8700,8700
226,شوينده,مديريت صنعت شوينده ت.ص.بهشهر,235,420220,8681746180,21290,20400,20600,-690,-3.24,20850,-440,-2.07,20350,21600
227,تسه9803,امتياز تسهيلات مسكن خرداد98,235,4472,2519350784,584445,558630,555223,-29222,-5,563361,-21084,-3.61,555223,573985
228,فپنتا,سپنتا,232,33072,11523195210,352080,336350,350990,-1090,-0.31,349070,-3010,-0.85,336350,355000
229,خاور,ايران خودرو ديزل,227,5792215,25921306165,4612,4474,4474,-138,-2.99,4475,-137,-2.97,4474,4600
230,خديزل,بهمن  ديزل,223,526448,19903361486,39550,37576,37573,-1977,-5,37807,-1743,-4.41,37573,39530
231,وسگيلا,شركت س استان گيلان,220,14262885,9327926790,688,654,654,-34,-4.94,680,-8,-1.16,654,654
232,تيپيكو,سرمايه گذاري دارويي تامين,209,361265,12221366150,33940,33200,33650,-290,-0.85,33920,-20,-0.06,33200,34180
233,سيستم,همكاران سيستم,205,1087638,23026585900,22160,21100,21060,-1100,-4.96,21170,-990,-4.47,21060,22250
234,سپيدما,صندوق س. سپيد دماوند-د,202,9720820,100617177901,10343,10350,10350,7,0.07,10351,8,0.08,10350,10355
235,وبرق,س.کارکنان صنعت برق زنجان وقزوي,202,365326,15992510976,45129,43776,43776,-1353,-3,43776,-1353,-3,43776,43776
236,تايرا,تراكتورسازي‌ايران‌,199,307388,7263234530,24600,23460,23370,-1230,-5,24370,-230,-0.93,23370,24840
237,تسه9907,امتياز تسهيلات مسكن مهر99,192,3076,1804402765,590247,580000,599929,9682,1.64,586607,-3640,-0.62,561118,615000
238,تماوند,تامين سرمايه دماوند,191,982349,4883036799,4988,5003,4998,10,0.2,4982,-6,-0.12,4860,5003
239,زر,صندوق س.پشتوانه سكه طلاي زر,191,170054,7143742634,43485,41211,42340,-1145,-2.63,42009,-1476,-3.39,41200,42535
240,وپخش,داروپخش‌ (هلدينگ‌,183,135104,12595445190,97840,92950,92950,-4890,-5,95990,-1850,-1.89,92950,97640
241,تسه9902,امتياز تسهيلات مسكن ارديبهشت99,182,4247,2468048486,583891,582222,554700,-29191,-5,581127,-2764,-0.47,554700,599000
242,گكوثر,هتل پارسيان كوثر اصفهان,182,1838548,3673693659,2103,1998,1998,-105,-4.99,2074,-29,-1.38,1998,2002
243,سمتاز,سيمان ممتازان كرمان,181,461715,10744439344,23521,22820,23360,-161,-0.68,23271,-250,-1.06,22816,23700
244,شاوان,پالايش نفت لاوان,180,194122,14227333889,76912,76089,73067,-3845,-5,75375,-1537,-2,73067,76089
245,شساخت,مهندسي و ساختمان صنايع نفت,180,307700,13241620514,42824,41610,43500,676,1.58,42888,64,0.15,41610,43500
246,تماوندح,ح . تامين سرمايه دماوند,180,2347548,7679889836,3365,3266,3272,-93,-2.76,3271,-94,-2.79,3265,3348
247,كرماشا,صنايع پتروشيمي كرمانشاه,174,321223,10072300000,31860,31020,31250,-610,-1.91,31750,-110,-0.35,30910,32500
248,درازك,دارويي‌ رازك‌,171,348185,9334157290,27370,27880,26880,-490,-1.79,26990,-380,-1.39,26650,27880
249,دسبحانح,ح. سبحان دارو,169,166797,1850309170,11630,11010,10900,-730,-6.28,11090,-540,-4.64,10600,12230
250,تسه9810,امتياز تسهيلات مسكن دي98,169,3628,2095936423,582377,553389,560400,-21977,-3.77,577711,-4666,-0.8,553389,611495
251,دسينا,داروسازي‌ سينا,168,456901,9459007230,21770,20690,20690,-1080,-4.96,21000,-770,-3.54,20690,20790
252,شخارك,پتروشيمي‌ خارك‌,165,239622,9810568490,42480,41990,41300,-1180,-2.78,42320,-160,-0.38,40520,41990
253,وبشهر,توسعه‌ صنايع‌ بهشهر(هلدينگ,163,780271,7338738290,9600,9680,9370,-230,-2.4,9550,-50,-0.52,9200,9680
254,كخاك,صنايع‌خاك‌چيني‌ايران‌,162,288493,9953389860,36270,35400,34490,-1780,-4.91,35420,-850,-2.34,34460,35400
255,وصندوق,سرمايه‌گذاري‌صندوق‌بازنشستگي‌,160,762650,10266210210,13900,13780,13500,-400,-2.88,13860,-40,-0.29,13240,13970
256,ضخود7077,اختيارخ خودرو-3000-1400/07/07,157,9653,419693000,53,46,36,-17,-32.08,43,-10,-18.87,35,55
257,حسينا,توسعه خدمات دريايي وبندري سينا,152,135830,7451598324,55506,54950,53750,-1756,-3.16,55170,-336,-0.61,53746,55980
258,شيراز,پتروشيمي‌شيراز,149,674712,33914729040,50630,51170,49820,-810,-1.6,50510,-120,-0.24,49640,51170
259,اطلس,صندوق س.توسعه اندوخته آينده-س,147,20019,3919016297,198231,197000,194021,-4210,-2.12,195765,-2466,-1.24,194001,198600
260,گوهر,صندوق سكه طلاي كيان,144,90570,4440718974,50210,49899,49450,-760,-1.51,49031,-1179,-2.35,48510,49899
261,مارون,پتروشيمي مارون,144,249278,36240517872,146476,145900,143560,-2916,-1.99,146074,-402,-0.27,140000,147000
262,اتكاي,بيمه اتكايي ايرانيان,141,1220337,18699404322,16051,15250,15360,-691,-4.31,15496,-555,-3.46,15249,15690
263,آكورد2,صندوق س. آرمان آتي كوثر-د,140,14000000,14000000,32135,1,1,-32134,-100,1,-32134,-100,1,1
264,كوير,توليدي فولاد سپيد فراب كوير,136,4328136,66177199440,16090,15290,15290,-800,-4.97,15290,-800,-4.97,15290,15290
265,زپارس,ملي كشت و صنعت و دامپروري پارس,134,142363,17087207770,123830,123840,120000,-3830,-3.09,120030,-3800,-3.07,117640,123840
266,عيار,صندوق س. پشتوانه طلاي مفيد,133,98341,2476644547,25890,25152,25250,-640,-2.47,25184,-706,-2.73,25000,25400
267,تسه9904,امتياز تسهيلات مسكن تير99,130,1873,1090186778,592333,563717,569111,-23222,-3.92,582054,-10279,-1.74,563717,599990
268,ختوقا,قطعات‌ اتومبيل‌ ايران‌,129,3174979,6362657916,2109,2004,2004,-105,-4.98,2054,-55,-2.61,2004,2004
269,ضخود7076,اختيارخ خودرو-2500-1400/07/07,128,4690,446296000,103,101,93,-10,-9.71,95,-8,-7.77,87,110
270,بفجر,فجر انرژي خليج فارس,127,195693,4277117670,21920,22400,21680,-240,-1.09,21920,0,0,21330,22400
271,شفا,سرمايه گذاري شفادارو,126,242118,10064845260,43750,41570,41570,-2180,-4.98,42630,-1120,-2.56,41570,41570
272,غپآذر,شير پگاه آذربايجان شرقي,125,247191,13569374500,64688,55000,52250,-12438,-19.23,54894,-9794,-15.14,52250,55000
273,تسه9903,امتياز تسهيلات مسكن خرداد99,121,2019,1189295511,590396,570053,570000,-20396,-3.45,589052,-1344,-0.23,560877,619914
274,شاملا,معدني‌ املاح‌  ايران‌,120,479815,18840848290,41320,39260,39260,-2060,-4.99,39270,-2050,-4.96,39260,40060
275,تسه9906,امتياز تسهيلات مسكن شهريور99,116,1227,723228949,593820,570000,619999,26179,4.41,589429,-4391,-0.74,565000,619999
276,فيروزه,صندوق شاخص30 شركت فيروزه- سهام,116,31215,3982249990,128760,128100,127750,-1010,-0.78,127570,-1190,-0.92,127470,128770
277,سكرما,سيمان‌ كرمان‌,112,399240,5041429130,13250,12590,12590,-660,-4.98,13000,-250,-1.89,12590,13200
278,نهال,صندوق س. طلاي سرخ نوويرا,112,116287,1005017271,8561,8778,8661,100,1.17,8643,82,0.96,8520,8778
279,تسه9905,امتياز تسهيلات مسكن مرداد99,112,2480,1442445925,588461,562151,561000,-27461,-4.67,581631,-6830,-1.16,561000,599444
280,ارمغان,ص سرمايه گذاري ارمغان ايرانيان,111,2845735,28683380304,10074,10075,10081,7,0.07,10079,5,0.05,10074,10081
281,آساميد,صندوق س.مشترك آسمان اميد -د,111,6940197,83601687269,12038,12350,12045,7,0.06,12046,8,0.07,12041,12350
282,لبوتان,گروه‌صنعتي‌بوتان‌,109,164166,8714409360,55870,53080,53080,-2790,-4.99,54240,-1630,-2.92,53080,54100
283,بمپنا,توليد برق عسلويه  مپنا,102,55842,3540776066,66744,63407,63407,-3337,-5,66104,-640,-0.96,63407,63409
284,كاريس,صندوق س.سپهر كاريزما-س,102,806588,8361677305,10464,10460,10370,-94,-0.9,10367,-97,-0.93,10350,10460
285,خريخت,صنايع‌ريخته‌گري‌ايران‌,100,2144761,4969373684,2437,2316,2316,-121,-4.97,2388,-49,-2.01,2316,2370
286,شلعابح,ح . لعابيران‌,99,1518887,9068172030,6160,6770,5900,-260,-4.22,5970,-190,-3.08,5900,6770
287,شصفها,پتروشيمي‌ اصفهان‌,98,56561,6846396402,122636,121477,120500,-2136,-1.74,121886,-750,-0.61,120184,123960
288,ثبهساز,بهساز كاشانه تهران,97,8219086,17383366890,2226,2115,2115,-111,-4.99,2115,-111,-4.99,2115,2115
289,اخزا910,اسنادخزانه-م10بودجه99-020807,97,244438,147920538272,604841,603115,605860,1019,0.17,605145,304,0.05,603110,606200
290,سپاس,صندوق س. پاداش سهامداري توسعه1,95,1693967,17072423220,10071,10080,10078,7,0.07,10078,7,0.07,10076,10080
291,سپيدار,سپيدار سيستم آسيا,90,694861,37543339830,56873,54030,54030,-2843,-5,54030,-2843,-5,54030,54030
292,بميلا,توسعه بازرگاني آهن وفولادميلاد,90,379264,4591496094,12665,12132,12032,-633,-5,12369,-296,-2.34,12032,12500
293,بساما,بيمه سامان,87,248575,4656793293,19709,18727,18724,-985,-5,19414,-295,-1.5,18724,19548
294,دارا,صندوق س. دارا الگوريتم-د,87,1341377,13522661487,10055,10085,10084,29,0.29,10081,26,0.26,10062,10090
295,ضخود4002,اختيارخ خودرو-1800-1400/04/02,86,2977,417333000,186,255,137,-49,-26.34,140,-46,-24.73,130,255
296,ختور,رادياتور ايران‌,86,86350,1518033000,19530,17580,17580,-1950,-9.98,19310,-220,-1.13,17580,17580
297,شسينا,صنايع‌شيميايي‌سينا,85,20308,2412996560,132020,118820,118820,-13200,-10,129660,-2360,-1.79,118820,118820
298,خفولا,خدمات فني فولاد يزد,85,188448,8129081376,44471,43137,43137,-1334,-3,43387,-1084,-2.44,43137,43137
299,تسه9806,امتياز تسهيلات مسكن شهريور98,85,1933,1127160274,600118,571123,586000,-14118,-2.35,583114,-17004,-2.83,570277,597000
300,چخزر,صنايع چوب خزر كاسپين,83,100756,3215829252,33596,31917,31917,-1679,-5,33025,-571,-1.7,31917,31917
301,دلر,داروسازي‌ اكسير,82,109210,3278573840,31340,31340,30080,-1260,-4.02,31020,-320,-1.02,29790,31340
302,تسه9901,امتياز تسهيلات مسكن فروردين99,81,1148,680168971,602602,572482,580000,-22602,-3.75,592482,-10120,-1.68,572482,632732
303,سحرخيز,صندوق س. گروه زعفران سحرخيز,80,170962,1421186163,8430,8417,8389,-41,-0.49,8313,-117,-1.39,8270,8420
304,تسه9809,امتياز تسهيلات مسكن آذر98,79,1288,752475237,581627,552546,600000,18373,3.16,584220,2593,0.45,552546,610708
305,فردا2,صندوق س آواي فرداي زاگرس-ثابت,79,7900000,7900000,10705,1,1,-10704,-99.99,1,-10704,-99.99,1,1
306,ضملي3003,اختيارخ فملي-12000-1400/03/02,78,595,202042000,792,600,260,-532,-67.17,340,-452,-57.07,209,790
307,ملت,بيمه ملت,77,1387012,19071415000,14470,13750,13750,-720,-4.98,13750,-720,-4.98,13750,13750
308,غسالم,سالمين‌,75,428341,1334710556,3279,3116,3116,-163,-4.97,3261,-18,-0.55,3116,3116
309,پتاير,ايران‌ تاير,74,1305208,4067028128,3279,3116,3116,-163,-4.97,3227,-52,-1.59,3116,3116
310,فمراد,آلومراد,73,24937,1979997800,83570,79400,79400,-4170,-4.99,82920,-650,-0.78,79400,79400
311,تسه9812,امتياز تسهيلات مسكن اسفند98,72,1546,905721829,583365,562222,596995,13630,2.34,585848,2483,0.43,556000,597000
312,تسه9804,امتياز تسهيلات مسكن تير98,72,1811,1057562849,584060,569000,576131,-7929,-1.36,583966,-94,-0.02,569000,594898
313,بورس,بورس اوراق بهادار تهران,72,1498078,45826206020,32200,30590,30590,-1610,-5,30690,-1510,-4.69,30590,30590
314,خصدرا,صنعتي‌ دريايي‌ ايران‌,71,684157,1529775052,2305,2236,2236,-69,-2.99,2300,-5,-0.22,2236,2236
315,فخاس,فولاد خراسان,70,405803,9451543600,24510,23290,23290,-1220,-4.98,24390,-120,-0.49,23290,23980
316,اخزا911,اسنادخزانه-م11بودجه99-020906,69,239773,142569120408,593605,595000,595930,2325,0.39,594600,995,0.17,591000,597370
317,اخزا903,اسنادخزانه-م3بودجه99-011110,69,128240,90828565347,704363,706000,707100,2737,0.39,708270,3907,0.55,705001,710000
318,دفرا,فرآورده‌هاي‌ تزريقي‌ ايران‌,67,341425,8103358250,24930,23690,23690,-1240,-4.97,24220,-710,-2.85,23690,24880
319,اخزا902,اسنادخزانه-م2بودجه99-011019,67,124161,89169525041,717658,725000,717500,-158,-0.02,718177,519,0.07,715001,730000
320,كاذر,فرآورده‌هاي‌نسوزآذر,67,458155,7664933150,17610,16730,16730,-880,-5,16730,-880,-5,16730,16730
321,صايند,صندوق س. گنجينه آينده روشن-د,66,351910,3381863170,9640,9620,9600,-40,-0.41,9610,-30,-0.31,9600,9632
322,سكه0012پ04,سكه تمام بهارتحويلي1روز صادرات,66,33000,32843196600,1018520,988989,994450,-24070,-2.36,995248,-23272,-2.28,985000,999900
323,اخزا908,اسنادخزانه-م8بودجه99-020606,66,112594,70588497204,627337,626111,626900,-437,-0.07,626929,-408,-0.07,625558,628479
324,سپر,صندوق س سپر سرمايه بيدار- ثابت,65,2209991,26137082533,11823,11827,11829,6,0.05,11827,4,0.03,11824,11829
325,لخزر,پارس‌ خزر,65,14057,2354125790,186070,167470,167470,-18600,-10,182820,-3250,-1.75,167470,167470
326,فيروزا,صندوق بادرآمد ثابت فيروزه آسيا,64,873391,19964732529,22959,22952,22900,-59,-0.26,22859,-100,-0.44,22850,22984
327,اتكام,شركت بيمه اتكايي امين,62,403002,1720659296,4493,4272,4269,-224,-4.99,4465,-28,-0.62,4269,4320
328,ضملي3004,اختيارخ فملي-14000-1400/03/02,61,2383,5755000,34,10,2,-32,-94.12,2,-32,-94.12,2,10
329,تسه9811,امتياز تسهيلات مسكن بهمن98,61,1134,654725259,576982,548133,550010,-26972,-4.67,577359,377,0.07,548133,599990
330,ساروج,بين المللي ساروج بوشهر,59,169917,2932121693,17443,17443,17000,-443,-2.54,17388,-55,-0.32,16930,17443
331,اخزا914,اسنادخزانه-م14بودجه99-021025,59,132079,76596836406,577837,575000,579510,1673,0.29,579932,2095,0.36,575000,581000
332,خاتم,صندوق س خاتم ايساتيس پويا-ثابت,57,286842,3191258707,11116,11118,11128,12,0.11,11125,9,0.08,11118,11129
333,فروس,فروسيليس‌ ايران‌,57,2871739,14186390660,5200,4940,4940,-260,-5,4940,-260,-5,4940,4940
334,وبازار,صندوق س شاخصي بازارآشنا,56,311825,2837617950,9100,9100,9100,0,0,9100,0,0,9100,9130
335,دارو,كارخانجات‌داروپخش‌,55,47442,1437093440,31770,30190,30190,-1580,-4.97,31650,-120,-0.38,30190,32780
336,تسه9808,امتياز تسهيلات مسكن آبان98,54,1266,736494490,588229,587000,570005,-18224,-3.1,581749,-6480,-1.1,561000,605000
337,گنجين,صندوق س. گنجينه يكم آويد-د,53,462880,5949675944,12851,12860,12850,-1,-0.01,12854,3,0.02,12846,12860
338,ضپاس2000,اختيارخ وپارس-2000-1400/02/29,52,2297,1259985000,573,480,576,3,0.52,549,-24,-4.19,480,600
339,اخزا901,اسنادخزانه-م1بودجه99-010621,52,62366,47674158200,764784,763500,764389,-395,-0.05,764425,-359,-0.05,763500,765000
340,دمعيار,صندوق س. توازن معيار-د,51,1511722,15333214156,10139,10145,10144,5,0.05,10143,4,0.04,10137,10145
341,سكه0112پ03,سكه تمام بهارتحويلي1روزه سامان,51,39400,39269185000,1017773,991555,995000,-22773,-2.24,996680,-21093,-2.07,991555,998800
342,خمحركه,نيرو محركه‌,49,173676,657189984,3983,3784,3784,-199,-5,3973,-10,-0.25,3784,3784
343,تسه9805,امتياز تسهيلات مسكن مرداد98,49,889,519076626,595619,566155,580000,-15619,-2.62,583888,-11731,-1.97,566155,599998
344,دزهراوي,داروسازي‌زهراوي‌,49,86024,555715040,6790,6460,6460,-330,-4.86,6770,-20,-0.29,6460,6460
345,آتيمس,صندوق س.آرمان آتيه درخشان مس-س,49,11442,1953895716,174853,171000,171500,-3353,-1.92,170765,-4088,-2.34,169697,171500
346,غگرجي,بيسكويت‌  گرجي‌,48,815221,11682116930,15080,14330,14330,-750,-4.97,14340,-740,-4.91,14330,14330
347,فراز,صندوق س.سهام فراز داريك-س,45,65504,676731932,10330,10330,10336,6,0.06,10331,1,0.01,10330,10336
348,وپويا,سرمايه گذاري پويا,43,402449,2359558487,6171,5863,5863,-308,-4.99,6118,-53,-0.86,5863,5863
349,شراز,پالايش نفت شيراز,42,13060,1275991197,102816,97676,97676,-5140,-5,102654,-162,-0.16,97676,98995
350,فاراك,ماشين‌ سازي‌ اراك‌,42,431510,913075160,2227,2116,2116,-111,-4.98,2219,-8,-0.36,2116,2116
351,ضجار7040,اختيارخ وتجارت-2500-1400/07/21,42,733,131324000,208,101,159,-49,-23.56,179,-29,-13.94,101,200
352,اراد50,مرابحه عام دولت5-ش.خ0302,41,481800,481800006200,1000001,1000000,1000000,-1,0,1000000,-1,0,1000000,1000001
353,زرين,صندوق س. سهام زرين كوروش-س,40,76719,724592806,9690,9425,9430,-260,-2.68,9445,-245,-2.53,9419,9500
354,پارند2,صندوق س. پارند پايدار سپهر,40,4000000,4000000,11232,1,1,-11231,-99.99,1,-11231,-99.99,1,1
355,هنوري102,اختيارف ت نوري73761-01/02/15,40,300000,48300000,251,161,161,-90,-35.86,161,-90,-35.86,161,161
356,مداران,داده‌پردازي‌ايران‌,40,530730,11543377500,22890,21750,21750,-1140,-4.98,21880,-1010,-4.41,21750,21750
357,كلوند,كاشي‌ الوند,39,224315,4522190400,21220,20160,20160,-1060,-5,20860,-360,-1.7,20160,20160
358,سكه0011پ02,سكه تمام بهارتحويلي 1روزه ملت,37,8100,8069525800,1027195,980001,995000,-32195,-3.13,996238,-30957,-3.01,980001,999499
359,دكپسول,توليد ژلاتين كپسول ايران,36,47116,1348554152,30128,28622,28622,-1506,-5,29989,-139,-0.46,28622,28622
360,كدما,معدني‌ دماوند,36,4758,375168300,82990,78850,78850,-4140,-4.99,82860,-130,-0.16,78850,78850
361,ضجار7039,اختيارخ وتجارت-2000-1400/07/21,35,1144,398051000,435,380,323,-112,-25.75,348,-87,-20,323,380
362,غپاك,لبنيات‌ پاك‌,35,101852,2801948520,30560,27510,27510,-3050,-9.98,30000,-560,-1.83,27510,27510
363,تسه9807,امتياز تسهيلات مسكن مهر98,35,307,178021709,599264,569301,578000,-21264,-3.55,579875,-19389,-3.24,569301,599000
364,چكاپا,گروه صنايع كاغذ پارس,35,316614,1532411760,5090,4840,4840,-250,-4.91,5070,-20,-0.39,4840,4840
365,دروز,داروسازي‌ روزدارو,34,697182,20971234560,31660,30080,30080,-1580,-4.99,30080,-1580,-4.99,30080,30080
366,شكبير,پتروشيمي اميركبير,34,21778,1765794850,82548,81190,81080,-1468,-1.78,82522,-26,-0.03,80250,81910
367,ونيرو,سرمايه‌گذاري‌نيرو,33,751371,1784506125,2499,2375,2375,-124,-4.96,2483,-16,-0.64,2375,2375
368,اخزا820,اسنادخزانه-م20بودجه98-020806,33,25112,15220944541,608855,607230,605312,-3543,-0.58,606122,-2733,-0.45,605225,608000
369,اخزا811,اسنادخزانه-م11بودجه98-001013,32,6529,5745761720,877756,879000,888400,10644,1.21,880037,2281,0.26,879000,888400
370,خودكفا,اقتصادي و خودكفايي آزادگان,31,83740,1416043400,17432,16910,16910,-522,-2.99,17412,-20,-0.11,16910,16910
371,زعف0008پ05,زعفران0008نگين زرين(پ),31,18899,2212527960,118596,118500,118000,-596,-0.5,117071,-1525,-1.29,115000,118596
372,اخزا815,اسنادخزانه-م15بودجه98-010406,30,49017,39377566455,800692,804000,802700,2008,0.25,803345,2653,0.33,797002,814999
373,غچين,كشت‌ و صنعت‌ چين‌ چين,29,55198,984732320,19820,17840,17840,-1980,-9.99,19680,-140,-0.71,17840,17840
374,ضخود7073,اختيارخ خودرو-1600-1400/07/07,29,795,284014000,443,370,439,-4,-0.9,357,-86,-19.41,316,439
375,وارس,سرمايه گذاري ارس صبا,29,614495,8896658610,14925,14478,14478,-447,-2.99,14478,-447,-2.99,14478,14478
376,اخزا909,اسنادخزانه-م9بودجه99-020316,28,88329,58111697739,657040,653599,657500,460,0.07,657901,861,0.13,653599,659000
377,سبزوا,سيمان لار سبزوار,28,260969,808220993,3259,3097,3097,-162,-4.97,3250,-9,-0.28,3097,3097
378,اخزا907,اسنادخزانه-م7بودجه99-020704,27,136473,84508570320,615715,615000,618000,2285,0.37,619233,3518,0.57,615000,620000
379,قثابت,قند ثابت‌ خراسان‌,26,4113,236456370,60510,57490,57490,-3020,-4.99,60450,-60,-0.1,57490,57490
380,اخزا812,اسنادخزانه-م12بودجه98-001111,26,9117,7999043659,870408,876000,877977,7569,0.87,877377,6969,0.8,874100,877999
381,اخزا806,اسنادخزانه-م6بودجه98-000519,26,16970,16220242985,952353,956493,958897,6544,0.69,955819,3466,0.36,950604,958898
382,نوين,بيمه نوين,26,212241,1180696683,5855,5563,5563,-292,-4.99,5831,-24,-0.41,5563,5563
383,دپارس,پارس‌ دارو,25,10007,397978390,41860,39770,39770,-2090,-4.99,41800,-60,-0.14,39770,39770
384,لسرما,سرما آفرين‌,24,228818,4949333340,22760,21630,21630,-1130,-4.96,22340,-420,-1.85,21630,21630
385,كساوه,صنايع‌ كاشي‌ و سراميك‌ سينا,24,7620,483031800,70430,63390,63390,-7040,-10,70180,-250,-0.35,63390,63390
386,ضپاس7029,اختيارخ وپارس-2500-1400/07/28,24,643,239095000,398,371,370,-28,-7.04,372,-26,-6.53,350,389
387,هفجر102,اختيارف ت بفجر26401-01/02/11,24,750000,750000,1,1,1,0,0,1,0,0,1,1
388,ضخود7072,اختيارخ خودرو-1400-1400/07/07,23,189,97607000,622,556,510,-112,-18.01,516,-106,-17.04,496,562
389,وكادو,تكادو,23,643718,8903263658,14258,13831,13831,-427,-2.99,13831,-427,-2.99,13831,13831
390,صنوين,صندوق سرمايه‌گذاري صنوين-مختلط,22,27155,2809014980,104010,104010,103000,-1010,-0.97,103440,-570,-0.55,103000,104010
391,افق ملت,صندوق س در سهام افق ملت,22,14534,1786786980,123760,123500,122510,-1250,-1.01,122940,-820,-0.66,122510,123850
392,كفپارس,فرآورده‌هاي‌ نسوز پارس‌,22,95324,290833524,3211,3051,3051,-160,-4.98,3208,-3,-0.09,3051,3051
393,دسبحان,سبحان دارو,21,349240,5856754800,17650,16770,16770,-880,-4.99,17270,-380,-2.15,16770,16770
394,غزر,صنعتي زر ماكارون,21,11936,276079680,24340,23130,23130,-1210,-4.97,24330,-10,-0.04,23130,23130
395,لپارس,پارس‌ الكتريك‌,21,19361,1651686910,89800,85310,85310,-4490,-5,89270,-530,-0.59,85310,85310
396,اخزا718,اسنادخزانه-م18بودجه97-000525,21,5297,4963691506,956000,920004,953389,-2611,-0.27,937076,-18924,-1.98,920004,953491
397,سقاين,سيمان‌ قائن‌,21,75776,3929743360,54580,51860,51860,-2720,-4.98,53690,-890,-1.63,51860,51860
398,هپارس102,اختيارف ت پارس-177010-01/02/05,21,42926,49407826,1328,1151,1151,-177,-13.33,1151,-177,-13.33,1151,1151
399,ولانا,شركت ليزينگ آريا دانا,20,26341,912425899,36462,34639,34639,-1823,-5,36275,-187,-0.51,34639,34639
400,اخزا813,اسنادخزانه-م13بودجه98-010219,20,4195,3476318639,825227,820160,828740,3513,0.43,828681,3454,0.42,820159,829998
401,ضملي3002,اختيارخ فملي-10000-1400/03/02,20,110,240922000,2808,2900,2190,-618,-22.01,2190,-618,-22.01,2021,2900
402,كالا,بورس كالاي ايران,20,7906,233780420,31120,29570,29570,-1550,-4.98,31110,-10,-0.03,29570,29570
403,وهور,مديريت انرژي اميد  تابان هور,19,218957,414923515,1994,1895,1895,-99,-4.96,1993,-1,-0.05,1895,1895
404,بكام,كارخانجات توليدي شهيد قندي,19,104015,385063530,3896,3702,3702,-194,-4.98,3891,-5,-0.13,3702,3702
405,تكشا,گسترش‌صنايع‌وخدمات‌كشاورزي‌,19,83193,3298602450,41730,39650,39650,-2080,-4.98,41200,-530,-1.27,39650,39650
406,وآرين,شركت توسعه اقتصادي آرين,18,63802,210163788,3467,3294,3294,-173,-4.99,3463,-4,-0.12,3294,3294
407,وبيمه,سرمايه‌ گذاري‌ صنعت‌ بيمه‌,18,878580,2139342300,2563,2435,2435,-128,-4.99,2542,-21,-0.82,2435,2435
408,زعف0008پ09,زعفران0008نگين نوين(پ),18,3692,436291188,118050,117500,118995,945,0.8,118172,122,0.1,117500,118995
409,الماس,صندوق س.امين تدبيرگران فردا-س,18,3031,321484747,106481,104012,104301,-2180,-2.05,106066,-415,-0.39,104012,106975
410,توريل,توکاريل,18,44184,680212680,16205,15395,15395,-810,-5,16177,-28,-0.17,15395,15395
411,دانا,بيمه دانا,17,173900,975579000,5900,5610,5610,-290,-4.92,5880,-20,-0.34,5610,5610
412,چكارن,كارتن‌ ايران‌,17,132728,416235008,3301,3136,3136,-165,-5,3296,-5,-0.15,3136,3136
413,ثاخت,بين‌المللي‌توسعه‌ساختمان,17,171208,388813368,2390,2271,2271,-119,-4.98,2387,-3,-0.13,2271,2271
414,زعف0008پ20,زعفران0008نگين وحدت جام(پ),17,9179,1076137105,117729,116997,117994,265,0.23,117239,-490,-0.42,116200,117994
415,فسرب,ملي‌ سرب‌وروي‌ ايران‌,17,3871,267563520,72750,69120,69120,-3630,-4.99,72680,-70,-0.1,69120,69120
416,فرابورس,فرابورس ايران,17,18540,546614820,31034,29483,29483,-1551,-5,31008,-26,-0.08,29483,29483
417,اخزا818,اسنادخزانه-م18بودجه98-010614,17,18684,14331120828,765115,766000,767001,1886,0.25,767026,1911,0.25,766000,767150
418,تملي703,تسهيلات مسكن ب. ملي-خرداد97,16,385,236706474,588457,617879,617878,29421,5,614822,26365,4.48,559035,617879
419,خموتور,موتورسازان‌تراكتورسازي‌ايران‌,16,15184,204376640,14950,13460,13460,-1490,-9.97,14930,-20,-0.13,13460,13460
420,شكلر,نيروكلر,16,201507,8134837590,42490,40370,40370,-2120,-4.99,41280,-1210,-2.85,40370,40370
421,خشرق,الكتريك‌ خودرو شرق‌,16,306443,4274879850,14680,13950,13950,-730,-4.97,14460,-220,-1.5,13950,13950
422,همبين102,اختيارف ت مبين19752-01/02/10,16,420594,241420956,565,574,574,9,1.59,574,9,1.59,574,574
423,اخزا722,اسنادخزانه-م22بودجه97-000428,16,44011,42636526264,968177,968520,970499,2322,0.24,968770,593,0.06,967003,970500
424,اخزا821,اسنادخزانه-م21بودجه98-020906,16,9570,5702338910,593688,598000,596000,2312,0.39,595856,2168,0.37,592400,598000
425,خزر,فنرسازي‌زر,16,8456,362001360,47560,42810,42810,-4750,-9.99,47430,-130,-0.27,42810,42810
426,ضترا8057,اختيارخ شتران-7000-1400/08/09,16,291,334730000,1600,1579,1090,-510,-31.88,1150,-450,-28.13,500,1579
427,آسام,صندوق س.آرمان سپهر آشنا-م,15,22500,2309888090,102278,101000,103000,722,0.71,102662,384,0.38,100050,104000
428,بخاور,بيمه زندگي خاورميانه,15,35897,215023030,6305,5990,5990,-315,-5,6300,-5,-0.08,5990,5990
429,اوصتا,صندوق انديشه ورزان صباتامين -د,15,196654,3672508019,18666,18674,18675,9,0.05,18675,9,0.05,18674,18675
430,اخزا817,اسنادخزانه-م17بودجه98-010512,14,9754,7626525380,780319,781000,781025,706,0.09,781887,1568,0.2,781000,782000
431,دماوند,توليد نيروي برق دماوند,14,8569,249914885,30700,29165,29165,-1535,-5,30694,-6,-0.02,29165,29165
432,شاروم,پتروشيمي اروميه,14,11295,205715835,19171,18213,18213,-958,-5,19157,-14,-0.07,18213,18213
433,اخزا904,اسنادخزانه-م4بودجه99-011215,14,6222,4315262696,693374,694900,693518,144,0.02,693549,175,0.03,693211,694900
434,دتماد,توليدمواداوليه‌داروپخش‌,14,6910,273912400,41720,39640,39640,-2080,-4.99,41680,-40,-0.1,39640,39640
435,ستران,سيمان‌ تهران‌,14,8697,184811250,22360,21250,21250,-1110,-4.96,22350,-10,-0.04,21250,21250
436,شكربن,كربن‌ ايران‌,14,87034,6356093020,76870,73030,73030,-3840,-5,75000,-1870,-2.43,73030,73030
437,ضترا8058,اختيارخ شتران-8000-1400/08/09,13,340,272550000,1253,1050,720,-533,-42.54,802,-451,-35.99,700,1200
438,وآوا,سرمايه گذاري آوا نوين,12,8365,70608965,8885,8441,8441,-444,-5,8883,-2,-0.02,8441,8441
439,سجام,مجتمع سيمان غرب آسيا,12,28389,109950597,3992,3873,3873,-119,-2.98,3991,-1,-0.03,3873,3873
440,كلر,كلر پارس,12,9274,1141814880,129599,123120,123120,-6479,-5,129140,-459,-0.35,123120,123120
441,كطبس,ذغال‌سنگ‌ نگين‌ ط‌بس‌,12,112300,7840786000,73490,69820,69820,-3670,-4.99,71250,-2240,-3.05,69820,69820
442,ضسپا8041,اختيارخ خساپا-1600-1400/08/26,12,791,200750000,347,350,250,-97,-27.95,254,-93,-26.8,250,350
443,غشوكو,شوكو پارس,12,11458,316756410,28500,27645,27645,-855,-3,28461,-39,-0.14,27645,27645
444,ساذري,آذريت‌,12,129990,801908310,5876,6169,6169,293,4.99,5898,22,0.37,6169,6169
445,كرازي,كارخانجات‌توليدي‌شيشه‌رازي‌,11,15077,318426240,22230,21120,21120,-1110,-4.99,22210,-20,-0.09,21120,21120
446,ودي,بيمه  دي,11,17379,333676800,20210,19200,19200,-1010,-5,20192,-18,-0.09,19200,19200
447,كبافق,معادن‌ بافق‌,11,3595,159366350,46660,44330,44330,-2330,-4.99,46640,-20,-0.04,44330,44330
448,وملي,گروه‌ صنعتي‌ ملي‌ (هلدينگ‌,11,3849,610104990,166850,158510,158510,-8340,-5,166530,-320,-0.19,158510,158510
449,بذر,صندوق س بذر اميد آفرين-سهام,11,1163,104954440,90840,90360,90010,-830,-0.91,90240,-600,-0.66,89440,90500
450,تملي803,تسهيلات مسكن ب. ملي-خرداد98,11,327,254441861,761364,723296,799432,38068,5,778110,16746,2.2,723296,799432
451,كسرا,سراميك‌هاي‌صنعتي‌اردكان‌,11,45000,821700000,19220,18260,18260,-960,-4.99,19160,-60,-0.31,18260,18260
452,اخزا905,اسنادخزانه-م5بودجه99-020218,11,27580,18429259814,666658,670000,667722,1064,0.16,668211,1553,0.23,667722,674000
453,زعف0008پ16,زعفران0008نگين بيرجند(پ),10,12940,1523260440,117391,116001,118000,609,0.52,117717,326,0.28,116001,118000
454,وسگلستا,شركت س استان گلستان,10,55536,65421408,1240,1178,1178,-62,-5,1240,0,0,1178,1178
455,پخش,پخش البرز,10,12855,377847015,30940,29393,29393,-1547,-5,30898,-42,-0.14,29393,29393
456,ضملي7005,اختيارخ فملي-16000-1400/07/11,10,119,71100000,450,500,600,150,33.33,597,147,32.67,500,600
457,ضپنا8001,اختيارخ رمپنا-12000-1400/08/05,10,265,636000000,2900,2400,2400,-500,-17.24,2400,-500,-17.24,2400,2400
458,فاما,صنعتي‌ آما,10,103860,1570363200,15910,15120,15120,-790,-4.97,15810,-100,-0.63,15120,15120
459,دجابر,داروسازي‌ جابرابن‌حيان‌,10,301010,5710159700,19960,18970,18970,-990,-4.96,19630,-330,-1.65,18970,18970
460,دلقما,دارويي‌ لقمان‌,10,7402,172614640,24540,23320,23320,-1220,-4.97,24520,-20,-0.08,23320,23320
461,شدوص,دوده‌ صنعتي‌ پارس‌,10,200750,4271960000,22400,21280,21280,-1120,-5,22030,-370,-1.65,21280,21280
462,كيان2,صندوق س. با درآمد ثابت كيان,10,1000000,1000000,28465,1,1,-28464,-100,1,-28464,-100,1,1
463,دامين,داروسازي‌ امين‌,10,29959,142904430,5020,4770,4770,-250,-4.98,5020,0,0,4770,4770
464,زعف0008پ08,زعفران0008نگين روستا(پ),10,4679,555693943,118866,117800,118997,131,0.11,118763,-103,-0.09,117500,118997
465,سبجنو,سيمان‌ بجنورد,10,1946,78793540,42620,40490,40490,-2130,-5,42600,-20,-0.05,40490,40490
466,ثباغ,شهر سازي و خانه سازي باغميشه,10,11345,140417065,13028,12377,12377,-651,-5,13021,-7,-0.05,12377,12377
467,آوا2,صندوق س.سهام آواي معيار-س,10,11100000,11100000,6632,1,1,-6631,-99.98,1,-6631,-99.98,1,1
468,اخزا808,اسنادخزانه-م8بودجه98-000817,9,19712,17932987192,906023,907000,909999,3976,0.44,909750,3727,0.41,907000,909999
469,شلعاب,لعابيران‌,9,10980,138128400,13240,12580,12580,-660,-4.98,13230,-10,-0.08,12580,12580
470,اخزا723,اسنادخزانه-م23بودجه97-000824,9,3520,3185495050,903762,905000,905729,1967,0.22,904970,1208,0.13,902201,905729
471,هاي وب,داده گسترعصرنوين-هاي وب,9,11221,110639060,10370,9860,9860,-510,-4.92,10370,0,0,9860,9860
472,كوثر,بيمه كوثر,9,18572,257909364,14617,13887,13887,-730,-4.99,14612,-5,-0.03,13887,13887
473,خبازرس,بازرسي مهندسي و صنعتي ايران,9,35148,869350632,25498,24734,24734,-764,-3,25428,-70,-0.27,24734,24734
474,غشهد,شهد ايران ‌,8,50583,333847800,6940,6600,6600,-340,-4.9,6930,-10,-0.14,6600,6600
475,زگلدشت,كشت و دام گلدشت نمونه اصفهان,8,13892,181943524,13786,13097,13097,-689,-5,13777,-9,-0.07,13097,13097
476,سخاش,سيمان‌خاش‌,8,4584,594728160,136560,129740,129740,-6820,-4.99,136270,-290,-0.21,129740,129740
477,قيستو,شركت قند بيستون,8,200295,3417032700,17408,17060,17060,-348,-2,17139,-269,-1.55,17060,17060
478,سمايه,بانك سرمايه,8,44270,208954400,4968,4720,4720,-248,-4.99,4963,-5,-0.1,4720,4720
479,اخزا721,اسنادخزانه-م21بودجه97-000728,8,2326,2132453374,913382,916500,919887,6505,0.71,916790,3408,0.37,916500,919887
480,وآيند,بانك  آينده,8,4546,72708724,16320,15994,15994,-326,-2,16320,0,0,15994,15994
481,ولشرق,ليزينگ ايران و شرق,8,500000,4125500000,8685,8251,8251,-434,-5,8559,-126,-1.45,8251,8251
482,سدور,سيمان‌ دورود,8,11284,122995600,11470,10900,10900,-570,-4.97,11460,-10,-0.09,10900,10900
483,باران,بيمه زندگي باران50%تاديه,8,65435,257486725,3821,3935,3935,114,2.98,3824,3,0.08,3935,3935
484,ضملي7002,اختيارخ فملي-10000-1400/07/11,8,48,164885000,3936,3500,3300,-636,-16.16,3435,-501,-12.73,3206,3800
485,اشاد10,مشاركت دولتي10-شرايط خاص001226,8,200000,191700000000,952010,958500,958500,6490,0.68,958500,6490,0.68,958500,958500
486,قشكر,شكرشاهرود,8,14800,52540000,3736,3550,3550,-186,-4.98,3735,-1,-0.03,3550,3550
487,دتوزيعح,ح . توزيع دارو پخش,8,12370,441691912,36964,38812,35116,-1848,-5,35707,-1257,-3.4,35116,38812
488,ثروتم,صندوق س. ثروت آفرين پارسيان-س,8,19220,1405894170,74504,74637,73137,-1367,-1.83,73147,-1357,-1.82,72766,74637
489,رافزا,رايان هم افزا,8,1203,121143303,106001,100701,100701,-5300,-5,105956,-45,-0.04,100701,100701
490,ثشاهد,سرمايه‌ گذاري‌ شاهد,8,7394,120226440,17110,16260,16260,-850,-4.97,17110,0,0,16260,16260
491,اخزا814,اسنادخزانه-م14بودجه98-010318,8,838,675926935,806408,806408,812199,5791,0.72,806595,187,0.02,805500,812199
492,ساينا,صنايع بهداشتي ساينا,7,543,75361341,146091,138787,138787,-7304,-5,146052,-39,-0.03,138787,138787
493,آپ,آسان پرداخت پرشين,7,4314,67470960,16460,15640,15640,-820,-4.98,16460,0,0,15640,15640
494,بنو,بيمه تجارت نو,7,2410,69222430,30234,28723,28723,-1511,-5,30231,-3,-0.01,28723,28723
495,داريك2,صندوق س.اعتماد داريك-د,7,6650000,6650000,10583,1,1,-10582,-99.99,1,-10582,-99.99,1,1
496,شپاس,نفت پاسارگاد,7,201732,3972506544,20728,19692,19692,-1036,-5,20510,-218,-1.05,19692,19692
497,داريك4,صندوق س.اعتماد داريك-د,7,10008000,104283360000,10583,10420,10420,-163,-1.54,10420,-163,-1.54,10420,10420
498,بزاگرس,نيروگاه زاگرس كوثر,7,8175,55475550,7143,6786,6786,-357,-5,7142,-1,-0.01,6786,6786
499,وسديد,گروه ‌صنعتي‌سديد,7,55488,157252992,2891,2834,2834,-57,-1.97,2891,0,0,2834,2834
500,غمينو,شركت صنايع غذايي مينو شرق,7,20137,189952321,9929,9433,9433,-496,-5,9921,-8,-0.08,9433,9433
501,برن0003پ01,برنج طارم0003تجارت مازندران(پ),7,650,179243000,275706,275000,276000,294,0.11,275758,52,0.02,275000,278000
502,تمحركه,ماشين سازي نيرو محركه,7,6099,110410197,18662,18103,18103,-559,-3,18654,-8,-0.04,18103,18103
503,ضپيك7042,اختيارخ تاپيكو-10000-00/07/18,7,100,143500000,1536,400,1500,-36,-2.34,1435,-101,-6.58,400,2000
504,اخزا716,اسنادخزانه-م16بودجه97-000407,6,110,107676985,976399,983000,978000,1601,0.16,978882,2483,0.25,978000,983000
505,دتوليد,داروسازي توليد دارو,6,9813,245639016,26349,25032,25032,-1317,-5,26326,-23,-0.09,25032,25032
506,حتوكا,حمل‌ونقل‌توكا,6,3394,69101840,21430,20360,20360,-1070,-4.99,21420,-10,-0.05,20360,20360
507,بهپاك,صنعتي بهپاك,6,67725,435133125,6763,6425,6425,-338,-5,6753,-10,-0.15,6425,6425
508,كپارس,كاشي‌ پارس‌,6,1809,255810690,148850,141410,141410,-7440,-5,148710,-140,-0.09,141410,141410
509,ضمخا7077,اختيارخ اخابر-7000-1400/07/28,6,34,37806000,1459,1150,1140,-319,-21.86,1112,-347,-23.78,1036,1150
510,آرمان,بيمه آرمان,6,213599,1665431403,8207,7797,7797,-410,-5,8135,-72,-0.88,7797,7797
511,ضمخا7070,اختيارخ اخابر-20000-1400/07/28,6,28,8386000,203,151,398,195,96.06,299,96,47.29,151,498
512,ولبهمن,شركت بهمن ليزينگ,6,114848,771663712,7072,6719,6719,-353,-4.99,7051,-21,-0.3,6719,6719
513,دسانكو,داروسازي سبحان انكولوژي,6,13050,183000150,14761,14023,14023,-738,-5,14752,-9,-0.06,14023,14023
514,غشهداب,كشت و صنعت شهداب ناب خراسان,6,35655,132779220,3920,3724,3724,-196,-5,3918,-2,-0.05,3724,3724
515,اخزا805,اسنادخزانه-م5بودجه98-000422,6,8189,7943308430,969750,970000,973000,3250,0.34,969997,247,0.03,968001,973000
516,سخواف,سيمان مجد خواف,6,11387,181508780,16778,15940,15940,-838,-4.99,16762,-16,-0.1,15940,15940
517,كپشير,پشم‌شيشه‌ايران‌,6,1075,40807000,39950,37960,37960,-1990,-4.98,39940,-10,-0.03,37960,37960
518,فوكا,فولاد كاويان,6,105610,1165406350,11376,11035,11035,-341,-3,11361,-15,-0.13,11035,11035
519,اخزا810,اسنادخزانه-م10بودجه98-001006,6,5752,5073468197,884999,881021,886797,1798,0.2,882035,-2964,-0.33,881021,886797
520,چفيبر,فيبر ايران‌,5,8663,110453250,13420,12750,12750,-670,-4.99,13410,-10,-0.07,12750,12750
521,دتوزيع,توزيع دارو پخش,5,1138,51552538,47685,45301,45301,-2384,-5,47679,-6,-0.01,45301,45301
522,نطرين,عطرين نخ قم,5,3934,44875138,12007,11407,11407,-600,-5,12005,-2,-0.02,11407,11407
523,لابسا,آبسال‌,5,2799,131636970,49500,47030,47030,-2470,-4.99,49480,-20,-0.04,47030,47030
524,سخند,صندوق س.سپهرخبرگان نفت-د,5,5570,55909140,10005,10038,10038,33,0.33,10038,33,0.33,10002,10038
525,شسم,توليد سموم‌ علف‌ كش,5,8147,778706554,91906,95582,95582,3676,4,92445,539,0.59,95582,95582
526,كهمدا,شيشه‌ همدان‌,5,3070,29042200,9950,9460,9460,-490,-4.92,9950,0,0,9460,9460
527,ديران,ايران‌دارو,5,19750,325085000,17320,16460,16460,-860,-4.97,17300,-20,-0.12,16460,16460
528,گوهر2,صندوق سكه طلاي كيان,5,50000,50000,50210,1,1,-50209,-100,1,-50209,-100,1,1
529,ضملي3000,اختيارخ فملي-8000-1400/03/02,5,65,273481000,4488,4500,4051,-437,-9.74,4207,-281,-6.26,4010,4500
530,سدشت,صنايع سيمان دشتستان,5,1495,98849400,69590,66120,66120,-3470,-4.99,69580,-10,-0.01,66120,66120
531,ضمخا7075,اختيارخ اخابر-9000-1400/07/28,5,21,10730000,668,555,500,-168,-25.15,511,-157,-23.5,500,555
532,خرينگ,رينگ‌سازي‌مشهد,5,680,32334000,50050,47550,47550,-2500,-5,50040,-10,-0.02,47550,47550
533,ضمخا7078,اختيارخ اخابر-8000-1400/07/28,5,101,72200000,980,700,750,-230,-23.47,715,-265,-27.04,700,750
534,دسبحا,گروه دارويي سبحان,5,18934,333806420,18550,17630,17630,-920,-4.96,18540,-10,-0.05,17630,17630
535,قصفها,قنداصفهان‌,5,969,143537970,155920,148130,148130,-7790,-5,155840,-80,-0.05,148130,148130
536,فبستم,صنايع ‌بسته‌بندي‌ مشهد,5,37327,31056064,793,832,832,39,4.92,793,0,0,832,832
537,ضترا3001,اختيارخ شتران-7000-1400/03/09,5,43,26450000,903,1000,600,-303,-33.55,615,-288,-31.89,450,1000
538,زفكا,كشت و دامداري فكا,5,40875,488415375,12577,11949,11949,-628,-4.99,12555,-22,-0.17,11949,11949
539,پكوير,كوير تاير,5,9270,111332700,12640,12010,12010,-630,-4.98,12640,0,0,12010,12010
540,بنيرو,نيروترانس‌,5,10381,148136870,15020,14270,14270,-750,-4.99,15010,-10,-0.07,14270,14270
541,كپرور,فرآوري زغال سنگ پروده طبس,5,2226,70553070,33363,31695,31695,-1668,-5,33354,-9,-0.03,31695,31695
542,زير0003پ01,زيره سبز0003كيميابذر(پ),5,200,112600000,556352,575000,555000,-1352,-0.24,563000,6648,1.19,555000,575000
543,غالبر,لبنيات‌ كالبر,5,24090,452892000,19780,18800,18800,-980,-4.95,19750,-30,-0.15,18800,18800
544,ساروم,سيمان‌اروميه‌,5,1225,41233500,35430,33660,33660,-1770,-5,35420,-10,-0.03,33660,33660
545,ثرود,سرمايه‌گذاري مسكن زاينده رود,4,2560,50951680,20950,19903,19903,-1047,-5,20946,-4,-0.02,19903,19903
546,ضسپا3005,اختيارخ خساپا-3000-1400/03/26,4,59,178000,14,2,5,-9,-64.29,3,-11,-78.57,2,5
547,ختراك,ريخته‌گري‌ تراكتورسازي‌ ايران‌,4,33505,465719500,14630,13900,13900,-730,-4.99,14600,-30,-0.21,13900,13900
548,زير0003پ04,زيره سبز0003شركت مينوبذر(پ),4,175,93833390,605411,584169,530000,-75411,-12.46,536191,-69220,-11.43,530000,584169
549,ضجار7041,اختيارخ وتجارت-3000-1400/07/21,4,211,10770000,59,60,50,-9,-15.25,51,-8,-13.56,50,60
550,ريشمك,توليد و صادرات ريشمك,4,801,42815052,56265,53452,53452,-2813,-5,56257,-8,-0.01,53452,53452
551,فرآور,فرآوري‌موادمعدني‌ايران‌,4,3661,108987970,31330,29770,29770,-1560,-4.98,31320,-10,-0.03,29770,29770
552,ضپاس7028,اختيارخ وپارس-2000-1400/07/28,4,29,21195000,683,700,740,57,8.35,731,48,7.03,700,749
553,ضترا8055,اختيارخ شتران-5000-1400/08/09,4,20,59900000,3380,3180,2810,-570,-16.86,2995,-385,-11.39,2810,3180
554,تبرك,گروه كارخانجات صنعتي تبرك,4,1276,23972212,19775,18787,18787,-988,-5,19774,-1,-0.01,18787,18787
555,صخود412,ص مرابحه خودرو412- 3ماهه 18%,4,33800,33631033800,995000,995001,995001,1,0,995001,1,0,995001,995001
556,سمگا,گروه سرمايه گذاري ميراث فرهنگي,4,11180,303682340,28592,27163,27163,-1429,-5,28583,-9,-0.03,27163,27163
557,صگل039,صكوك اجاره گل گهر039-3ماهه20%,4,920,947600000,1000000,1030000,1030000,30000,3,1030000,30000,3,1030000,1030000
558,فلوله,لوله‌وماشين‌سازي‌ايران‌,4,1911,39385710,21690,20610,20610,-1080,-4.98,21690,0,0,20610,20610
559,اخزا804,اسنادخزانه-م4بودجه98-000421,4,559,542231124,969798,970002,970002,204,0.02,970002,204,0.02,970002,970003
560,ضپاس2005,اختيارخ وپارس-4500-1400/02/29,4,131,3317000,1,1,2,1,100,25,24,2400,1,50
561,كحافظ,كاشي‌ وسراميك‌ حافظ‌,4,8024,91232880,11960,11370,11370,-590,-4.93,11960,0,0,11370,11370
562,اعتلا,شركت سرمايه گذاري اعتلاء البرز,4,16033,109665720,7199,6840,6840,-359,-4.99,7196,-3,-0.04,6840,6840
563,غويتا,ويتانا,4,2462,41991872,17953,17056,17056,-897,-5,17951,-2,-0.01,17056,17056
564,ضسپا8040,اختيارخ خساپا-1400-1400/08/26,4,160,43800000,500,380,250,-250,-50,274,-226,-45.2,250,380
565,سميعا002,سلف موازي استاندارد سميعا002,4,460000,600399360000,1304650,1305215,1305216,566,0.04,1305216,566,0.04,1305216,1305216
566,شكف,كف,4,280,26974080,100349,96336,96336,-4013,-4,100338,-11,-0.01,96336,96336
567,اخزا713,اسنادخزانه-م13بودجه97-000518,4,874,834549328,954835,954754,957000,2165,0.23,954862,27,0,954754,957000
568,لخانه,لوازم‌ خانگي‌ پارس‌,4,40583,1081536950,27474,26650,26650,-824,-3,27381,-93,-0.34,26650,26650
569,ضمخا7066,اختيارخ اخابر-12000-1400/07/28,4,36,14073000,450,333,650,200,44.44,391,-59,-13.11,121,650
570,كگاز,شيشه‌ و گاز,4,2750,48180000,18440,17520,17520,-920,-4.99,18440,0,0,17520,17520
571,كي بي سي,شركت كي بي سي,3,1710,42062580,25892,24598,24598,-1294,-5,25888,-4,-0.02,24598,24598
572,زنگان,صنعت روي زنگان,3,250,24759000,104248,99036,99036,-5212,-5,104239,-9,-0.01,99036,99036
573,رنيك,جنرال مكانيك,3,900,19037700,22266,21153,21153,-1113,-5,22265,-1,0,21153,21153
574,ثنوسا,نوسازي‌وساختمان‌تهران‌,3,1935,23394150,12720,12090,12090,-630,-4.95,12720,0,0,12090,12090
575,ضصاد3001,اختيارخ وبصادر-2000-1400/03/12,3,110,8000000,129,100,70,-59,-45.74,73,-56,-43.41,70,100
576,پلوله,گازلوله‌,3,7186,195883174,28102,27259,27259,-843,-3,28084,-18,-0.06,27259,27259
577,كسعدي,كاشي‌ سعدي‌,3,1643,33287180,21320,20260,20260,-1060,-4.97,21320,0,0,20260,20260
578,سيمرغ,سيمرغ,3,5970,103400400,18230,17320,17320,-910,-4.99,18220,-10,-0.05,17320,17320
579,ضملي7003,اختيارخ فملي-12000-1400/07/11,3,126,205800000,2389,1420,1700,-689,-28.84,1633,-756,-31.65,1420,1700
580,سپرمي,پرميت‌,3,6965,62817335,8930,9019,9019,89,1,8932,2,0.02,9019,9019
581,غنوش,نوش‌ مازندران‌,3,4412,236174360,56340,53530,53530,-2810,-4.99,56290,-50,-0.09,53530,53530
582,لازما,كارخانه هاي صنعتي آزمايش,3,32238,1073299734,34322,33293,33293,-1029,-3,34208,-114,-0.33,33293,33293
583,تپمپي,پمپ‌ سازي‌ ايران‌,3,963,17353260,18960,18020,18020,-940,-4.96,18960,0,0,18020,18020
584,شگل,گلتاش‌,3,3437,32857720,10060,9560,9560,-500,-4.97,10060,0,0,9560,9560
585,شستان,پتروشيمي گلستان,3,7953,29791938,3822,3746,3746,-76,-1.99,3822,0,0,3746,3746
586,وسخوز,شركت س استان خوزستان,3,22186,20455492,970,922,922,-48,-4.95,970,0,0,922,922
587,حريل,ريل پردازسير,3,4061,21190298,5492,5218,5218,-274,-4.99,5492,0,0,5218,5218
588,سفانو,سيمان فارس نو,3,2995,91317550,32090,30490,30490,-1600,-4.99,32080,-10,-0.03,30490,30490
589,درهآور,دارويي ره آورد تامين,3,1971,52613874,28098,26694,26694,-1404,-5,28092,-6,-0.02,26694,26694
590,زنجان,صنايع كشاورزي وكود زنجان,3,2332,21144244,9347,9067,9067,-280,-3,9347,0,0,9067,9067
591,داسوه,داروسازي‌ اسوه‌,3,50000,1749000000,36820,34980,34980,-1840,-5,36590,-230,-0.62,34980,34980
592,ضشنا8003,اختيارخ شپنا-10000-1400/08/16,3,30,39900000,1425,1250,1490,65,4.56,1330,-95,-6.67,1250,1490
593,دكيمي,كيميدارو,3,51000,1434120000,29590,28120,28120,-1470,-4.97,29440,-150,-0.51,28120,28120
594,اخزا809,اسنادخزانه-م9بودجه98-000923,3,1239,1105132495,887229,892499,890000,2771,0.31,891955,4726,0.53,890000,892500
595,مرقام,ايران‌ارقام‌,3,2000,36900000,19420,18450,18450,-970,-4.99,19420,0,0,18450,18450
596,ضخود7078,اختيارخ خودرو-3500-1400/07/07,3,300,3200000,7,11,11,4,57.14,11,4,57.14,10,11
597,غبهنوش,بهنوش‌ ايران‌,3,260,17009200,68860,65420,65420,-3440,-5,68860,0,0,65420,65420
598,ثالوند,سرمايه گذاري مسكن الوند,2,399,12223365,32247,30635,30635,-1612,-5,32246,-1,0,30635,30635
599,خمهر,مهركام‌پارس‌,2,7379,15827955,2257,2145,2145,-112,-4.96,2257,0,0,2145,2145
600,آ س پ,آ.س.پ,2,1600,24526400,16135,15329,15329,-806,-5,16134,-1,-0.01,15329,15329
601,اميد,تامين سرمايه اميد,2,2748,19923000,7630,7250,7250,-380,-4.98,7630,0,0,7250,7250
602,سكارون,سيمان كارون,2,103,17409987,177925,169029,169029,-8896,-5,177914,-11,-0.01,169029,169029
603,ثعمرا,عمران و توسعه شاهد,2,1257,15578001,13045,12393,12393,-652,-5,13044,-1,-0.01,12393,12393
604,بايكا,كارخانجات كابلسازي ‌ايران‌,2,1050,42556500,41783,40530,40530,-1253,-3,41777,-6,-0.01,40530,40530
605,چكاوه,صنايع‌كاغذسازي‌كاوه‌,2,2100,36666000,18370,17460,17460,-910,-4.95,18370,0,0,17460,17460
606,كترام,توليدي‌ كاشي‌ تكسرام‌,2,620,28557200,48480,46060,46060,-2420,-4.99,48480,0,0,46060,46060
607,ضسپا3001,اختيارخ خساپا-1600-1400/03/26,2,105,19150000,271,230,180,-91,-33.58,182,-89,-32.84,180,230
608,ضشنا8004,اختيارخ شپنا-12000-1400/08/16,2,5,4500000,997,900,900,-97,-9.73,900,-97,-9.73,900,900
609,سنفت001,سلف موازي استاندارد سنفت001,2,43500,50141058000,1150725,1152668,1152668,1943,0.17,1152668,1943,0.17,1152668,1152668
610,زير0003پ02,زيره سبز0003 دانش(پ),2,19,10557521,560000,584169,530000,-30000,-5.36,555659,-4341,-0.78,530000,584169
611,زكشت,كشاورزي مكانيزه اصفهان كشت,2,1070,41037710,40371,38353,38353,-2018,-5,40365,-6,-0.01,38353,38353
612,اراد704,مرابحه عام دولت70-ش.خ0112,2,34228000,32175175700000,943750,940050,940000,-3750,-0.4,940025,-3725,-0.39,940000,940050
613,وملت,سرمايه گذاري ملت,2,4125,17659125,4368,4281,4281,-87,-1.99,4368,0,0,4281,4281
614,گدنا,تهيه توزيع غذاي دنا آفرين فدك,2,338,10861968,33827,32136,32136,-1691,-5,33826,-1,0,32136,32136
615,نگين,ص.س. زمين و ساختمان نگين شهرري,2,220,10458800,47940,47540,47540,-400,-0.83,47540,-400,-0.83,47540,47540
616,تكنو,تكنوتار,2,49000,1004990000,21580,20510,20510,-1070,-4.96,21500,-80,-0.37,20510,20510
617,اخزا807,اسنادخزانه-م7بودجه98-000719,2,1077,993035940,919545,928990,922000,2455,0.27,922039,2494,0.27,922000,928990
618,هجرت,پخش هجرت,2,390,10396620,28061,26658,26658,-1403,-5,28060,-1,0,26658,26658
619,ضترا8060,اختيارخ شتران-10000-1400/08/09,2,60,30000000,600,500,500,-100,-16.67,500,-100,-16.67,500,500
620,ثشرق,سرمايه گذاري مسكن شمال شرق,2,1715,11233250,6890,6550,6550,-340,-4.93,6890,0,0,6550,6550
621,خعمرا,توسعه و عمران شهرستان نائين,2,540,12697560,22830,23514,23514,684,3,22831,1,0,23514,23514
622,غدشت,دشت‌ مرغاب‌,2,210,54675600,274060,260360,260360,-13700,-5,274000,-60,-0.02,260360,260360
623,مفاخر,توسعه فناوري اطلاعات خوارزمي,2,749,43557346,61214,58154,58154,-3060,-5,61205,-9,-0.01,58154,58154
624,فسا,پتروشيمي فسا,2,96047,161262913,1767,1679,1679,-88,-4.98,1766,-1,-0.06,1679,1679
625,گكيش,توريستي ورفاهي آبادگران كيش,2,2148,98685564,48361,45943,45943,-2418,-5,48336,-25,-0.05,45943,45943
626,كشرق,صنعتي و معدني شمال شرق شاهرود,2,141,12105696,90374,85856,85856,-4518,-5,90370,-4,0,85856,85856
627,وگستر,گسترش سرمايه گذاري ايرانيان,2,1670,30036620,18932,17986,17986,-946,-5,18930,-2,-0.01,17986,17986
628,اخزا720,اسنادخزانه-م20بودجه97-000324,2,7730,7621790729,985999,989000,986001,2,0,986001,2,0,986001,989000
629,زكوثر,سرمايه گذاري كشاورزي كوثر,2,4251,84934980,21030,19980,19980,-1050,-4.99,21030,0,0,19980,19980
630,كمنگنز,معادن‌منگنزايران‌,2,162,13348800,86730,82400,82400,-4330,-4.99,86730,0,0,82400,82400
631,تكنار,مجتمع معادن مس تكنار,2,200,22299400,117365,111497,111497,-5868,-5,117351,-14,-0.01,111497,111497
632,ثفارس,عمران‌وتوسعه‌فارس‌,2,2158,19918340,9710,9230,9230,-480,-4.94,9710,0,0,9230,9230
633,ضمخا2000,اختيارخ اخابر-9000-1400/02/29,2,7,7000,799,1,1,-798,-99.87,1,-798,-99.87,1,1
634,غاذر,كشت‌وصنعت‌پياذر,2,505,26810450,55880,53090,53090,-2790,-4.99,55870,-10,-0.02,53090,53090
635,اراد42,مرابحه عام دولت4-ش.خ 0106,2,400,390379800,961333,999999,951900,-9433,-0.98,975949,14616,1.52,951900,999999
636,ضپاس7027,اختيارخ وپارس-1800-1400/07/28,2,100,90000000,802,900,900,98,12.22,900,98,12.22,900,900
637,ضغدر3002,اختيارخ وغدير-8200-1400/03/26,2,30,41250000,2000,1200,1550,-450,-22.5,1375,-625,-31.25,1200,1550
638,آكورد4,صندوق س. آرمان آتي كوثر-د,2,50000000,1607550000000,32135,32151,32151,16,0.05,32151,16,0.05,32151,32151
639,حفارس,حمل و نقل بين المللي خليج فارس,2,8499,38338989,4748,4511,4511,-237,-4.99,4747,-1,-0.02,4511,4511
640,فافزا,فولاد افزا سپاهان,2,5998,272633092,47846,45454,45454,-2392,-5,47775,-71,-0.15,45454,45454
641,وهنر,گروه توسعه هنر ايران,2,80000,632720000,8153,7909,7909,-244,-2.99,8137,-16,-0.2,7909,7909
642,غشصفا,شيرپاستوريزه‌پگاه‌اصفهان‌,2,410,10836300,27820,26430,26430,-1390,-5,27820,0,0,26430,26430
643,افران2,صندوق س افرا نماد پايدار-ثابت,2,14020000,14020000,13342,1,1,-13341,-99.99,1,-13341,-99.99,1,1
644,سدبير,س. تدبيرگران فارس وخوزستان,2,5525,455862225,86851,82509,82509,-4342,-5,86708,-143,-0.16,82509,82509
645,وجامي,سرمايه گذاري جامي,2,1342,19621382,15073,14621,14621,-452,-3,15072,-1,-0.01,14621,14621
646,تپكو,توليدتجهيزات‌سنگين‌هپكو,2,8745,46365990,5410,5302,5302,-108,-2,5410,0,0,5302,5302
647,ضملي3001,اختيارخ فملي-9000-1400/03/02,2,3,9020000,3065,3000,3020,-45,-1.47,3007,-58,-1.89,3000,3020
648,خكار,ايركا پارت صنعت,2,778,16143500,21840,20750,20750,-1090,-4.99,21840,0,0,20750,20750
649,خفناور,مهندسي صنعتي روان فن آور,2,620,28487760,48366,45948,45948,-2418,-5,48359,-7,-0.01,45948,45948
650,گپارس,امور رفاهي كارگزاران پارس,2,74,14974640,208618,202360,202360,-6258,-3,208608,-10,0,202360,202360
651,اراد214,مرابحه عام دولت2ش.خ صادرات0212,2,19800000,18733804200000,1000000,946167,946104,-53896,-5.39,946152,-53848,-5.38,946104,946167
652,داريك,صندوق س.اعتماد داريك-د,2,5000,52928000,10583,10584,10586,3,0.03,10586,3,0.03,10584,10586
653,زقيام,كشت و دام قيام اصفهان,2,13730,374993760,28749,27312,27312,-1437,-5,28711,-38,-0.13,27312,27312
654,دبالك,مواد اوليه دارويي البرز بالك,2,10000,196870000,20723,19687,19687,-1036,-5,20709,-14,-0.07,19687,19687
655,بشهاب,لامپ‌  پارس‌ شهاب‌,2,123,17430330,149160,141710,141710,-7450,-4.99,149150,-10,-0.01,141710,141710
656,فتوسا4,توليد و توسعه سرب روي ايرانيان,2,15250000,119590500000,1000,7842,7842,6842,684.2,7842,6842,684.2,7842,7842
657,غصينو,صنعتي مينو,2,162,10307898,66977,63629,63629,-3348,-5,66977,0,0,63629,63629
658,بكاب,صنايع‌جوشكاب‌يزد,1,15,5127150,359800,341810,341810,-17990,-5,359790,-10,0,341810,341810
659,كمند2,صندوق س. با درآمد ثابت كمند,1,44700000,44700000,10071,1,1,-10070,-99.99,1,-10070,-99.99,1,1
660,اعتماد4,صندوق س.اعتماد آفرين پارسيان-د,1,100250000,3660528500000,36479,36514,36514,35,0.1,36514,35,0.1,36514,36514
661,صگل309,صكوك اجاره گل گهر309-3ماهه20%,1,2000,2240000000,1100000,1120000,1120000,20000,1.82,1120000,20000,1.82,1120000,1120000
662,دامين2,داروسازي‌ امين‌,1,32129997,153260085690,5020,4770,4770,-250,-4.98,4770,-250,-4.98,4770,4770
663,طمخا7071,اختيارف اخابر-24000-1400/07/28,1,5,81250000,15124,16250,16250,1126,7.45,16250,1126,7.45,16250,16250
664,فلات,گروه صنايع معادن فلات ايرانيان,1,380,5618680,15243,14786,14786,-457,-3,15243,0,0,14786,14786
665,وسيلام,شركت س استان ايلام,1,5000,5890000,1240,1178,1178,-62,-5,1240,0,0,1178,1178
666,اراد434,مرابحه عام دولت4-ش.خ 0205,1,36000,35064000000,997500,974000,974000,-23500,-2.36,974000,-23500,-2.36,974000,974000
667,صفارس1472,صكوك اجاره فارس147- 3ماهه18%,1,100000,100000000000,1044733,1000000,1000000,-44733,-4.28,1000000,-44733,-4.28,1000000,1000000
668,زبينا,كشاورزي و دامپروري بينالود,1,5575,20660950,3901,3706,3706,-195,-5,3901,0,0,3706,3706
669,ضمخا7076,اختيارخ اخابر-10000-1400/07/28,1,8,4000000,638,500,500,-138,-21.63,500,-138,-21.63,500,500
670,كگل2,معدني و صنعتي گل گهر,1,10600000,151156000000,14260,14260,14260,0,0,14260,0,0,14260,14260
671,فنرژي,گسترش صنايع انرژي آذرآب,1,300,5459100,18568,18197,18197,-371,-2,18568,0,0,18197,18197
672,خكاوه,سايپا ديزل,1,1500,5212500,3582,3475,3475,-107,-2.99,3582,0,0,3475,3475
673,ضصاد3002,اختيارخ وبصادر-2500-1400/03/12,1,100,800000,20,8,8,-12,-60,8,-12,-60,8,8
674,ثنور,سرمايه گذاري كوه نور,1,709,6563922,9544,9258,9258,-286,-3,9544,0,0,9258,9258
675,قنيشا,قند  نيشابور,1,342,20889360,64290,61080,61080,-3210,-4.99,64290,0,0,61080,61080
676,اپرداز,آتيه داده پرداز,1,250,5047250,21251,20189,20189,-1062,-5,21251,0,0,20189,20189
677,كيش1402,اجاره س. و توسعه كيش14020820,1,200,200000000,1000000,1000000,1000000,0,0,1000000,0,0,1000000,1000000
678,افاد82,منفعت دولت8-ش.خاص لوتوس0205,1,5000,4680000000,920408,936000,936000,15592,1.69,936000,15592,1.69,936000,936000
679,كتوكا,توليدي و خدمات صنايع نسوز توكا,1,750,24437250,34297,32583,32583,-1714,-5,34294,-3,-0.01,32583,32583
680,اخزا9082,اسنادخزانه-م8بودجه99-020606,1,100000,62418300000,627337,624183,624183,-3154,-0.5,624183,-3154,-0.5,624183,624183
681,سكرد,سيمان كردستان,1,756,7038360,9790,9310,9310,-480,-4.9,9790,0,0,9310,9310
682,تشتاد,صنايع توليدي اشتاد ايران‌,1,922,14022698,15679,15209,15209,-470,-3,15678,-1,-0.01,15209,15209
683,اراد37,مرابحه عام دولت3-ش.خ 0005,1,2000,2000000000,987000,1000000,1000000,13000,1.32,1000000,13000,1.32,1000000,1000000
684,سرو2,صندوق س سروسودمند مدبران-سهام,1,100000,100000,62190,1,1,-62189,-100,1,-62189,-100,1,1
685,سنوين,سرمايه گذاري اقتصاد نوين,1,1000,8683000,9139,8683,8683,-456,-4.99,9139,0,0,8683,8683
686,كشم0006پ02,كشمش تيزابي0006تاكستان(پ),1,24,5227200,216700,217800,217800,1100,0.51,217800,1100,0.51,217800,217800
687,ولتجار,واسپاري تجارت وسرمايه ايرانيان,1,3200,23804800,7669,7439,7439,-230,-3,7668,-1,-0.01,7439,7439
688,خچرخش,چرخشگر,1,5377,69739690,13650,12970,12970,-680,-4.98,13650,0,0,12970,12970
689,دشيمي,شيمي‌ داروئي‌ داروپخش‌,1,200,5790000,30470,28950,28950,-1520,-4.99,30470,0,0,28950,28950
690,شساخت2,مهندسي و ساختمان صنايع نفت,1,2000000,86000000000,42824,43000,43000,176,0.41,43000,176,0.41,43000,43000
691,سنفت009,سلف موازي استاندارد سنفت009,1,32600,49970910000,1532060,1532850,1532850,790,0.05,1532850,790,0.05,1532850,1532850
692,اراد644,مرابحه عام دولتي64-ش.خ0111,1,10000000,9428480000000,944500,942848,942848,-1652,-0.17,942848,-1652,-0.17,942848,942848
693,فجام,جام‌دارو,1,560,5180000,9730,9250,9250,-480,-4.93,9730,0,0,9250,9250
694,وتعاون,بيمه  تعاون,1,888,5422128,6294,6106,6106,-188,-2.99,6294,0,0,6106,6106
695,زشگزا,شير و گوشت زاگرس شهركرد,1,660,5141400,8200,7790,7790,-410,-5,8200,0,0,7790,7790
696,زشريف,كشت وصنعت شريف آباد,1,2000,9882000,5201,4941,4941,-260,-5,5201,0,0,4941,4941
697,تملي804,تسهيلات مسكن ب. ملي-تير98,1,17,8737082,540995,513946,513946,-27049,-5,513946,-27049,-5,513946,513946
698,تملي806,تسهيلات مسكن ب. ملي-شهريور98,1,8,4035968,531048,504496,504496,-26552,-5,504496,-26552,-5,504496,504496
699,كيميا,معدني كيمياي زنجان گستران,1,500,8339000,17555,16678,16678,-877,-5,17554,-1,-0.01,16678,16678
700,كاسپين,داروسازي كاسپين تامين,1,1000,24530000,25821,24530,24530,-1291,-5,25819,-2,-0.01,24530,24530
701,ضگل8071,اختيار خ كگل-9000-1400/08/23,1,10,68000000,1,6800,6800,6799,679900,6800,6799,679900,6800,6800
702,وسرضوي,س.سهام عدالت استان خراسان رضوي,1,5317,5205343,1030,979,979,-51,-4.95,1030,0,0,979,979
703,سغرب,سيمان‌غرب‌,1,356,9928840,29350,27890,27890,-1460,-4.97,29350,0,0,27890,27890
704,اراد834,مرابحه عام دولت83-ش.خ041220,1,11370000,10387393230000,1000000,913579,913579,-86421,-8.64,913579,-86421,-8.64,913579,913579
705,فبيرا,بسته‌ بندي‌ ايران‌,1,2000,6010000,3097,3005,3005,-92,-2.97,3097,0,0,3005,3005
706,طمخا7068,اختيارف اخابر-16000-1400/07/28,1,4,30748000,6741,7687,7687,946,14.03,7687,946,14.03,7687,7687
707,صفارس307,صكوك اجاره فارس307- 3ماهه18%,1,1000,980700000,970000,980700,980700,10700,1.1,980700,10700,1.1,980700,980700
708,اوصتا4,صندوق انديشه ورزان صباتامين -د,1,25130689,470119799123,18666,18707,18707,41,0.22,18707,41,0.22,18707,18707
709,خاذين,سايپاآذين‌,1,1150,5169250,4731,4495,4495,-236,-4.99,4731,0,0,4495,4495
710,اراد35,مرابحه عام دولت3-ش.خ 0103,1,200,199998000,996000,999990,999990,3990,0.4,999990,3990,0.4,999990,999990
711,ضفار3002,اختيارخ فارس-10000-1400/03/05,1,10,1000000,1,100,100,99,9900,100,99,9900,100,100
712,نيرو,نيرو سرمايه,1,187,9570660,53873,51180,51180,-2693,-5,53870,-3,-0.01,51180,51180
713,فزرين,زرين معدن آسيا,1,201,5063793,26518,25193,25193,-1325,-5,26518,0,0,25193,25193
714,عيار2,صندوق س. پشتوانه طلاي مفيد,1,10000,10000,25890,1,1,-25889,-100,1,-25889,-100,1,1
715,اراد61,مرابحه عام دولت61-ش.خ0309,1,3000,3000000000,1000000,1000000,1000000,0,0,1000000,0,0,1000000,1000000
716,ضترا3004,اختيارخ شتران-10000-1400/03/09,1,1,5000,100,5,5,-95,-95,5,-95,-95,5,5
717,صايپا0122,صكوك مرابحه سايپا012-3ماهه 16%,1,190000,190000000000,1000002,1000000,1000000,-2,0,1000000,-2,0,1000000,1000000
718,وآذر,سرمايه‌گذاري‌توسعه‌آذربايجان‌,1,100,7807000,82170,78070,78070,-4100,-4.99,82170,0,0,78070,78070
719,فملي2,ملي‌ صنايع‌ مس‌ ايران‌,1,197160883,2499999996440,12960,12680,12680,-280,-2.16,12680,-280,-2.16,12680,12680
720,پست0008پ08,پسته فندقي32-30مه ولات0008(پ),1,4,6579996,1595601,1644999,1644999,49398,3.1,1644999,49398,3.1,1644999,1644999
721,داوه,داروسازي آوه سينا,1,1000,19165000,20173,19165,19165,-1008,-5,20172,-1,0,19165,19165
722,زمگسا,كشاورزي‌ ودامپروي‌ مگسال‌,1,500,15435000,32490,30870,30870,-1620,-4.99,32490,0,0,30870,30870
723,تملي809,تسهيلات مسكن ب. ملي-آذر98,1,22,10509488,454957,477704,477704,22747,5,477704,22747,5,477704,477704
724,وسخراج,شركت س استان خراسان جنوبي,1,5000,10545000,2220,2109,2109,-111,-5,2220,0,0,2109,2109
725,ضمخا2002,اختيارخ اخابر-12000-1400/02/29,1,18,18000,956,1,1,-955,-99.9,1,-955,-99.9,1,1
726,آبين,كشت و صنعت آبشيرين,1,2000,8252000,4210,4126,4126,-84,-2,4210,0,0,4126,4126
727,ثاصفا,شركت‌ ساختمان‌ اصفهان‌,1,190,5118790,27774,26941,26941,-833,-3,27774,0,0,26941,26941
728,اراد544,مرابحه عام دولت5-ش.خ 0109,1,5000000,4741315000000,1015000,948263,948263,-66737,-6.58,948263,-66737,-6.58,948263,948263
729,بالاس,مهندسي ساختمان تاسيسات راه آهن,1,1000,53236000,56037,53236,53236,-2801,-5,56026,-11,-0.02,53236,53236
730,سصفها,سيمان‌اصفهان‌,1,350,42185500,126870,120530,120530,-6340,-5,126860,-10,-0.01,120530,120530
731,كابگن,توليدي و صنعتي آبگينه‌,1,1277,6627630,5139,5190,5190,51,0.99,5139,0,0,5190,5190
732,نبروج,نساجي بروجرد,1,1800,10677600,5816,5932,5932,116,1.99,5816,0,0,5932,5932
733,فخوز2,فولاد  خوزستان,1,10000000,151200000000,15120,15120,15120,0,0,15120,0,0,15120,15120
734,اراد494,مرابحه عام دولت4-ش.خ 0206,1,10712000,10053511936000,1009900,938528,938528,-71372,-7.07,938528,-71372,-7.07,938528,938528
735,حسير,ريل سير كوثر,1,310,5123990,17398,16529,16529,-869,-4.99,17398,0,0,16529,16529
736,دمعيار4,صندوق س. توازن معيار-د,1,20103909,204054676350,10139,10150,10150,11,0.11,10150,11,0.11,10150,10150
737,خساپا4,سايپا,1,402000000,699480000000,1821,1740,1740,-81,-4.45,1740,-81,-4.45,1740,1740
738,ضشنا8000,اختيارخ شپنا-7000-1400/08/16,1,1,2100000,3980,2100,2100,-1880,-47.24,2100,-1880,-47.24,2100,2100
739,كسرام,پارس‌ سرام‌,1,645,5037450,8220,7810,7810,-410,-4.99,8220,0,0,7810,7810
740,تاپيكو2,س. نفت و گاز و پتروشيمي تأمين,1,236294896,2499999999680,10560,10580,10580,20,0.19,10580,20,0.19,10580,10580
741,نتوس,پشم‌ بافي‌ توس,1,1000,21117000,21770,21117,21117,-653,-3,21769,-1,0,21117,21117
742,اراد48,مرابحه عام دولت4-ش.خ 0009,1,1000,999998000,960000,999998,999998,39998,4.17,999998,39998,4.17,999998,999998
743,اراد33,مرابحه عام دولت3-ش.خ 0303,1,200,177995800,875000,889979,889979,14979,1.71,889979,14979,1.71,889979,889979
744,ضفار3010,اختيارخ فارس-7000-1400/03/05,1,5,25000000,2000,5000,5000,3000,150,5000,3000,150,5000,5000
745,وسنا,سرمايه گذاري نيروگاهي ايران,1,20000,304300000,15685,15215,15215,-470,-3,15678,-7,-0.04,15215,15215
746,زدشت,كشت و صنعت دشت خرم دره,1,182,5026294,29070,27617,27617,-1453,-5,29069,-1,0,27617,27617
747,صبا1404,اجاصبابدون ضامن بارتبه اعتباري,1,50000,51500000000,1000000,1030000,1030000,30000,3,1030000,30000,3,1030000,1030000
748,غفارس,شير پاستوريزه پگاه فارس,1,573,9956448,18290,17376,17376,-914,-5,18289,-1,-0.01,17376,17376
749,قزوين,كارخانجات‌ قند قزوين‌,1,150,5638500,39560,37590,37590,-1970,-4.98,39560,0,0,37590,37590
750,خلنت,لنت‌ ترمزايران‌,1,171,9962460,61320,58260,58260,-3060,-4.99,61320,0,0,58260,58260
751,قهكمت,قندهكمتان‌,1,115,5031250,46050,43750,43750,-2300,-4.99,46050,0,0,43750,43750
752,ويسرو,ص.ج.سرو رشد پايداريكم 20%تاديه,1,5000,921600000,192000,184320,184320,-7680,-4,184320,-7680,-4,184320,184320
753,خكمك,كمك‌فنرايندامين‌,1,201,5175750,27100,25750,25750,-1350,-4.98,27100,0,0,25750,25750
754,پارسان2,گسترش نفت و گاز پارسيان,1,5498653,98700821350,18120,17950,17950,-170,-0.94,17950,-170,-0.94,17950,17950
755,صخود4122,ص مرابحه خودرو412- 3ماهه 18%,1,350000,348250000000,995000,995000,995000,0,0,995000,0,0,995000,995000
756,آينده,بازرگاني آينده سازان بهشت پارس,1,1000,19255000,19850,19255,19255,-595,-3,19849,-1,-0.01,19255,19255
757,گواهي ظرفيت,گواهي ظرفيت نقدي,1,543000,9876627000,17323,18189,18189,866,5,18189,866,5,18189,18189
