,نماد,نام,تعداد,حجم,ارزش,دیروز,اولین,آخرین معامله - مقدار,آخرین معامله - تغییر,آخرین معامله - درصد,قیمت پایانی - مقدار,قیمت پایانی - تغییر,قیمت پایانی - درصد,کمترین,بیشترین
2,پالايش,صندوق پالايشي يکم-سهام,40246,53164342,3852142989100,71120,73200,70890,-230,-0.32,72460,1340,1.88,70600,74250
3,دارا يكم,صندوق واسطه گري مالي يكم-سهام,38631,34122931,4505694275070,125470,129100,130700,5230,4.17,132040,6570,5.24,126120,136000
4,بركت,گروه دارويي بركت,25388,71861002,2318520191760,31910,31950,31610,-300,-0.94,32260,350,1.1,31280,33750
5,خودرو,ايران‌ خودرو,22246,698146095,1550206765670,2240,2230,2200,-40,-1.79,2220,-20,-0.89,2200,2280
6,شستا,سرمايه گذاري تامين اجتماعي,22034,114390251,1349675311090,11370,11720,11580,210,1.85,11800,430,3.78,11400,12050
7,وتجارت,بانك تجارت,19123,568433831,1522476363610,2580,2550,2640,60,2.33,2680,100,3.88,2530,2730
8,امينح,ح . تامين سرمايه امين,17867,12110982,55666462330,4570,4610,4610,40,0.88,4600,30,0.66,4450,4800
9,خساپا,سايپا,17450,718103226,1532575479620,2170,2130,2130,-40,-1.84,2130,-40,-1.84,2130,2170
10,شپنا,پالايش نفت اصفهان,15144,128558673,1473425298750,11630,11700,11400,-230,-1.98,11460,-170,-1.46,11400,11770
11,وبملت,بانك ملت,13422,528713038,2211245804840,3970,4040,4190,220,5.54,4180,210,5.29,4040,4200
12,وبصادر,بانك صادرات ايران,12943,381779011,901590198820,2290,2290,2330,40,1.75,2360,70,3.06,2250,2420
13,فملي,ملي‌ صنايع‌ مس‌ ايران‌,11976,65686686,741121297140,11140,11350,11140,0,0,11280,140,1.26,11090,11560
14,پترول,گروه پتروشيمي س. ايرانيان,10165,55268567,498032065100,9040,9300,8870,-170,-1.88,9010,-30,-0.33,8860,9300
15,فولاد,فولاد مباركه اصفهان,9962,68198392,842585511130,12290,12310,12180,-110,-0.9,12350,60,0.49,12120,12650
16,كمند,صندوق س. با درآمد ثابت كمند,9291,711000695,7172611578360,10083,10088,10088,5,0.05,10088,5,0.05,10088,10090
17,شتران,پالايش نفت تهران,7029,65286263,603944426150,9410,9320,9230,-180,-1.91,9250,-160,-1.7,9230,9470
18,وپارس,بانك‌پارسيان‌,6725,274287372,725735935080,2520,2550,2620,100,3.97,2650,130,5.16,2500,2670
19,ذوب,سهامي ذوب آهن  اصفهان,6236,111517453,400222419147,3656,3611,3583,-73,-2,3589,-67,-1.83,3583,3650
20,وكبهمن,مديريت سرمايه گذاري كوثربهمن,6168,2880688,30765412348,10744,10900,10580,-164,-1.53,10702,-42,-0.39,10530,10948
21,شبندر,پالايش نفت بندرعباس,5709,21568850,493497516420,23300,22850,22840,-460,-1.97,22880,-420,-1.8,22840,23300
22,بپيوند,برق و انرژي پيوندگستر پارس,5522,3318986,42474566697,12952,12740,12693,-259,-2,12816,-136,-1.05,12693,13100
23,بوعلي,پتروشيمي بوعلي سينا,5378,1497651,62893492420,42030,41810,41640,-390,-0.93,41990,-40,-0.1,41550,42500
24,اپال,فرآوري معدني اپال كاني پارس,5277,6061951,102726342960,16770,17020,16930,160,0.95,16920,150,0.89,16790,17340
25,آبادا,توليد نيروي برق آبادان,4719,3361513,43813467120,13280,13030,13060,-220,-1.66,13060,-220,-1.66,13020,13280
26,وغدير,سرمايه‌گذاري‌غدير(هلدينگ‌,4283,24926711,261345889880,10590,10390,10380,-210,-1.98,10480,-110,-1.04,10380,10800
27,شگويا,پتروشيمي تندگويان,4268,25401015,222648118780,8896,8890,8719,-177,-1.99,8765,-131,-1.47,8719,9055
28,آريا,پليمر آريا ساسول,4204,1708494,146580464763,85413,85010,85030,-383,-0.45,85795,382,0.45,84715,87980
29,غگل,گلوكوزان‌,3586,46476377,153103190760,3320,3260,3270,-50,-1.51,3290,-30,-0.9,3260,3400
30,وساپا,سرمايه‌گذاري‌ سايپا,3504,52915407,266111524860,5120,5020,5020,-100,-1.95,5030,-90,-1.76,5020,5120
31,وپاسار,بانك  پاسارگاد,3427,56941411,773533141470,13400,13400,13780,380,2.84,13580,180,1.34,13390,13810
32,ونوين,بانك‌اقتصادنوين‌,3407,70639962,314528223970,4340,4370,4390,50,1.15,4450,110,2.53,4270,4570
33,بگيلان,توسعه مسير برق گيلان,3336,794989,16721061361,21411,21021,20983,-428,-2,21281,-130,-0.61,20983,21353
34,آوا,صندوق س.سهام آواي معيار-س,3254,26980415,168740068521,6137,6285,6320,183,2.98,6254,117,1.91,6150,6390
35,فارس,صنايع پتروشيمي خليج فارس,2777,14941771,138703860750,9360,9460,9180,-180,-1.92,9280,-80,-0.85,9180,9550
36,فايرا,آلومينيوم‌ايران‌,2670,9637749,170703421790,17630,17990,17280,-350,-1.99,17710,80,0.45,17280,18450
37,فخوز,فولاد  خوزستان,2416,9201613,135782181440,14470,14760,14590,120,0.83,14760,290,2,14410,15040
38,صبا,سرمايه گذاري صبا تامين,2389,6641758,50172360166,7500,7460,7484,-16,-0.21,7523,23,0.31,7450,7745
39,نوري,پتروشيمي نوري,2332,2583624,156210767340,60410,60010,59700,-710,-1.18,60460,50,0.08,59240,61850
40,وسينا,بانك سينا,2295,54605666,165671375640,3010,2960,2990,-20,-0.66,3030,20,0.66,2950,3180
41,وخارزمح,ح.سرمايه گذاري خوارزمي,2108,8435936,29799497150,3490,3550,3480,-10,-0.29,3530,40,1.15,3480,3690
42,سيدكو,سرمايه گذاري توسعه صنايع سيمان,2101,18010228,115414218720,6080,6290,6440,360,5.92,6410,330,5.43,6210,6440
43,سپيدما,صندوق س. سپيد دماوند-د,2046,100037086,1020378272356,10000,10200,10200,200,2,10200,200,2,10196,10202
44,شبريز,پالايش نفت تبريز,2035,5930249,166369039910,28600,28030,28030,-570,-1.99,28050,-550,-1.92,28030,28410
45,ولانا,شركت ليزينگ آريا دانا,2030,5410103,232971672742,42176,42179,43442,1266,3,43062,886,2.1,41336,43444
46,تملت,تامين سرمايه بانك ملت,2025,17581512,88057127480,5100,5000,5000,-100,-1.96,5010,-90,-1.76,5000,5250
47,سرو,صندوق س سروسودمند مدبران-سهام,1977,2255606,146203110990,64350,65290,64140,-210,-0.33,64820,470,0.73,63580,66150
48,امين يكم,صندوق درآمد ثابت امين يكم فردا,1905,50321342,513916737839,10205,10215,10218,13,0.13,10213,8,0.08,10208,10218
49,بجهرم,توسعه مولد نيروگاهي جهرم,1875,25664078,67113870165,2664,2625,2611,-53,-1.99,2615,-49,-1.84,2611,2670
50,تاصيكو,سرمايه گذاري صدرتامين,1854,18630099,188639741640,9970,10240,10040,70,0.7,10130,160,1.6,9970,10250
51,كاوه,فولاد كاوه جنوب كيش,1852,4555055,98126681280,20950,21830,21220,270,1.29,21520,570,2.72,21050,22100
52,تاپيكو,س. نفت و گاز و پتروشيمي تأمين,1848,16469046,181679261210,11150,11100,10930,-220,-1.97,11030,-120,-1.08,10930,11450
53,اعتماد,صندوق س.اعتماد آفرين پارسيان-د,1832,46573590,1675798716570,35965,35981,35987,22,0.06,35982,17,0.05,35979,35987
54,فنوال,نورد آلومينيوم‌,1809,3545266,89548445410,24440,23960,25900,1460,5.97,25260,820,3.36,23960,25900
55,ضخود2005,اختيارخ خودرو-2000-1400/02/08,1673,79910,11563810000,136,159,124,-12,-8.82,145,9,6.62,121,180
56,آگاس,صندوق س.هستي بخش آگاه-س,1666,2067688,135580576023,64197,65490,64970,773,1.2,65571,1374,2.14,64190,69000
57,سبزوا,سيمان لار سبزوار,1649,15544719,53629125690,3486,3417,3417,-69,-1.98,3450,-36,-1.03,3417,3680
58,شيران,س. صنايع‌شيميايي‌ايران,1615,4093630,97233628480,24110,23640,23630,-480,-1.99,23750,-360,-1.49,23630,24380
59,حفاري,حفاري شمال,1590,12967788,92274876860,7240,7100,7100,-140,-1.93,7120,-120,-1.66,7100,7200
60,كگلح,ح . معدني و صنعتي گل گهر,1485,3392955,37564359180,10770,11140,10970,200,1.86,11070,300,2.79,10930,11350
61,فجر,فولاد اميركبيركاشان,1447,2888847,163555453410,57690,56540,56540,-1150,-1.99,56620,-1070,-1.85,56540,57650
62,غگيلا,شيرپاستوريزه پگاه گيلان,1418,136638,3336153408,23034,24416,24416,1382,6,23121,87,0.38,24416,24416
63,كچاد,معدني‌وصنعتي‌چادرملو,1395,3756176,86144010220,22990,22760,22670,-320,-1.39,22950,-40,-0.17,22600,23510
64,فباهنرح,ح . مس‌ شهيدباهنر,1372,4354451,68768428590,15160,15900,15710,550,3.63,15790,630,4.16,15430,16350
65,سامان,بانك سامان,1358,18588490,172225015604,9579,9196,9300,-279,-2.91,9265,-314,-3.28,9196,9629
66,شپديس,پتروشيمي پرديس,1321,1150629,110358826550,91580,95820,95410,3830,4.18,95910,4330,4.73,94000,96830
67,شلرد,كود شيميايي اوره لردگان,1313,14419227,94898875382,6545,6545,6500,-45,-0.69,6581,36,0.55,6420,6700
68,خگستر,گسترش‌سرمايه‌گذاري‌ايران‌خودرو,1286,30662614,79722796400,2650,2600,2600,-50,-1.89,2600,-50,-1.89,2600,2600
69,وصنعت,سرمايه گذاري توسعه صنعت وتجارت,1248,6774472,41210658010,6040,5990,6030,-10,-0.17,6080,40,0.66,5990,6170
70,كيان,صندوق س. با درآمد ثابت كيان,1236,14661000,411166075310,28032,28046,28050,18,0.06,28045,13,0.05,28040,28051
71,وشهر,بانك شهر,1220,10411899,58013418861,5459,5410,5661,202,3.7,5572,113,2.07,5379,5677
72,ونيكي,سرمايه‌گذاري‌ ملي‌ايران‌,1199,6995047,63847158320,9260,9140,9080,-180,-1.94,9130,-130,-1.4,9080,9410
73,خكرمان,گروه اقتصادي كرمان خودرو,1139,21697469,82775234674,3714,3700,3825,111,2.99,3815,101,2.72,3700,3825
74,زاگرس,پتروشيمي زاگرس,1096,386361,78987709433,205971,202960,201855,-4116,-2,204707,-1264,-0.61,201852,209500
75,سرچشمه,سرمايه گذاري مس سرچشمه,1075,16226690,103656532461,6509,6400,6379,-130,-2,6388,-121,-1.86,6379,6690
76,كگل,معدني و صنعتي گل گهر,1055,4033924,58718757710,14640,14590,14500,-140,-0.96,14600,-40,-0.27,14400,14890
77,وملل,اعتباري ملل,1052,33412066,446048617034,13349,13350,13350,1,0.01,13350,1,0.01,13345,13480
78,مدير,ص.س.مديريت ثروت ص.بازنشستگي-س,1016,5129043,41569804096,7992,8140,8027,35,0.44,8105,113,1.41,7950,8250
79,ما,بيمه  ما,980,9772892,70848319720,7260,7120,7140,-120,-1.65,7250,-10,-0.14,7120,7550
80,وكار,بانك‌ كارآفرين‌,967,19679771,50750283420,2520,2470,2530,10,0.4,2580,60,2.38,2470,2670
81,حتايد,تايدواترخاورميانه,957,4738789,129082662680,27750,27200,27200,-550,-1.98,27240,-510,-1.84,27200,28080
82,فاسمين,كالسيمين‌,954,9716443,159258907460,16720,16390,16390,-330,-1.97,16390,-330,-1.97,16390,16450
83,شسپا,نفت سپاهان,953,3788750,56672247060,14840,14770,14860,20,0.13,14960,120,0.81,14600,15190
84,ومهان,گروه توسعه مالي مهر آيندگان,951,2247024,27606981095,12259,12320,12187,-72,-0.59,12274,15,0.12,12127,12555
85,وخاور,بانك خاورميانه,920,5476919,47038456900,8330,8250,8560,230,2.76,8570,240,2.88,8250,8800
86,ضسپا3003,اختيارخ خساپا-2000-1400/03/26,904,37979,7501977000,202,250,189,-13,-6.44,198,-4,-1.98,178,254
87,زشريف,كشت وصنعت شريف آباد,891,14349161,75059900210,5336,5230,5230,-106,-1.99,5231,-105,-1.97,5230,5318
88,هرمز,فولاد هرمزگان جنوب,884,3592349,53132638170,14644,15000,14970,326,2.23,14710,66,0.45,14430,15150
89,پارند,صندوق س. پارند پايدار سپهر,875,32793261,369589632360,11265,11273,11272,7,0.06,11270,5,0.04,11270,11274
90,ارزش,صندوق س ارزش آفرين بيدار-سهام,837,5113602,47736663780,9270,9400,9200,-70,-0.76,9340,70,0.76,9180,9490
91,افق,فروشگاههاي زنجيره اي افق كوروش,830,1963474,133640712000,69420,68040,68100,-1320,-1.9,68060,-1360,-1.96,68040,69360
92,ضخود2007,اختيارخ خودرو-3000-1400/02/08,822,40412,62836000,2,2,1,-1,-50,2,0,0,1,3
93,سجامح,ح.مجتمع سيمان غرب آسيا,797,6867482,12571248265,1834,1798,1886,52,2.84,1831,-3,-0.16,1798,1889
94,معيار,سرمايه گذاري معيار صنعت پارس,796,1080464,58623321877,53779,52704,55392,1613,3,54258,479,0.89,52704,55392
95,دارا,صندوق س. دارا الگوريتم-د,781,35749337,360373199723,10072,10096,10089,17,0.17,10081,9,0.09,10080,10108
96,واحيا,م .صنايع و معادن احياء سپاهان,763,1656551,222699093061,139622,134038,134038,-5584,-4,134435,-5187,-3.72,134038,136790
97,وبانك,سرمايه گذاري گروه توسعه ملي,762,4604613,37682592080,8330,8200,8170,-160,-1.92,8270,-60,-0.72,8170,8340
98,پارسان,گسترش نفت و گاز پارسيان,752,7895601,154449340840,19940,19550,19550,-390,-1.96,19560,-380,-1.91,19550,19990
99,وسكاب,س.ص.بازنشستگي كاركنان بانكها,731,6385854,31715675760,5050,4950,5000,-50,-0.99,5000,-50,-0.99,4950,5050
100,تسه9912,امتياز تسهيلات مسكن اسفند99,696,33667,16662772301,512648,512648,497000,-15648,-3.05,494929,-17719,-3.46,487016,525000
101,ضخود2006,اختيارخ خودرو-2500-1400/02/08,692,33232,431163000,13,13,11,-2,-15.38,13,0,0,9,19
102,بميلا,توسعه بازرگاني آهن وفولادميلاد,687,3111180,38989688639,13139,12800,12483,-656,-4.99,12532,-607,-4.62,12483,13363
103,وثنو,سرمايه گذاري ساختماني نوين,681,4237900,23915541220,5572,5500,5518,-54,-0.97,5643,71,1.27,5294,5850
104,جمح,ح . پتروشيمي جم,678,2143692,60353034390,28080,29250,28600,520,1.85,28150,70,0.25,27910,29250
105,وساخت,سرمايه‌ گذاري‌ ساختمان‌ايران‌,676,750374,34217181320,45910,45110,45040,-870,-1.9,45680,-230,-0.5,45030,46980
106,كاردان,صندوق س تجارت شاخصي كاردان,661,495522,74345311410,148900,153790,149990,1090,0.73,150030,1130,0.76,147170,153790
107,ارفع,شركت آهن و فولاد ارفع,652,2940589,43624332308,14881,15150,14740,-141,-0.95,14853,-28,-0.19,14584,15230
108,شصدف,صنعتي دوده فام,652,33332,1071523804,30328,32147,32147,1819,6,30365,37,0.12,32147,32147
109,همراه,شركت ارتباطات سيار ايران,637,1068800,27237521580,25850,25350,25340,-510,-1.97,25750,-100,-0.39,25340,26290
110,طلا,صندوق س.پشتوانه طلاي لوتوس,623,443038,31595451593,73241,72000,71455,-1786,-2.44,71315,-1926,-2.63,70800,72000
111,ونفت,سرمايه‌گذاري‌ صنعت‌ نفت‌,616,2613655,39380079490,15240,14960,14940,-300,-1.97,15100,-140,-0.92,14940,15500
112,فنورد,نوردوقطعات‌ فولادي‌,609,222876,39178411620,178910,175340,175340,-3570,-2,176330,-2580,-1.44,175340,179950
113,فسازان,غلتك سازان سپاهان,597,1326302,46106069560,34890,34220,34200,-690,-1.98,34770,-120,-0.34,34200,35290
114,پترولح,ح . گروه پتروشيمي س. ايرانيان,589,14821095,107590853190,6950,7600,7000,50,0.72,7260,310,4.46,7000,7600
115,رمپنا,گروه مپنا (سهامي عام),588,6491947,110956063390,17430,17090,17090,-340,-1.95,17110,-320,-1.84,17090,17300
116,بپاس,بيمه پاسارگاد,586,1001149,88275057008,87967,88000,88611,644,0.73,88149,182,0.21,87967,88700
117,ميدكو,هلدينگ صنايع  معدني خاورميانه,518,3563268,116161198358,32307,32307,32634,327,1.01,32588,281,0.87,32307,32640
118,سكه0012پ01,سكه تمام بهارتحويلي 1روزه رفاه,494,133100,131903681600,1013623,998990,995880,-17743,-1.75,991012,-22611,-2.23,980012,998990
119,شفن,پتروشيمي فناوران,482,90688,29557703220,323320,330000,324030,710,0.22,324090,770,0.24,319170,330000
120,سحرخيز,صندوق س. گروه زعفران سحرخيز,481,1539661,15501476062,9945,10050,10050,105,1.06,10068,123,1.24,9960,10150
121,گكيشح,ح.توريستي ورفاهي آبادگران كيش,454,1018986,30184621021,29653,29060,30542,889,3,29622,-31,-0.1,29060,30542
122,سپ,پرداخت الكترونيك سامان كيش,449,1208097,25661645450,21640,21210,21210,-430,-1.99,21430,-210,-0.97,21210,22200
123,افران,صندوق س افرا نماد پايدار-ثابت,436,13563241,178230479357,13132,13138,13143,11,0.08,13141,9,0.07,13137,13143
124,انرژي3,سايراشخاص بورس انرژي,432,59559,14608631520,255500,245280,245280,-10220,-4,252960,-2540,-0.99,245280,245280
125,شاراك,پتروشيمي شازند,408,866006,21267465200,24460,24200,24440,-20,-0.08,24490,30,0.12,24200,24970
126,تسه9911,امتياز تسهيلات مسكن بهمن99,401,29382,14519179690,498108,490000,490000,-8108,-1.63,494152,-3956,-0.79,480022,510000
127,نهال,صندوق س. طلاي سرخ نوويرا,398,1007740,10951007236,10569,10880,10750,181,1.71,10867,298,2.82,10750,10999
128,شگلح,ح . گلتاش‌,397,1558897,9679137430,6220,6290,6190,-30,-0.48,6210,-10,-0.16,6060,6630
129,حكشتي,كشتيراني جمهوري اسلامي ايران,394,1742161,31045309020,18180,17820,17820,-360,-1.98,18080,-100,-0.55,17820,17820
130,پارسيان,بيمه پارسيان,389,4002705,40704380400,10340,10140,10180,-160,-1.55,10200,-140,-1.35,10140,10340
131,دعبيد,لابراتوارداروسازي‌  دكترعبيدي‌,379,956346,21914498370,22800,22460,22900,100,0.44,22850,50,0.22,22450,23170
132,وصندوق,سرمايه‌گذاري‌صندوق‌بازنشستگي‌,369,2483739,35444399810,14520,14230,14230,-290,-2,14440,-80,-0.55,14230,14740
133,جم,پتروشيمي جم,362,547853,19459805940,35660,36890,35000,-660,-1.85,35630,-30,-0.08,34980,36890
134,پارند2,صندوق س. پارند پايدار سپهر,346,34600000,34600000,11265,1,1,-11264,-99.99,1,-11264,-99.99,1,1
135,آريان,سرمايه گذاري پارس آريان,345,9169867,94440505897,10506,10300,10296,-210,-2,10299,-207,-1.97,10296,10689
136,شبهرن,نفت‌ بهران‌,342,2447205,31838137050,13270,13010,13010,-260,-1.96,13140,-130,-0.98,13010,13010
137,وحكمت,بيمه حكمت صبا,337,2573833,9335413800,3683,3615,3650,-33,-0.9,3656,-27,-0.73,3610,3682
138,وخارزم,سرمايه گذاري خوارزمي,333,2719907,14007521050,5250,5150,5150,-100,-1.9,5220,-30,-0.57,5150,5150
139,وسپه,سرمايه‌گذاري‌ سپه‌,330,1451660,9535664840,6670,6540,6540,-130,-1.95,6650,-20,-0.3,6540,6690
140,ضخود7076,اختيارخ خودرو-2500-1400/07/07,330,15896,3315064000,202,210,200,-2,-0.99,209,7,3.47,200,240
141,آكورد,صندوق س. آرمان آتي كوثر-د,327,5019420,159016004188,31665,31681,31682,17,0.05,31680,15,0.05,31679,31683
142,فافزا,فولاد افزا سپاهان,325,297242,15708009034,53384,52317,52490,-894,-1.67,52949,-435,-0.81,52317,54979
143,تيپيكو,سرمايه گذاري دارويي تامين,321,686529,27207140810,39730,39000,39200,-530,-1.33,39690,-40,-0.1,38950,40050
144,حسينا,توسعه خدمات دريايي وبندري سينا,321,492037,32365014761,66241,65000,65850,-391,-0.59,65925,-316,-0.48,64917,66860
145,وسين,بيمه سينا,314,2764437,34582636571,12733,12505,12480,-253,-1.99,12510,-223,-1.75,12479,12733
146,كرماشا,صنايع پتروشيمي كرمانشاه,312,431196,15387166490,35320,34700,34850,-470,-1.33,35430,110,0.31,34700,36190
147,ضسپا3004,اختيارخ خساپا-2500-1400/03/26,304,11501,1093274000,95,119,89,-6,-6.32,95,0,0,86,119
148,اطلس,صندوق س.توسعه اندوخته آينده-س,299,73184,14962858492,203327,203601,203500,173,0.09,204455,1128,0.55,203500,206999
149,شرانل,نفت ايرانول,296,471392,17988013296,37909,38100,38349,440,1.16,37999,90,0.24,37903,38740
150,كاريس,صندوق س.سپهر كاريزما-س,295,954657,10427873056,10835,11080,10740,-95,-0.88,10923,88,0.81,10720,11099
151,تصميم,صندوق س با درآمد ثابت تصميم,292,2855878,46160882621,16156,16161,16167,11,0.07,16163,7,0.04,16161,16167
152,شبصير,توليدات پتروشيمي قائد بصير,284,175450,11962503794,69419,68350,68031,-1388,-2,69109,-310,-0.45,68031,70820
153,تماوند,تامين سرمايه دماوند,281,1488253,24498145693,16152,15831,16636,484,3,16461,309,1.91,15831,16636
154,ياقوت,صندوق س ياقوت آگاه-ثابت,271,1326175,16301107992,12292,12283,12295,3,0.02,12292,0,0,12283,12298
155,زگلدشتح,ح.كشت و دام گلدشت نمونه اصفهان,262,1818287,14277247315,8000,7840,7840,-160,-2,7852,-148,-1.85,7840,8000
156,فيروزه,صندوق شاخص30 شركت فيروزه- سهام,258,121354,15835061550,128350,132030,128510,160,0.12,130490,2140,1.67,128350,133400
157,والبر,سرمايه‌ گذاري‌ البرز(هلدينگ‌,255,2515075,43561101900,17670,17320,17320,-350,-1.98,17360,-310,-1.75,17320,17330
158,آساميد,صندوق س.مشترك آسمان اميد -د,252,12241337,145772597413,11903,11915,11908,5,0.04,11908,5,0.04,11908,11915
159,پارس,پتروشيمي پارس,249,161993,23596552380,144910,143310,144010,-900,-0.62,145090,180,0.12,143310,147790
160,كروي,توسعه‌ معادن‌ روي‌ ايران‌,248,2147465,60386715800,28690,28120,28120,-570,-1.99,28120,-570,-1.99,28120,28120
161,خزاميا,زامياد,246,3609837,33499287360,9460,9280,9280,-180,-1.9,9340,-120,-1.27,9280,9280
162,ثباغ,شهر سازي و خانه سازي باغميشه,246,1003510,16065431721,16330,16010,16004,-326,-2,16223,-107,-0.66,16004,16260
163,جم پيلن,پلي پروپيلن جم - جم پيلن,240,215774,17095824680,78920,78000,79890,970,1.23,79000,80,0.1,77800,80000
164,عيار,صندوق س. پشتوانه طلاي مفيد,235,262243,6568929729,25654,25099,25081,-573,-2.23,25049,-605,-2.36,24811,25180
165,وتوسم,سرمايه‌گذاري‌توسعه‌ملي‌,235,1188539,10138237670,8700,8530,8530,-170,-1.95,8660,-40,-0.46,8530,8530
166,كنور,توسعه معدني و صنعتي صبانور,233,183658,8550265640,46250,45500,46700,450,0.97,46300,50,0.11,45500,47200
167,خريخت,صنايع‌ريخته‌گري‌ايران‌,232,3461820,11008935460,3240,3180,3180,-60,-1.85,3230,-10,-0.31,3180,3190
168,شنفت,نفت‌ پارس‌,227,248009,11963766180,49200,48220,48220,-980,-1.99,48960,-240,-0.49,48220,48800
169,بفجر,فجر انرژي خليج فارس,225,624376,14023500730,22660,22210,22210,-450,-1.99,22610,-50,-0.22,22210,23200
170,شخارك,پتروشيمي‌ خارك‌,218,187838,8316128280,44740,45000,43980,-760,-1.7,44700,-40,-0.09,43980,45000
171,آكورد2,صندوق س. آرمان آتي كوثر-د,215,21500000,21500000,31665,1,1,-31664,-100,1,-31664,-100,1,1
172,گكوثر,هتل پارسيان كوثر اصفهان,214,4645624,10954773102,2406,2358,2358,-48,-2,2395,-11,-0.46,2358,2395
173,تنوين,تامين سرمايه نوين,212,1403122,10074072550,7160,7160,7210,50,0.7,7160,0,0,7150,7280
174,تسه9910,امتياز تسهيلات مسكن دي99,211,11737,5760845796,498622,490000,493000,-5622,-1.13,490828,-7794,-1.56,486600,499890
175,مبين,مبين انرژي خليج فارس,210,1827002,29068655760,16230,15910,15910,-320,-1.97,16150,-80,-0.49,15910,16000
176,گوهران,سرمايه گذاري توسعه گوهران اميد,209,1193885,8383726930,7161,7018,7018,-143,-2,7137,-24,-0.34,7018,7100
177,كاما,باما,205,664357,8337680350,12800,12550,12550,-250,-1.95,12760,-40,-0.31,12550,12550
178,بخاور,بيمه زندگي خاورميانه,203,1067303,7340746061,6947,6820,6809,-138,-1.99,6937,-10,-0.14,6809,6971
179,ضپاس2001,اختيارخ وپارس-2500-1400/02/29,202,13026,2810006000,179,180,220,41,22.91,216,37,20.67,170,278
180,تسه9802,امتياز تسهيلات مسكن ارديبهشت98,197,4036,1626003135,419824,398859,400021,-19803,-4.72,402875,-16949,-4.04,398833,410000
181,ثاميد,توسعه و عمران اميد,191,1209102,1874108100,1580,1550,1550,-30,-1.9,1580,0,0,1550,1550
182,وسناح,ح. سرمايه گذاري نيروگاهي ايران,191,17639751,198068809050,10271,10500,11150,879,8.56,11229,958,9.33,10500,11500
183,سكه0112پ03,سكه تمام بهارتحويلي1روزه سامان,191,47000,46342552700,1013428,997980,993690,-19738,-1.95,986012,-27416,-2.71,970000,997980
184,سپاس,صندوق س. پاداش سهامداري توسعه1,187,5756342,58071149215,10084,10088,10089,5,0.05,10088,4,0.04,10088,10090
185,شيراز,پتروشيمي‌شيراز,184,197939,10882789530,55130,54600,54030,-1100,-2,55110,-20,-0.04,54030,55960
186,شصفها,پتروشيمي‌ اصفهان‌,180,254078,30857739651,119254,118470,121639,2385,2,121450,2196,1.84,118470,121639
187,تسه9908,امتياز تسهيلات مسكن آبان99,180,3592,1764689855,499397,481000,524200,24803,4.97,491283,-8114,-1.62,474428,524365
188,سجام,مجتمع سيمان غرب آسيا,176,4076315,18392333280,4700,4512,4512,-188,-4,4520,-180,-3.83,4512,4512
189,دالبرح,ح . البرزدارو,174,193902,1969716600,10010,10500,10050,40,0.4,10160,150,1.5,10050,10500
190,آساس,صندوق س.آسمان آرماني سهام-س,174,45673,7658394141,165502,168605,167700,2198,1.33,167679,2177,1.32,165420,168605
191,گشان,توسعه بين المللي پديده شانديز,168,126269,3357240172,27130,26588,26588,-542,-2,27015,-115,-0.42,26588,26588
192,زر,صندوق س.پشتوانه سكه طلاي زر,168,109370,4560212524,42888,40555,41870,-1018,-2.37,41695,-1193,-2.78,40555,42700
193,گوهر,صندوق سكه طلاي كيان,158,181659,8825565299,49849,49000,48222,-1627,-3.26,48583,-1266,-2.54,48201,49001
194,پلوله,گازلوله‌,155,2563648,67170141248,24954,26201,26201,1247,5,26201,1247,5,26201,26201
195,واعتبار,سرمايه گذاري اعتبار ايران,155,2558869,21319731290,8490,8400,8330,-160,-1.88,8420,-70,-0.82,8330,8560
196,اتكاي,بيمه اتكايي ايرانيان,154,782865,13438335780,17485,17136,17477,-8,-0.05,17395,-90,-0.51,17136,17550
197,شساخت,مهندسي و ساختمان صنايع نفت,153,475982,17330338615,35982,35366,36201,219,0.61,36184,202,0.56,35366,36900
198,لوتوس,تامين سرمايه لوتوس پارسيان,149,382120,3610972590,9530,9370,9370,-160,-1.68,9520,-10,-0.1,9350,9580
199,خصدرا,صنعتي‌ دريايي‌ ايران‌,148,1402307,3882988083,2825,2769,2769,-56,-1.98,2818,-7,-0.25,2769,2769
200,اتكام,شركت بيمه اتكايي امين,148,1246027,5915970298,4842,4760,4746,-96,-1.98,4831,-11,-0.23,4746,4809
201,شكف,كف,147,74807,7657278040,106615,102351,102351,-4264,-4,103432,-3183,-2.99,102351,105000
202,مارون,پتروشيمي مارون,147,49724,7729928403,156333,153250,153251,-3082,-1.97,156265,-68,-0.04,153250,157598
203,امين,تامين سرمايه امين,144,261388,1855854800,7240,7100,7100,-140,-1.93,7230,-10,-0.14,7100,7100
204,سمايه,بانك سرمايه,143,2455204,12224460716,5186,4979,4979,-207,-3.99,5054,-132,-2.55,4979,4979
205,لبوتان,گروه‌صنعتي‌بوتان‌,142,175765,10709116410,62150,60910,60910,-1240,-2,61880,-270,-0.43,60910,62990
206,وبشهر,توسعه‌ صنايع‌ بهشهر(هلدينگ,142,829273,9312799390,11450,11230,11300,-150,-1.31,11410,-40,-0.35,11230,11300
207,تسه9803,امتياز تسهيلات مسكن خرداد98,137,2629,1285006365,488171,471000,498970,10799,2.21,488781,610,0.12,471000,498970
208,خاتم,صندوق س خاتم ايساتيس پويا-ثابت,134,2640263,29024975827,10990,10997,10997,7,0.06,10993,3,0.03,10991,10997
209,خراسان,پتروشيمي خراسان,131,73249,5219965380,72050,70680,70610,-1440,-2,71970,-80,-0.11,70610,72930
210,بترانس,ايران‌ ترانسفو,130,1115880,3191416800,2910,2860,2860,-50,-1.72,2910,0,0,2860,2860
211,وآيند,بانك  آينده,128,359009,5667316074,16443,15786,15786,-657,-4,16404,-39,-0.24,15786,15786
212,وبازار,صندوق س شاخصي بازارآشنا,126,465910,4264903430,9150,9200,9150,0,0,9150,0,0,9100,9370
213,بكهنوج,توليد برق ماهتاب كهنوج,116,1289316,2099006448,1661,1628,1628,-33,-1.99,1660,-1,-0.06,1628,1628
214,ضخود2008,اختيارخ خودرو-3500-1400/02/08,113,5579,5979000,1,2,1,0,0,1,0,0,1,2
215,ثاخت,بين‌المللي‌توسعه‌ساختمان,111,2553786,6256775700,2500,2450,2450,-50,-2,2490,-10,-0.4,2450,2450
216,درازك,دارويي‌ رازك‌,111,588137,19198333150,33290,32630,33000,-290,-0.87,33040,-250,-0.75,32630,33150
217,اخزا902,اسنادخزانه-م2بودجه99-011019,111,216444,153271787583,706752,703111,708000,1248,0.18,708136,1384,0.2,703111,709998
218,صايند,صندوق س. گنجينه آينده روشن-د,111,645300,6368476690,9874,9870,9866,-8,-0.08,9869,-5,-0.05,9844,9890
219,فاراك,ماشين‌ سازي‌ اراك‌,109,1815788,4339733320,2430,2390,2390,-40,-1.65,2430,0,0,2390,2390
220,شپترو,پتروشيمي آبادان,109,3872934,19240736112,5174,4968,4968,-206,-3.98,4968,-206,-3.98,4968,4968
221,وسپهر,سرمايه گذاري مالي سپهرصادرات,103,316320,3241014720,10455,10246,10246,-209,-2,10449,-6,-0.06,10246,10246
222,ارمغان,ص سرمايه گذاري ارمغان ايرانيان,103,1536391,15514489200,10092,10094,10099,7,0.07,10098,6,0.06,10093,10099
223,آرمان,بيمه آرمان,102,1205986,9733513006,8407,8071,8071,-336,-4,8234,-173,-2.06,8071,8071
224,امين يكم2,صندوق درآمد ثابت امين يكم فردا,100,10000000,10000000,10205,1,1,-10204,-99.99,1,-10204,-99.99,1,1
225,كخاك,صنايع‌خاك‌چيني‌ايران‌,100,95524,3854559670,41090,40270,40270,-820,-2,41030,-60,-0.15,40270,41100
226,وپخش,داروپخش‌ (هلدينگ‌,97,88782,8550822270,98270,96310,96390,-1880,-1.91,97930,-340,-0.35,96310,96400
227,تسه9909,امتياز تسهيلات مسكن آذر99,96,1000,493892555,501529,485009,486004,-15525,-3.1,493893,-7636,-1.52,481011,526605
228,فروي,ذوب روي اصفهان,95,72873,4394460519,61533,60303,60303,-1230,-2,61423,-110,-0.18,60303,60303
229,وتوشه,سرمايه‌ گذاري‌ پارس‌ توشه‌,95,180032,3881489920,21990,21560,21560,-430,-1.96,21960,-30,-0.14,21560,21560
230,ماديرا,صنايع ماشين هاي اداري ايران,94,1152152,9363539304,8292,8127,8127,-165,-1.99,8260,-32,-0.39,8127,8127
231,آتيمس,صندوق س.آرمان آتيه درخشان مس-س,92,35276,6265720707,177553,177700,177000,-553,-0.31,177620,67,0.04,176500,179900
232,كارين,صندوق س نگين سامان-ثابت,91,2271027,23158309655,10187,10199,10200,13,0.13,10197,10,0.1,10197,10204
233,اخزا821,اسنادخزانه-م21بودجه98-020906,91,69933,41959800000,599929,600000,600000,71,0.01,600000,71,0.01,600000,600000
234,هجرت,پخش هجرت,90,511213,14287892137,28519,27949,27949,-570,-2,28353,-166,-0.58,27949,27949
235,فيروزا,صندوق بادرآمد ثابت فيروزه آسيا,88,610470,13802816461,22658,22595,22608,-50,-0.22,22610,-48,-0.21,22595,22719
236,تسه9907,امتياز تسهيلات مسكن مهر99,88,1869,924317872,503547,483111,527999,24452,4.86,494552,-8995,-1.79,478380,527999
237,ورازي,بيمه رازي,88,1398031,13576279041,9249,9711,9711,462,5,9549,300,3.24,9711,9711
238,ضجار2003,اختيارخ وتجارت-3000-1400/02/22,87,5701,422446000,23,38,69,46,200,74,51,221.74,38,114
239,پكرمان,گروه‌ صنعتي‌ بارز,85,1402444,36000737480,26190,25670,25670,-520,-1.99,25800,-390,-1.49,25670,25670
240,فسپا,گروه‌صنعتي‌سپاهان‌,84,311396,11540335760,37810,37060,37060,-750,-1.98,37630,-180,-0.48,37060,37060
241,سكه0011پ02,سكه تمام بهارتحويلي 1روزه ملت,84,12100,11952522500,1011173,998887,996600,-14573,-1.44,987812,-23361,-2.31,975000,998887
242,البرز,بيمه البرز,83,1167038,4224677560,3690,3620,3620,-70,-1.9,3680,-10,-0.27,3620,3620
243,تسه9810,امتياز تسهيلات مسكن دي98,82,1567,769507758,494487,470050,519211,24724,5,491071,-3416,-0.69,470050,519211
244,اخزا903,اسنادخزانه-م3بودجه99-011110,81,247979,174612836475,699919,697001,704650,4731,0.68,704144,4225,0.6,697001,707339
245,ضپاس2000,اختيارخ وپارس-2000-1400/02/29,80,4877,2757945000,473,480,599,126,26.64,566,93,19.66,480,635
246,سكه0012پ04,سكه تمام بهارتحويلي1روز صادرات,79,16500,16301950100,1007814,980000,993004,-14810,-1.47,987997,-19817,-1.97,970000,993004
247,اخزا901,اسنادخزانه-م1بودجه99-010621,79,72604,54918869920,752562,750800,752401,-161,-0.02,756417,3855,0.51,750800,759990
248,آسيا,بيمه آسيا,78,780613,1592450520,2080,2040,2040,-40,-1.92,2080,0,0,2040,2040
249,ضخود2009,اختيارخ خودرو-4000-1400/02/08,76,6783,6783000,1,1,1,0,0,1,0,0,1,1
250,ضصاد3002,اختيارخ وبصادر-2500-1400/03/12,75,4095,684618000,183,171,170,-13,-7.1,167,-16,-8.74,155,171
251,زرين,صندوق س. سهام زرين كوروش-س,74,75235,738729138,9861,9800,9721,-140,-1.42,9819,-42,-0.43,9702,9999
252,تسه9902,امتياز تسهيلات مسكن ارديبهشت99,71,1579,804461923,510801,485500,485578,-25223,-4.94,509476,-1325,-0.26,485261,536339
253,دفرا,فرآورده‌هاي‌ تزريقي‌ ايران‌,71,65365,1687948560,26340,25820,25820,-520,-1.97,26320,-20,-0.08,25820,25980
254,وآرين,شركت توسعه اقتصادي آرين,68,485521,1801282910,3864,3710,3710,-154,-3.99,3850,-14,-0.36,3710,3710
255,زعف0008پ16,زعفران0008نگين بيرجند(پ),67,46246,6477779502,140698,141000,140250,-448,-0.32,140072,-626,-0.44,136500,142000
256,زعف0008پ05,زعفران0008نگين زرين(پ),67,40176,5679288030,140467,144900,142200,1733,1.23,141360,893,0.64,139000,144990
257,پتاير,ايران‌ تاير,66,365855,1324395100,3690,3620,3620,-70,-1.9,3690,0,0,3620,3620
258,سپيدار,سپيدار سيستم آسيا,65,47297,2736462529,59037,57857,57857,-1180,-2,58968,-69,-0.12,57857,57857
259,افق ملت,صندوق س در سهام افق ملت,64,20889,2590688490,122980,124000,123020,40,0.03,124020,1040,0.85,123000,125000
260,پيزد,مجتمع صنايع لاستيك يزد,62,15212,976960276,65533,64223,64223,-1310,-2,65507,-26,-0.04,64223,64223
261,ضجار2002,اختيارخ وتجارت-2500-1400/02/22,60,3132,755494000,146,190,225,79,54.11,241,95,65.07,150,301
262,ضپاس2002,اختيارخ وپارس-3000-1400/02/29,59,2773,226059000,62,75,72,10,16.13,82,20,32.26,65,108
263,كرازي,كارخانجات‌توليدي‌شيشه‌رازي‌,58,173166,3977623020,23430,22970,22970,-460,-1.96,23390,-40,-0.17,22970,22970
264,اخزا910,اسنادخزانه-م10بودجه99-020807,58,64959,39154383138,601208,605000,602166,958,0.16,602755,1547,0.26,600001,606368
265,خمحركه,نيرو محركه‌,57,153214,690995140,4600,4510,4510,-90,-1.96,4600,0,0,4510,4510
266,شپلي,پلي اكريل ايران,57,230033,1938028025,8776,8425,8425,-351,-4,8719,-57,-0.65,8425,8425
267,وسديد,گروه ‌صنعتي‌سديد,56,335191,957640687,2915,2857,2857,-58,-1.99,2913,-2,-0.07,2857,2857
268,فباهنر,مس‌ شهيدباهنر,56,55308,1426946400,26320,25800,25800,-520,-1.98,26300,-20,-0.08,25800,25800
269,تسه9804,امتياز تسهيلات مسكن تير98,56,1467,742491120,500287,480199,491000,-9287,-1.86,506129,5842,1.17,480199,514941
270,تسه9904,امتياز تسهيلات مسكن تير99,55,1041,514956916,511705,490000,510000,-1705,-0.33,494675,-17030,-3.33,486120,536999
271,اخزا908,اسنادخزانه-م8بودجه99-020606,54,99118,61701788119,619583,620000,625000,5417,0.87,622508,2925,0.47,620000,625000
272,وبوعلي,سرمايه‌گذاري‌بوعلي‌,53,343071,1952073990,5800,5690,5690,-110,-1.9,5800,0,0,5690,5690
273,قرن,پديده شيمي قرن,51,95082,5796198720,62200,60960,60960,-1240,-1.99,62050,-150,-0.24,60960,60960
274,كوير,توليدي فولاد سپيد فراب كوير,50,811956,16701934920,20980,20570,20570,-410,-1.95,20900,-80,-0.38,20570,20570
275,وهور,مديريت انرژي اميد  تابان هور,50,1130993,2448599845,2209,2165,2165,-44,-1.99,2207,-2,-0.09,2165,2165
276,ثبهساز,بهساز كاشانه تهران,50,299921,677821460,2300,2260,2260,-40,-1.74,2300,0,0,2260,2260
277,تسه9905,امتياز تسهيلات مسكن مرداد99,50,802,395932860,504599,490000,484011,-20588,-4.08,493682,-10917,-2.16,482111,519998
278,ضخود7075,اختيارخ خودرو-2000-1400/07/07,49,1637,809820000,496,537,460,-36,-7.26,495,-1,-0.2,450,537
279,غسالم,سالمين‌,49,432107,1849417960,4360,4280,4280,-80,-1.83,4360,0,0,4280,4280
280,سپر,صندوق س سپر سرمايه بيدار- ثابت,48,637829,7491608746,11742,11747,11745,3,0.03,11745,3,0.03,11745,11747
281,چكاپا,گروه صنايع كاغذ پارس,47,203885,1041852350,5210,5110,5110,-100,-1.92,5210,0,0,5110,5110
282,شسينا,صنايع‌شيميايي‌سينا,47,13522,1725271980,132900,127590,127590,-5310,-4,132710,-190,-0.14,127590,127590
283,فرابورس,فرابورس ايران,46,56480,1740148800,31438,30810,30810,-628,-2,31416,-22,-0.07,30810,30810
284,فراز,صندوق س.سهام فراز داريك-س,45,85723,875100533,10208,10209,10208,0,0,10208,0,0,10208,10211
285,چكارن,كارتن‌ ايران‌,44,704205,2302750350,3330,3270,3270,-60,-1.8,3330,0,0,3270,3270
286,فردا,صندوق س آواي فرداي زاگرس-ثابت,43,104705,1104098776,10538,10545,10544,6,0.06,10545,7,0.07,10544,10546
287,تسه9906,امتياز تسهيلات مسكن شهريور99,43,559,285037358,510237,485000,500000,-10237,-2.01,509906,-331,-0.06,484726,535748
288,وپويا,سرمايه گذاري پويا,42,568182,3700001184,6644,6512,6512,-132,-1.99,6634,-10,-0.15,6512,6512
289,اخابر,مخابرات ايران,42,60797,615265640,10320,10120,10120,-200,-1.94,10320,0,0,10120,10120
290,فاذر,صنايع‌ آذرآب‌,42,55811,1296489530,23700,23230,23230,-470,-1.98,23690,-10,-0.04,23230,23230
291,ختوقا,قطعات‌ اتومبيل‌ ايران‌,41,413258,1037277580,2560,2510,2510,-50,-1.95,2560,0,0,2510,2510
292,ضملت3001,اختيارخ وبملت-3500-1400/03/19,40,1108,897732000,636,700,860,224,35.22,810,174,27.36,650,1098
293,وملي,گروه‌ صنعتي‌ ملي‌ (هلدينگ‌,40,40161,6889619550,175050,171550,171550,-3500,-2,174560,-490,-0.28,171550,171550
294,وسبحان,سرمايه گذاري سبحان,40,2298174,6956572698,3088,3027,3027,-61,-1.98,3079,-9,-0.29,3027,3027
295,كالا,بورس كالاي ايران,40,21624,690021840,32560,31910,31910,-650,-2,32550,-10,-0.03,31910,31910
296,اخزا905,اسنادخزانه-م5بودجه99-020218,40,106884,70502862361,661007,640000,659000,-2007,-0.3,659620,-1387,-0.21,640000,665000
297,تسه9811,امتياز تسهيلات مسكن بهمن98,40,263,137416561,521316,495251,547381,26065,5,522496,1180,0.23,495251,547381
298,ولساپا,ليزينگ رايان‌ سايپا,39,385505,1279876600,3380,3320,3320,-60,-1.78,3380,0,0,3320,3320
299,ضشنا2002,اختيارخ شپنا-12000-1400/02/27,39,652,613320000,944,940,780,-164,-17.37,941,-3,-0.32,780,1030
300,الماس,صندوق س.امين تدبيرگران فردا-س,39,14249,1554153167,110302,111999,109000,-1302,-1.18,109071,-1231,-1.12,108067,111999
301,اخزا814,اسنادخزانه-م14بودجه98-010318,37,41347,33055290399,802142,799500,798660,-3482,-0.43,799460,-2682,-0.33,798610,802142
302,ونيرو,سرمايه‌گذاري‌نيرو,37,275510,730101500,2700,2650,2650,-50,-1.85,2700,0,0,2650,2650
303,ضملت3002,اختيارخ وبملت-4000-1400/03/19,37,1590,835298000,417,437,530,113,27.1,525,108,25.9,400,680
304,زعف0008پ08,زعفران0008نگين روستا(پ),37,27225,3800608416,140378,143000,142200,1822,1.3,139600,-778,-0.55,135000,143000
305,سنوين,سرمايه گذاري اقتصاد نوين,36,156748,1379852644,9169,8803,8803,-366,-3.99,9143,-26,-0.28,8803,8803
306,زعف0008پ11,زعفران0008نگين سحرخيز(پ),36,28650,4102545312,142385,144990,144000,1615,1.13,143195,810,0.57,140000,145000
307,تمحركه,ماشين سازي نيرو محركه,35,135034,3410823806,25774,25259,25259,-515,-2,25691,-83,-0.32,25259,25259
308,ضشنا2001,اختيارخ شپنا-10000-1400/02/27,35,918,1698175000,2162,1850,1600,-562,-25.99,1850,-312,-14.43,1600,1900
309,وصنا,گروه‌صنايع‌بهشهرايران‌,35,209191,1158918140,5650,5540,5540,-110,-1.95,5650,0,0,5540,5540
310,سيستم,همكاران سيستم,35,94338,2392411680,25870,25360,25360,-510,-1.97,25840,-30,-0.12,25360,25360
311,قپيرا,فرآورده‌هاي‌غدايي‌وقندپيرانشهر,35,33876,3487872960,105060,102960,102960,-2100,-2,104910,-150,-0.14,102960,102960
312,ثروتم,صندوق س. ثروت آفرين پارسيان-س,34,78130,5752024090,72358,72707,73700,1342,1.85,73621,1263,1.75,72707,74350
313,وكادو,تكادو,34,281601,4670070984,16922,16584,16584,-338,-2,16839,-83,-0.49,16584,16584
314,اخزا816,اسنادخزانه-م16بودجه98-010503,34,13759,10732851204,782610,782000,780000,-2610,-0.33,780060,-2550,-0.33,780000,785990
315,ورنا,سرمايه‌گذاري‌ رنا(هلدينگ‌,34,692321,3745456610,5520,5410,5410,-110,-1.99,5510,-10,-0.18,5410,5410
316,تسه9812,امتياز تسهيلات مسكن اسفند98,33,241,120120288,503887,478697,482650,-21237,-4.21,498424,-5463,-1.08,478697,529081
317,سخواف,سيمان مجد خواف,33,201450,3281016150,16965,16287,16287,-678,-4,16849,-116,-0.68,16287,16287
318,تكنار,مجتمع معادن مس تكنار,33,144158,16885514856,122012,117132,117132,-4880,-4,117632,-4380,-3.59,117132,117132
319,تسه9901,امتياز تسهيلات مسكن فروردين99,32,235,119263019,508852,520000,483410,-25442,-5,507502,-1350,-0.27,483410,534000
320,ثشاهد,سرمايه‌ گذاري‌ شاهد,32,77683,1345469560,17670,17320,17320,-350,-1.98,17660,-10,-0.06,17320,17320
321,زعف0008پ10,زعفران0008نگين طلاي سرخ(پ),32,18074,2615584800,143817,148605,145000,1183,0.82,144715,898,0.62,143090,148605
322,چخزر,صنايع چوب خزر كاسپين,31,141774,7518984090,54117,53035,53035,-1082,-2,53949,-168,-0.31,53035,53035
323,فولاژ,فولاد آلياژي ايران,31,127018,2415882360,19400,19020,19020,-380,-1.96,19390,-10,-0.05,19020,19020
324,تسه9809,امتياز تسهيلات مسكن آذر98,31,466,227630968,489736,476020,482500,-7236,-1.48,488478,-1258,-0.26,476020,510000
325,شسم,توليد سموم‌ علف‌ كش,30,5623,524614654,89710,93298,93298,3588,4,89891,181,0.2,93298,93298
326,بورس,بورس اوراق بهادار تهران,30,26210,906603900,35290,34590,34590,-700,-1.98,35280,-10,-0.03,34590,34590
327,هاي وب,داده گسترعصرنوين-هاي وب,30,37485,386095500,10510,10300,10300,-210,-2,10510,0,0,10300,10300
328,ساوه,سيمان ساوه,30,16669,959867696,58759,57584,57584,-1175,-2,58736,-23,-0.04,57584,57584
329,تسه9808,امتياز تسهيلات مسكن آبان98,30,325,157608529,494446,470000,485001,-9445,-1.91,484949,-9497,-1.92,470000,497990
330,غزر,صنعتي زر ماكارون,29,43919,1139698050,26470,25950,25950,-520,-1.96,26460,-10,-0.04,25950,25950
331,زپارس,ملي كشت و صنعت و دامپروري پارس,29,62150,10239856140,164530,164790,164530,0,0,164580,50,0.03,164530,164790
332,قشرين,قند شيرين خراسان,29,755572,10973172156,14819,14523,14523,-296,-2,14651,-168,-1.13,14523,14523
333,دمعيار,صندوق س. توازن معيار-د,29,481469,4883929408,10143,10145,10143,0,0,10144,1,0.01,10142,10147
334,اخزا817,اسنادخزانه-م17بودجه98-010512,29,66755,51912744251,778019,770668,776600,-1419,-0.18,777661,-358,-0.05,770668,778900
335,شپارس,بين‌ المللي‌ محصولات‌  پارس‌,29,177376,3914688320,22520,22070,22070,-450,-2,22480,-40,-0.18,22070,22070
336,كماسه,تامين‌ ماسه‌ ريخته‌گري‌,28,67273,2900139030,43980,43110,43110,-870,-1.98,43930,-50,-0.11,43110,43110
337,اخزا811,اسنادخزانه-م11بودجه98-001013,28,15351,13328596831,870115,871000,869900,-215,-0.02,868256,-1859,-0.21,866700,879899
338,بساما,بيمه سامان,28,462310,10492587760,23159,22696,22696,-463,-2,23060,-99,-0.43,22696,22696
339,كزغال,زغال سنگ پروده طبس,28,108658,3646127848,34240,33556,33556,-684,-2,34189,-51,-0.15,33556,33556
340,قچار,فراوردههاي غذايي وقند چهارمحال,28,18618,1634939670,89607,87815,87815,-1792,-2,89547,-60,-0.07,87815,87815
341,وپست,پست بانك ايران,28,93624,2052238080,22360,21920,21920,-440,-1.97,22340,-20,-0.09,21920,21920
342,بكام,كارخانجات توليدي شهيد قندي,28,144237,559639560,3950,3880,3880,-70,-1.77,3950,0,0,3880,3880
343,غپينو,پارس‌ مينو,28,96071,599483040,6360,6240,6240,-120,-1.89,6360,0,0,6240,6240
344,اخزا909,اسنادخزانه-م9بودجه99-020316,28,57570,37593504337,651153,650200,654999,3846,0.59,653005,1852,0.28,650200,655000
345,برن0003پ01,برنج طارم0003تجارت مازندران(پ),27,1669,459155000,275002,274500,277000,1998,0.73,275108,106,0.04,274000,280000
346,اخزا906,اسنادخزانه-م6بودجه99-020321,27,52082,38780714906,744529,707402,749000,4471,0.6,744609,80,0.01,707402,749000
347,جوين,كشت و صنعت جوين,27,329044,1633045372,5064,4963,4963,-101,-1.99,5056,-8,-0.16,4963,4963
348,چدن,توليدي چدن سازان,27,15635,377272550,24620,24130,24130,-490,-1.99,24620,0,0,24130,24130
349,نوين,بيمه نوين,27,132401,775207855,5974,5855,5855,-119,-1.99,5972,-2,-0.03,5855,5855
350,پكوير,كوير تاير,26,80345,1016364250,12900,12650,12650,-250,-1.94,12890,-10,-0.08,12650,12650
351,تليسه,دامداري تليسه نمونه,26,141755,605860870,4361,4274,4274,-87,-1.99,4360,-1,-0.02,4274,4274
352,تسه9903,امتياز تسهيلات مسكن خرداد99,25,235,116066161,512256,486900,488001,-24255,-4.73,493899,-18357,-3.58,486900,499900
353,ضملي3002,اختيارخ فملي-10000-1400/03/02,25,856,1463440000,1719,1720,1560,-159,-9.25,1710,-9,-0.52,1560,1800
354,اخزا815,اسنادخزانه-م15بودجه98-010406,24,9236,7322445780,798622,785565,793310,-5312,-0.67,792816,-5806,-0.73,785565,796000
355,تسه9805,امتياز تسهيلات مسكن مرداد98,24,410,211365569,498169,501000,508088,9919,1.99,515526,17357,3.48,490230,521000
356,تسه9806,امتياز تسهيلات مسكن شهريور98,23,302,148579560,496970,472699,499000,2030,0.41,491985,-4985,-1,472612,499000
357,ملت,بيمه ملت,23,29717,454670100,15610,15300,15300,-310,-1.99,15610,0,0,15300,15300
358,تسه9807,امتياز تسهيلات مسكن مهر98,23,160,78875555,488930,490000,490000,1070,0.22,492972,4042,0.83,490000,513376
359,اخزا808,اسنادخزانه-م8بودجه98-000817,22,8243,7377374467,894304,894000,895002,698,0.08,894987,683,0.08,893001,896000
360,اخزا809,اسنادخزانه-م9بودجه98-000923,22,31493,27606296146,875855,875201,879989,4134,0.47,876585,730,0.08,875201,879989
361,شوينده,مديريت صنعت شوينده ت.ص.بهشهر,22,14122,379175700,27390,26850,26850,-540,-1.97,27390,0,0,26850,26850
362,قيستو,شركت قند بيستون,22,982580,16624271020,16588,16919,16919,331,2,16919,331,2,16919,16919
363,كلر,كلر پارس,22,86671,11513288969,135550,132839,132839,-2711,-2,134913,-637,-0.47,132839,132839
364,صنوين,صندوق سرمايه‌گذاري صنوين-مختلط,22,3874,404162210,103990,104500,104980,990,0.95,104330,340,0.33,104210,105000
365,مفاخر,توسعه فناوري اطلاعات خوارزمي,21,260699,17057535570,66765,65430,65430,-1335,-2,66300,-465,-0.7,65430,65430
366,ثمسكن,سرمايه‌گذاري‌ مسكن‌,21,170599,873466880,5220,5120,5120,-100,-1.92,5220,0,0,5120,5120
367,وبيمه,سرمايه‌ گذاري‌ صنعت‌ بيمه‌,21,172109,473299750,2800,2750,2750,-50,-1.79,2800,0,0,2750,2750
368,كفپارس,فرآورده‌هاي‌ نسوز پارس‌,21,532590,2412632700,4620,4530,4530,-90,-1.95,4620,0,0,4530,4530
369,خبازرس,بازرسي مهندسي و صنعتي ايران,21,136710,4345464060,32434,31786,31786,-648,-2,32289,-145,-0.45,31786,31786
370,غشهداب,كشت و صنعت شهداب ناب خراسان,21,53032,206771768,3978,3899,3899,-79,-1.99,3978,0,0,3899,3899
371,غاذر,كشت‌وصنعت‌پياذر,21,4636,249045920,55950,53720,53720,-2230,-3.99,55940,-10,-0.02,53720,53720
372,واتي,سرمايه‌ گذاري‌ آتيه‌ دماوند,20,51492,525218400,10400,10200,10200,-200,-1.92,10400,0,0,10200,10200
373,كبافق,معادن‌ بافق‌,20,4230,207439200,50040,49040,49040,-1000,-2,50040,0,0,49040,49040
374,بذر,صندوق س بذر اميد آفرين-سهام,20,5739,546511420,94770,95360,95360,590,0.62,95230,460,0.49,94530,95360
375,دتوليد,داروسازي توليد دارو,20,20788,545560272,26779,26244,26244,-535,-2,26773,-6,-0.02,26244,26244
376,كدما,معدني‌ دماوند,20,1154,171553640,151690,148660,148660,-3030,-2,151680,-10,-0.01,148660,148660
377,وتوصا,گروه س توسعه صنعتي ايران,20,220359,2675158260,12380,12140,12140,-240,-1.94,12370,-10,-0.08,12140,12140
378,فخاس,فولاد خراسان,20,392984,10748112400,27900,27350,27350,-550,-1.97,27840,-60,-0.22,27350,27350
379,رتاپح,ح.تجارت الكترونيك پارسيان,20,225610,1142771000,5270,5270,5060,-210,-3.98,5070,-200,-3.8,5060,5270
380,پست0008پ08,پسته فندقي32-30مه ولات0008(پ),19,282,461839530,1611231,1691880,1621001,9770,0.61,1637729,26498,1.64,1600000,1691889
381,زعف0008پ09,زعفران0008نگين نوين(پ),19,11793,1657129450,141839,140051,141000,-839,-0.59,140518,-1321,-0.93,139300,142000
382,كپرور,فرآوري زغال سنگ پروده طبس,19,152147,5522175365,37035,36295,36295,-740,-2,36951,-84,-0.23,36295,36295
383,خرينگ,رينگ‌سازي‌مشهد,19,6945,358084200,52610,51560,51560,-1050,-2,52600,-10,-0.02,51560,51560
384,ودي,بيمه  دي,18,33715,709667035,21478,21049,21049,-429,-2,21472,-6,-0.03,21049,21049
385,شكربن,كربن‌ ايران‌,18,180964,15944738040,89900,88110,88110,-1790,-1.99,89310,-590,-0.66,88110,88110
386,پست0008پ04,پسته فندقي32-30سبزدانه0008(پ),18,1830,3014193700,1611420,1691890,1670000,58580,3.64,1647100,35680,2.21,1545003,1691890
387,تايرا,تراكتورسازي‌ايران‌,18,53784,1509179040,28630,28060,28060,-570,-1.99,28610,-20,-0.07,28060,28060
388,اميد,تامين سرمايه اميد,18,122192,929881120,7760,7610,7610,-150,-1.93,7760,0,0,7610,7610
389,شاروم,پتروشيمي اروميه,18,11545,222518330,19667,19274,19274,-393,-2,19665,-2,-0.01,19274,19274
390,فسرب,ملي‌ سرب‌وروي‌ ايران‌,18,4049,314283380,79200,77620,77620,-1580,-1.99,79190,-10,-0.01,77620,77620
391,وثوق,سرمايه گذاري وثوق امين,18,40523,733709438,18475,18106,18106,-369,-2,18461,-14,-0.08,18106,18106
392,فوكا,فولاد كاويان,18,107093,1260377517,12009,11769,11769,-240,-2,11998,-11,-0.09,11769,11769
393,لابسا,آبسال‌,18,120815,6316208200,53340,52280,52280,-1060,-1.99,53200,-140,-0.26,52280,52280
394,شلعابح,ح . لعابيران‌,18,58034,1018551600,4010,17600,17200,13190,328.93,17550,13540,337.66,17200,17600
395,خكاوه,سايپا ديزل,17,127198,452316088,3628,3556,3556,-72,-1.98,3626,-2,-0.06,3556,3556
396,وتوس,توسعه‌شهري‌توس‌گستر,17,78630,1064650200,13810,13540,13540,-270,-1.96,13800,-10,-0.07,13540,13540
397,رافزا,رايان هم افزا,17,15032,1668266392,113245,110981,110981,-2264,-2,113168,-77,-0.07,110981,110981
398,دپارس,پارس‌ دارو,17,6629,555377620,85480,83780,83780,-1700,-1.99,85460,-20,-0.02,83780,83780
399,وسگيلا,شركت س استان گيلان,17,388361,295154360,770,760,760,-10,-1.3,770,0,0,760,760
400,آپ,آسان پرداخت پرشين,17,23795,407132450,17450,17110,17110,-340,-1.95,17450,0,0,17110,17110
401,گنجين,صندوق س. گنجينه يكم آويد-د,17,22170,280501575,12650,12650,12650,0,0,12652,2,0.02,12650,12661
402,وايرا,سرمايه گذاري صنايع ايران,17,503008,6671898112,13534,13264,13264,-270,-1.99,13440,-94,-0.69,13264,13264
403,زملارد,كشاورزي و دامپروري ملارد شير,17,8142,305390136,38273,37508,37508,-765,-2,38268,-5,-0.01,37508,37508
404,اخزا904,اسنادخزانه-م4بودجه99-011215,17,5855,4095484638,693342,696000,693334,-8,0,699485,6143,0.89,693334,700000
405,شراز,پالايش نفت شيراز,17,2836,314308208,113089,110828,110828,-2261,-2,113074,-15,-0.01,110828,110828
406,اخزا907,اسنادخزانه-م7بودجه99-020704,17,68668,42373608333,612262,615011,619990,7728,1.26,617079,4817,0.79,614999,619990
407,فلوله,لوله‌وماشين‌سازي‌ايران‌,17,25572,556702440,22210,21770,21770,-440,-1.98,22200,-10,-0.05,21770,21770
408,خديزل,بهمن  ديزل,16,12163,470099950,39438,38650,38650,-788,-2,39430,-8,-0.02,38650,38650
409,ضصاد3001,اختيارخ وبصادر-2000-1400/03/12,16,1020,498000000,400,420,450,50,12.5,488,88,22,420,550
410,قاسم,قاسم ايران,16,81438,1043139342,13070,12809,12809,-261,-2,13064,-6,-0.05,12809,12809
411,خلنت,لنت‌ ترمزايران‌,16,7400,455026000,62740,61490,61490,-1250,-1.99,62720,-20,-0.03,61490,61490
412,شكبير,پتروشيمي اميركبير,16,36955,3218115310,88859,87082,87082,-1777,-2,88801,-58,-0.07,87082,87082
413,شاوان,پالايش نفت لاوان,16,12798,1096059114,87390,85643,85643,-1747,-2,87351,-39,-0.04,85643,85643
414,وپترو,سرمايه‌گذاري صنايع پتروشيمي‌,16,42998,586492720,13910,13640,13640,-270,-1.94,13910,0,0,13640,13640
415,كهمدا,شيشه‌ همدان‌,16,33973,338710810,10170,9970,9970,-200,-1.97,10170,0,0,9970,9970
416,اوصتا,صندوق انديشه ورزان صباتامين -د,15,176672,3252572622,18409,18411,18410,1,0.01,18410,1,0.01,18410,18417
417,كابگن,توليدي و صنعتي آبگينه‌,15,103067,534299328,5133,5184,5184,51,0.99,5138,5,0.1,5184,5184
418,داسوه,داروسازي‌ اسوه‌,15,11214,410544540,37350,36610,36610,-740,-1.98,37340,-10,-0.03,36610,36610
419,غويتا,ويتانا,15,7133,125633529,17972,17613,17613,-359,-2,17971,-1,-0.01,17613,17613
420,شدوص,دوده‌ صنعتي‌ پارس‌,15,203409,5536792980,27770,27220,27220,-550,-1.98,27710,-60,-0.22,27220,27220
421,عيار2,صندوق س. پشتوانه طلاي مفيد,15,150000,150000,25654,1,1,-25653,-100,1,-25653,-100,1,1
422,قثابت,قند ثابت‌ خراسان‌,14,104661,6967282770,67920,66570,66570,-1350,-1.99,67730,-190,-0.28,66570,66570
423,غپاك,لبنيات‌ پاك‌,14,6968,211757520,31010,30390,30390,-620,-2,31010,0,0,30390,30390
424,حريل,ريل پردازسير,14,173510,956907650,5627,5515,5515,-112,-1.99,5625,-2,-0.04,5515,5515
425,خفولا,خدمات فني فولاد يزد,14,3400,146057200,43834,42958,42958,-876,-2,43827,-7,-0.02,42958,42958
426,سخند,صندوق س.سپهرخبرگان نفت-د,14,79420,800653420,10076,10085,10084,8,0.08,10081,5,0.05,10079,10085
427,كگاز,شيشه‌ و گاز,14,6927,127526070,18780,18410,18410,-370,-1.97,18780,0,0,18410,18410
428,شجم,صنايع پتروشيمي تخت جمشيد,13,137822,1402476672,10383,10176,10176,-207,-1.99,10372,-11,-0.11,10176,10176
429,دامين,داروسازي‌ امين‌,13,38404,197012520,5230,5130,5130,-100,-1.91,5230,0,0,5130,5130
430,پرديس,سرمايه گذاري پرديس,13,42449,226253170,5430,5330,5330,-100,-1.84,5430,0,0,5330,5330
431,ضفلا3004,اختيارخ فولاد-8560-1400/03/19,13,294,399810000,1360,1480,1190,-170,-12.5,1360,0,0,1190,1480
432,دزهراوي,داروسازي‌زهراوي‌,13,34168,292478080,8730,8560,8560,-170,-1.95,8730,0,0,8560,8560
433,رتكو,كنترل‌خوردگي‌تكين‌كو,13,203142,3617959020,18170,17810,17810,-360,-1.98,18140,-30,-0.17,17810,17810
434,دلر,داروسازي‌ اكسير,13,6010,212754000,36120,35400,35400,-720,-1.99,36120,0,0,35400,35400
435,اخزا722,اسنادخزانه-م22بودجه97-000428,13,39377,37469081118,949170,951215,952387,3217,0.34,951547,2377,0.25,951215,952387
436,لپارس,پارس‌ الكتريك‌,13,43266,3951916440,93200,91340,91340,-1860,-2,93050,-150,-0.16,91340,91340
437,سيمرغ,سيمرغ,13,14762,264387420,18270,17910,17910,-360,-1.97,18270,0,0,17910,17910
438,تكمبا,كمباين‌ سازي‌ ايران‌,13,240443,1885073120,7990,7840,7840,-150,-1.88,7980,-10,-0.13,7840,7840
439,شگل,گلتاش‌,13,31138,314493800,10300,10100,10100,-200,-1.94,10300,0,0,10100,10100
440,غنوش,نوش‌ مازندران‌,13,8622,482745780,57130,55990,55990,-1140,-2,57120,-10,-0.02,55990,55990
441,ضخود7073,اختيارخ خودرو-1600-1400/07/07,13,234,194622000,1,850,880,879,87900,832,831,83100,610,950
442,دانا,بيمه دانا,12,163485,1062652500,6630,6500,6500,-130,-1.96,6630,0,0,6500,6500
443,وتوكا,سرمايه‌گذاري‌توكافولاد(هلدينگ,12,42254,495216880,11950,11720,11720,-230,-1.92,11950,0,0,11720,11720
444,زشگزا,شير و گوشت زاگرس شهركرد,12,17235,139172625,8239,8075,8075,-164,-1.99,8239,0,0,8075,8075
445,زعف0008پ19,زعفران0008نگين تروند قاينات(پ),12,9871,1352430160,140401,145000,136500,-3901,-2.78,137010,-3391,-2.42,136070,145000
446,اراد33,مرابحه عام دولت3-ش.خ 0303,12,61100,53172716700,870588,914117,871000,412,0.05,870257,-331,-0.04,870000,914117
447,كحافظ,كاشي‌ وسراميك‌ حافظ‌,12,33262,391161120,11990,11760,11760,-230,-1.92,11990,0,0,11760,11760
448,غشان,شيرپاستوريزه‌پگاه‌خراسان‌,12,16411,123738940,7690,7540,7540,-150,-1.95,7690,0,0,7540,7540
449,ولتجار,واسپاري تجارت وسرمايه ايرانيان,12,100000,812200000,8287,8122,8122,-165,-1.99,8280,-7,-0.08,8122,8122
450,كسرا,سراميك‌هاي‌صنعتي‌اردكان‌,12,8057,164523940,20830,20420,20420,-410,-1.97,20830,0,0,20420,20420
451,شپاكسا,پاكسان‌,12,43286,1184737820,27920,27370,27370,-550,-1.97,27910,-10,-0.04,27370,27370
452,ختور,رادياتور ايران‌,12,10345,199348150,19660,19270,19270,-390,-1.98,19660,0,0,19270,19270
453,فنرژي,گسترش صنايع انرژي آذرآب,12,11724,218664324,19031,18651,18651,-380,-2,19023,-8,-0.04,18651,18651
454,نطرين,عطرين نخ قم,12,75453,897815247,12141,11899,11899,-242,-1.99,12137,-4,-0.03,11899,11899
455,اخزا911,اسنادخزانه-م11بودجه99-020906,12,8615,5072071861,588182,588004,592000,3818,0.65,588749,567,0.1,588002,592000
456,دقاضي,داروسازي شهيد قاضي,11,60484,2546073980,43848,42095,42095,-1753,-4,43616,-232,-0.53,42095,42095
457,بالبر,كابل‌ البرز,11,4211,243816900,59080,57900,57900,-1180,-2,59070,-10,-0.02,57900,57900
458,دارو,كارخانجات‌داروپخش‌,11,3839,128030650,34030,33350,33350,-680,-2,34030,0,0,33350,33350
459,دفارا,داروسازي‌ فارابي‌,11,121708,7856251400,65860,64550,64550,-1310,-1.99,65650,-210,-0.32,64550,64550
460,كوثر,بيمه كوثر,11,192055,2766168165,14696,14403,14403,-293,-1.99,14679,-17,-0.12,14403,14403
461,حفارس,حمل و نقل بين المللي خليج فارس,11,79599,378891240,4850,4760,4760,-90,-1.86,4850,0,0,4760,4760
462,ضسپا3000,اختيارخ خساپا-1400-1400/03/26,11,460,354650000,748,750,775,27,3.61,771,23,3.07,750,780
463,اخزا914,اسنادخزانه-م14بودجه99-021025,11,1372,790943628,572884,576999,576999,4115,0.72,576489,3605,0.63,575999,576999
464,ثنوسا,نوسازي‌وساختمان‌تهران‌,11,179797,2292411750,13010,12750,12750,-260,-2,13000,-10,-0.08,12750,12750
465,ولپارس,ليزينگ پارسيان,11,66836,328164760,5010,4910,4910,-100,-2,5010,0,0,4910,4910
466,وسكرد,شركت س استان كردستان,11,206358,148577760,730,720,720,-10,-1.37,730,0,0,720,720
467,اراد50,مرابحه عام دولت5-ش.خ0302,11,123800,123800050000,1000000,1000000,1000001,1,0,1000000,0,0,1000000,1000001
468,زدشت,كشت و صنعت دشت خرم دره,10,18359,530391510,29479,28890,28890,-589,-2,29473,-6,-0.02,28890,28890
469,كاردان2,صندوق س تجارت شاخصي كاردان,10,1000000,1000000,148900,1,1,-148899,-100,1,-148899,-100,1,1
470,ضملي3003,اختيارخ فملي-12000-1400/03/02,10,29,23280000,772,890,760,-12,-1.55,803,31,4.02,700,899
471,اخزا812,اسنادخزانه-م12بودجه98-001111,10,7855,6711299000,856222,854001,855490,-732,-0.09,854398,-1824,-0.21,854000,855490
472,زفكا,كشت و دامداري فكا,10,229001,2944036856,13118,12856,12856,-262,-2,13102,-16,-0.12,12856,12856
473,وآذر,سرمايه‌گذاري‌توسعه‌آذربايجان‌,10,3178,264695620,84980,83290,83290,-1690,-1.99,84970,-10,-0.01,83290,83290
474,فسا,پتروشيمي فسا,10,61400,104441400,1771,1701,1701,-70,-3.95,1771,0,0,1701,1701
475,لازما,كارخانه هاي صنعتي آزمايش,10,9096,299949696,34350,32976,32976,-1374,-4,34329,-21,-0.06,32976,32976
476,كمنگنز,معادن‌منگنزايران‌,9,1330,115417400,88550,86780,86780,-1770,-2,88550,0,0,86780,86780
477,كمينا,شيشه سازي مينا,9,6408,158155848,25184,24681,24681,-503,-2,25180,-4,-0.02,24681,24681
478,اخزا806,اسنادخزانه-م6بودجه98-000519,9,1317,1237587010,939262,940000,940500,1238,0.13,939702,440,0.05,938951,940500
479,دالبر,البرزدارو,9,10991,163436170,15170,14870,14870,-300,-1.98,15170,0,0,14870,14870
480,اخزا818,اسنادخزانه-م18بودجه98-010614,9,20327,15835559680,763313,770000,767000,3687,0.48,779041,15728,2.06,766011,780000
481,ضترا3003,اختيارخ شتران-9000-1400/03/09,9,380,342030000,1450,900,900,-550,-37.93,900,-550,-37.93,900,901
482,شتولي,تولي‌پرس‌,9,6930,220852170,33196,31869,31869,-1327,-4,33165,-31,-0.09,31869,31869
483,ثعتما,س. ساختماني اعتماد گستر,9,6325,408209175,67228,64539,64539,-2689,-4,67171,-57,-0.08,64539,64539
484,تملي710,تسهيلات مسكن ب. ملي-دي97,9,54,40041540,706200,741510,741510,35310,5,741510,35310,5,741510,741510
485,دسينا,داروسازي‌ سينا,9,3543,82906200,23870,23400,23400,-470,-1.97,23870,0,0,23400,23400
486,پسهند,صنايع‌ لاستيكي‌  سهند,9,3771,153140310,41430,40610,40610,-820,-1.98,41430,0,0,40610,40610
487,ثفارس,عمران‌وتوسعه‌فارس‌,9,89924,885751400,10050,9850,9850,-200,-1.99,10050,0,0,9850,9850
488,خزر,فنرسازي‌زر,9,3838,178965940,47580,46630,46630,-950,-2,47580,0,0,46630,46630
489,ومشان,س. فني و مهندسي مشانير,9,2266,160111028,72100,70658,70658,-1442,-2,72088,-12,-0.02,70658,70658
490,اخزا720,اسنادخزانه-م20بودجه97-000324,9,1377,1336121996,967229,970050,971000,3771,0.39,970314,3085,0.32,970050,971000
491,سمگا,گروه سرمايه گذاري ميراث فرهنگي,9,103026,3099434184,30697,30084,30084,-613,-2,30662,-35,-0.11,30084,30084
492,وگستر,گسترش سرمايه گذاري ايرانيان,9,6955,131484275,19290,18905,18905,-385,-2,19289,-1,-0.01,18905,18905
493,فاما,صنعتي‌ آما,8,6948,126731520,18610,18240,18240,-370,-1.99,18610,0,0,18240,18240
494,آسام,صندوق س.آرمان سپهر آشنا-م,8,1340,138362650,103843,104000,103005,-838,-0.81,103256,-587,-0.57,102222,104500
495,بزاگرس,نيروگاه زاگرس كوثر,8,9507,66748647,7164,7021,7021,-143,-2,7164,0,0,7021,7021
496,اخزا804,اسنادخزانه-م4بودجه98-000421,8,2480,2364095123,953413,953000,954899,1486,0.16,953264,-149,-0.02,953000,955000
497,فرآور,فرآوري‌موادمعدني‌ايران‌,8,3242,112043520,35260,34560,34560,-700,-1.99,35260,0,0,34560,34560
498,ضسپا3002,اختيارخ خساپا-1800-1400/03/26,8,138,57045000,226,350,400,174,76.99,413,187,82.74,350,420
499,سنير,سيمان‌ سفيد ني‌ريز,8,977,238886270,249500,244510,244510,-4990,-2,249480,-20,-0.01,244510,244510
500,ثرود,سرمايه‌گذاري مسكن زاينده رود,8,11604,241038288,21195,20772,20772,-423,-2,21193,-2,-0.01,20772,20772
501,ضملت3004,اختيارخ وبملت-5000-1400/03/19,8,133,21004000,62,199,196,134,216.13,158,96,154.84,101,199
502,ساينا,صنايع بهداشتي ساينا,8,18268,2756294108,153960,150881,150881,-3079,-2,153786,-174,-0.11,150881,150881
503,فروس,فروسيليس‌ ايران‌,8,33323,172279910,5270,5170,5170,-100,-1.9,5270,0,0,5170,5170
504,تبرك,گروه كارخانجات صنعتي تبرك,8,220943,4317668106,19940,19542,19542,-398,-2,19905,-35,-0.18,19542,19542
505,دكپسول,توليد ژلاتين كپسول ايران,8,11285,368884080,33355,32688,32688,-667,-2,33350,-5,-0.01,32688,32688
506,غمارگ,مارگارين‌,7,2409,74269470,31450,30830,30830,-620,-1.97,31450,0,0,30830,30830
507,ضجار2000,اختيارخ وتجارت-1800-1400/02/22,7,156,138896000,600,700,900,300,50,890,290,48.33,700,900
508,كفرآور,فرآورده هاي سيمان شرق,7,2220,50371800,23635,22690,22690,-945,-4,23633,-2,-0.01,22690,22690
509,شكلر,نيروكلر,7,2094,99004320,48240,47280,47280,-960,-1.99,48240,0,0,47280,47280
510,دتوزيع,توزيع دارو پخش,7,1521,77619672,52073,51032,51032,-1041,-2,52071,-2,0,51032,51032
511,خمهر,مهركام‌پارس‌,7,32772,78652800,2440,2400,2400,-40,-1.64,2440,0,0,2400,2400
512,خنصير,مهندسي‌نصيرماشين‌,7,3032,322483520,108530,106360,106360,-2170,-2,108520,-10,-0.01,106360,106360
513,غگلپا,شير پاستوريزه پگاه گلپايگان,7,3648,251088192,70233,68829,68829,-1404,-2,70226,-7,-0.01,68829,68829
514,ضسپا3001,اختيارخ خساپا-1600-1400/03/26,7,460,275400000,610,600,599,-11,-1.8,599,-11,-1.8,598,600
515,غالبر,لبنيات‌ كالبر,7,8745,173413350,20230,19830,19830,-400,-1.98,20230,0,0,19830,19830
516,حتوكا,حمل‌ونقل‌توكا,7,7299,219334950,30660,30050,30050,-610,-1.99,30660,0,0,30050,30050
517,ضمخا2001,اختيارخ اخابر-10000-1400/02/29,7,500,119022000,290,250,200,-90,-31.03,238,-52,-17.93,200,250
518,ضجار2001,اختيارخ وتجارت-2000-1400/02/22,7,421,293630000,513,650,630,117,22.81,697,184,35.87,630,772
519,تكنو,تكنوتار,7,61339,1328602740,22100,21660,21660,-440,-1.99,22090,-10,-0.05,21660,21660
520,گدنا,تهيه توزيع غذاي دنا آفرين فدك,7,2517,83765760,33959,33280,33280,-679,-2,33958,-1,0,33280,33280
521,كپارس,كاشي‌ پارس‌,7,436,66245840,155040,151940,151940,-3100,-2,155040,0,0,151940,151940
522,زير0003پ01,زيره سبز0003كيميابذر(پ),7,213,118601027,566370,535001,565000,-1370,-0.24,556812,-9558,-1.69,535001,581714
523,ضسپا3005,اختيارخ خساپا-3000-1400/03/26,7,351,14204000,49,26,40,-9,-18.37,40,-9,-18.37,25,50
524,نمرينو,ايران‌ مرينوس‌,7,2506,278391540,113350,111090,111090,-2260,-1.99,113340,-10,-0.01,111090,111090
525,قشكر,شكرشاهرود,7,18126,68335020,3840,3770,3770,-70,-1.82,3840,0,0,3770,3770
526,ضملت3003,اختيارخ وبملت-4500-1400/03/19,7,190,47510000,153,300,220,67,43.79,250,97,63.4,220,300
527,دجابر,داروسازي‌ جابرابن‌حيان‌,7,8505,168739200,20240,19840,19840,-400,-1.98,20240,0,0,19840,19840
528,بسويچ,پارس‌سويچ‌,7,2887,155926870,55110,54010,54010,-1100,-2,55110,0,0,54010,54010
529,لكما,كارخانجات‌مخابراتي‌ايران‌,7,6584,39556672,6130,6008,6008,-122,-1.99,6130,0,0,6008,6008
530,تپمپي,پمپ‌ سازي‌ ايران‌,7,5092,96951680,19420,19040,19040,-380,-1.96,19420,0,0,19040,19040
531,قصفها,قنداصفهان‌,7,687,106024710,157470,154330,154330,-3140,-1.99,157460,-10,-0.01,154330,154330
532,دشيمي,شيمي‌ داروئي‌ داروپخش‌,6,1961,59261420,30830,30220,30220,-610,-1.98,30830,0,0,30220,30220
533,دتماد,توليدمواداوليه‌داروپخش‌,6,1749,78512610,45800,44890,44890,-910,-1.99,45800,0,0,44890,44890
534,وگردش,بانك گردشگري,6,3406,57976932,17369,17022,17022,-347,-2,17369,0,0,17022,17022
535,ضپاس2003,اختيارخ وپارس-3500-1400/02/29,6,94,1255000,52,20,11,-41,-78.85,13,-39,-75,11,20
536,وآفري,بيمه كارآفرين,6,12234,40335498,3364,3297,3297,-67,-1.99,3364,0,0,3297,3297
537,ضصاد3000,اختيارخ وبصادر-1800-1400/03/12,6,127,85080000,397,650,670,273,68.77,670,273,68.77,590,700
538,غشهد,شهد ايران ‌,6,7596,54159480,7270,7130,7130,-140,-1.93,7270,0,0,7130,7130
539,درهآور,دارويي ره آورد تامين,6,1188,61980336,53236,52172,52172,-1064,-2,53235,-1,0,52172,52172
540,وسيستا,شركت س استان سيستان وبلوچستان,6,32045,24033750,760,750,750,-10,-1.32,760,0,0,750,750
541,شفارا,پتروشيمي فارابي,6,19977,75752784,3869,3792,3792,-77,-1.99,3869,0,0,3792,3792
542,فمراد,آلومراد,6,277,39068080,143910,141040,141040,-2870,-1.99,143910,0,0,141040,141040
543,سايرا,ايرانيت‌,6,201000,8693853000,44135,43253,43253,-882,-2,43320,-815,-1.85,43253,43253
544,وسكرمان,س.سهام عدالت استان كرمان,6,42141,42562410,1030,1010,1010,-20,-1.94,1030,0,0,1010,1010
545,پارتا,مجتمع‌صنعتي‌آرتاويل‌تاير,6,21323,1115320838,53373,52306,52306,-1067,-2,53326,-47,-0.09,52306,52306
546,اوان,مبين وان كيش,6,7785,416855610,54638,53546,53546,-1092,-2,54629,-9,-0.02,53546,53546
547,غشوكو,شوكو پارس,6,6796,265805152,39910,39112,39112,-798,-2,39899,-11,-0.03,39112,39112
548,زعف0008پ20,زعفران0008نگين وحدت جام(پ),6,4700,658594000,139792,140555,140995,1203,0.86,140126,334,0.24,138999,140995
549,ضشنا2003,اختيارخ شپنا-14000-1400/02/27,6,83,32084000,280,400,250,-30,-10.71,387,107,38.21,184,450
550,تملي703,تسهيلات مسكن ب. ملي-خرداد97,6,100,62116030,591593,621172,621169,29576,5,621160,29567,5,621100,621172
551,تپكو,توليدتجهيزات‌سنگين‌هپكو,6,10834,57799390,5443,5335,5335,-108,-1.98,5443,0,0,5335,5335
552,پلاسك,پلاسكوكار,5,17035,125036900,7480,7340,7340,-140,-1.87,7480,0,0,7340,7340
553,ضفلا3003,اختيارخ فولاد-7133-1400/03/19,5,25,67000000,3045,2700,2650,-395,-12.97,2680,-365,-11.99,2650,2700
554,ضملي3001,اختيارخ فملي-9000-1400/03/02,5,76,192320000,2515,2520,2520,5,0.2,2531,16,0.64,2520,2600
555,بنو,بيمه تجارت نو,5,1304,40772168,31905,31267,31267,-638,-2,31904,-1,0,31267,31267
556,جهرم,پتروشيمي جهرم,5,120600,210085200,1777,1742,1742,-35,-1.97,1777,0,0,1742,1742
557,ضشنا2004,اختيارخ شپنا-16000-1400/02/27,5,400,46000000,113,90,130,17,15.04,115,2,1.77,90,130
558,غصينو,صنعتي مينو,5,3317,220845860,67938,66580,66580,-1358,-2,67935,-3,0,66580,66580
559,وسفارس,شركت س استان فارس,5,10060,10160600,1030,1010,1010,-20,-1.94,1030,0,0,1010,1010
560,اپرداز,آتيه داده پرداز,5,1896,39658632,21343,20917,20917,-426,-2,21343,0,0,20917,20917
561,ضملت3000,اختيارخ وبملت-3000-1400/03/19,5,55,76820000,1200,1200,1659,459,38.25,1397,197,16.42,1200,1659
562,ثنور,سرمايه گذاري كوه نور,5,11410,109113830,9758,9563,9563,-195,-2,9757,-1,-0.01,9563,9563
563,اخزا716,اسنادخزانه-م16بودجه97-000407,5,1255,1208195006,962605,962705,963000,395,0.04,962705,100,0.01,962704,963000
564,فالوم,آلومتك‌,5,1791,63870642,36389,35662,35662,-727,-2,36387,-2,-0.01,35662,35662
565,دقاضيح,ح . داروسازي شهيد قاضي,5,1500,56183000,39000,37510,37440,-1560,-4,37455,-1545,-3.96,37440,37510
566,وسنا,سرمايه گذاري نيروگاهي ايران,5,12842,197689748,15708,15394,15394,-314,-2,15705,-3,-0.02,15394,15394
567,مرقام,ايران‌ارقام‌,5,6295,120423350,19520,19130,19130,-390,-2,19520,0,0,19130,19130
568,ختراك,ريخته‌گري‌ تراكتورسازي‌ ايران‌,5,35999,550424710,15600,15290,15290,-310,-1.99,15600,0,0,15290,15290
569,وساربيل,شركت س استان اردبيل,5,8030,10117800,1280,1260,1260,-20,-1.56,1280,0,0,1260,1260
570,شستان,پتروشيمي گلستان,5,13780,56098380,4154,4071,4071,-83,-2,4154,0,0,4071,4071
571,تنوينح,ح . تامين سرمايه نوين,5,65000,371540000,5900,5900,5710,-190,-3.22,5720,-180,-3.05,5710,5900
572,شپاس,نفت پاسارگاد,5,163700,3480098300,21692,21259,21259,-433,-2,21661,-31,-0.14,21259,21259
573,گوهر2,صندوق سكه طلاي كيان,5,50000,50000,49849,1,1,-49848,-100,1,-49848,-100,1,1
574,ضمخا2000,اختيارخ اخابر-9000-1400/02/29,5,51,58600000,233,1150,1100,867,372.1,1149,916,393.13,1100,1150
575,دلقما,دارويي‌ لقمان‌,5,4115,104479850,25900,25390,25390,-510,-1.97,25900,0,0,25390,25390
576,ضغدر3002,اختيارخ وغدير-8200-1400/03/26,5,21,54601000,2588,2600,2600,12,0.46,2600,12,0.46,2600,2601
577,رتاپ,تجارت الكترونيك  پارسيان,5,4836,35061000,7390,7250,7250,-140,-1.89,7390,0,0,7250,7250
578,فزرين,زرين معدن آسيا,5,1582,41997354,27088,26547,26547,-541,-2,27088,0,0,26547,26547
579,ضمخا7070,اختيارخ اخابر-20000-1400/07/28,5,12,7220000,459,310,600,141,30.72,602,143,31.15,310,749
580,غچين,كشت‌ و صنعت‌ چين‌ چين,5,3832,74570720,19850,19460,19460,-390,-1.96,19850,0,0,19460,19460
581,حآسا,آسيا سير ارس,5,2964,130404144,44893,43996,43996,-897,-2,44891,-2,0,43996,43996
582,ثنظام,س. ساختماني نظام مهندسي ايران,4,786,36550572,47451,46502,46502,-949,-2,47449,-2,0,46502,46502
583,ولبهمن,شركت بهمن ليزينگ,4,34886,267889594,7835,7679,7679,-156,-1.99,7834,-1,-0.01,7679,7679
584,زكوثر,سرمايه گذاري كشاورزي كوثر,4,1207,25612540,21650,21220,21220,-430,-1.99,21650,0,0,21220,21220
585,كشرق,صنعتي و معدني شمال شرق شاهرود,4,481,43413136,92097,90256,90256,-1841,-2,92095,-2,0,90256,90256
586,اخزا723,اسنادخزانه-م23بودجه97-000824,4,280,249618551,897200,890134,892999,-4201,-0.47,891495,-5705,-0.64,890133,892999
587,خاذين,سايپاآذين‌,4,5345,24907700,4750,4660,4660,-90,-1.89,4750,0,0,4660,4660
588,شصفها4,پتروشيمي‌ اصفهان‌,4,22240859,3135560783538,119254,140982,140982,21728,18.22,140982,21728,18.22,140982,140982
589,غگرجي,بيسكويت‌  گرجي‌,4,2670,48407100,18490,18130,18130,-360,-1.95,18490,0,0,18130,18130
590,كهمداح,ح . شيشه‌ همدان‌,4,22500,173250000,7790,7700,7700,-90,-1.16,7700,-90,-1.16,7700,7700
591,شفا,سرمايه گذاري شفادارو,4,3047,139034610,46560,45630,45630,-930,-2,46560,0,0,45630,45630
592,وسخوز,شركت س استان خوزستان,4,5530,5308800,970,960,960,-10,-1.03,970,0,0,960,960
593,غمينو,شركت صنايع غذايي مينو شرق,4,2448,27427392,11432,11204,11204,-228,-1.99,11432,0,0,11204,11204
594,ضبدر3003,اختيارخ شبندر-20000-1400/03/30,4,81,341400000,5500,4200,4200,-1300,-23.64,4215,-1285,-23.36,4200,4220
595,زير0003پ02,زيره سبز0003 دانش(پ),4,150,79908000,549868,535100,530000,-19868,-3.61,532720,-17148,-3.12,530000,535100
596,پخش,پخش البرز,4,5350,169883900,32402,31754,31754,-648,-2,32400,-2,-0.01,31754,31754
597,وآوا,سرمايه گذاري آوا نوين,4,3300,28766100,8894,8717,8717,-177,-1.99,8894,0,0,8717,8717
598,ضپيك2010,اختيارخ تاپيكو-12000-00/02/19,4,41,20333000,500,500,333,-167,-33.4,496,-4,-0.8,333,500
599,ضپاس2004,اختيارخ وپارس-4000-1400/02/29,4,120,1200000,11,10,10,-1,-9.09,10,-1,-9.09,10,10
600,شزنگ,تجهيزنيروي‌زنگان‌,4,196,44146256,234620,225236,225236,-9384,-4,234598,-22,-0.01,225236,225236
601,تملي705,تسهيلات مسكن ب. ملي-مرداد97,4,29,21063053,717651,717651,753533,35882,5,726312,8661,1.21,717651,753533
602,دبالك,مواد اوليه دارويي البرز بالك,4,3397,69342961,20829,20413,20413,-416,-2,20828,-1,0,20413,20413
603,قشير,قند شيروان قوچان و بجنورد,4,2306,58055856,25689,25176,25176,-513,-2,25688,-1,0,25176,25176
604,ديران,ايران‌دارو,4,1555,40321150,26450,25930,25930,-520,-1.97,26450,0,0,25930,25930
605,فپنتا,سپنتا,4,2524,1008539920,407730,399580,399580,-8150,-2,407560,-170,-0.04,399580,399580
606,زنگان,صنعت روي زنگان,4,1149,117663345,104494,102405,102405,-2089,-2,104489,-5,0,102405,102405
607,ضچاد2004,اختيارخ كچاد-20000-1400/02/05,4,35,38660000,3150,1500,2500,-650,-20.63,1105,-2045,-64.92,320,2500
608,وسرضوي,س.سهام عدالت استان خراسان رضوي,4,6047,6107470,1030,1010,1010,-20,-1.94,1030,0,0,1010,1010
609,وارس,سرمايه گذاري ارس صبا,4,1542,26523942,17552,17201,17201,-351,-2,17552,0,0,17201,17201
610,واميد,گروه مديريت سرمايه گذاري اميد,4,3295,41352250,12800,12550,12550,-250,-1.95,12800,0,0,12550,12550
611,لسرما,سرما آفرين‌,4,15025,358496500,24340,23860,23860,-480,-1.97,24340,0,0,23860,23860
612,كباده,توليد خاك نسوزاستقلال آباده,4,60000,549240000,8719,9154,9154,435,4.99,8730,11,0.13,9154,9154
613,وسقم,شركت س استان قم,3,10100,14039000,1410,1390,1390,-20,-1.42,1410,0,0,1390,1390
614,ضفلا3001,اختيارخ فولاد-5706-1400/03/19,3,25,120300000,4800,5100,4800,0,0,4812,12,0.25,4800,5100
615,تملي708,تسهيلات مسكن ب. ملي-آبان97,3,29,17569795,577005,605855,605855,28850,5,605855,28850,5,605855,605855
616,وسكرشا,س.سهام عدالت استان كرمانشاه,3,30,37200,1260,1240,1240,-20,-1.59,1260,0,0,1240,1240
617,اراد51,مرابحه عام دولت5-ش.خ 0010,3,3000,2969000000,969000,1000000,969000,0,0,989667,20667,2.13,969000,1000000
618,غشاذر,پگاه‌آذربايجان‌غربي‌,3,3037,29762600,10000,9800,9800,-200,-2,10000,0,0,9800,9800
619,افرا,افرانت,3,11629,391071641,34315,33629,33629,-686,-2,34310,-5,-0.01,33629,33629
620,ضمخا7076,اختيارخ اخابر-10000-1400/07/28,3,72,108300000,2000,1800,1500,-500,-25,1504,-496,-24.8,1500,1800
621,زبينا,كشاورزي و دامپروري بينالود,3,6500,24914500,3911,3833,3833,-78,-1.99,3911,0,0,3833,3833
622,اراد504,مرابحه عام دولت5-ش.خ0302,3,5000000,5013528000000,1000000,1013528,1000000,0,0,1002706,2706,0.27,1000000,1013528
623,تاپكيش,تجارت الكترونيك پارسيان كيش,3,1350,24092100,18210,17846,17846,-364,-2,18210,0,0,17846,17846
624,وسكهبو,س.عدالت ا. كهگيلويه وبويراحمد,3,30,33300,1130,1110,1110,-20,-1.77,1130,0,0,1110,1110
625,تملي701,تسهيلات مسكن ب. ملي-فروردين97,3,39,24698310,603134,633290,633290,30156,5,633290,30156,5,633290,633290
626,غبهار,كشت وصنعت بهاران گلبهار خراسان,3,3864,129455592,34186,33503,33503,-683,-2,34181,-5,-0.01,33503,33503
627,زقيام,كشت و دام قيام اصفهان,3,680,19320160,28991,28412,28412,-579,-2,28991,0,0,28412,28412
628,لخزر,پارس‌ خزر,3,178,32533060,186490,182770,182770,-3720,-1.99,186490,0,0,182770,182770
629,ددام,داروسازي زاگرس فارمد پارس,3,6213,135132750,22190,21750,21750,-440,-1.98,22190,0,0,21750,21750
630,اخزا810,اسنادخزانه-م10بودجه98-001006,3,1720,1499877406,872006,872500,872044,38,0,872022,16,0,872011,872500
631,وسيزد,شركت س استان يزد,3,30,37800,1280,1260,1260,-20,-1.56,1280,0,0,1260,1260
632,تكشا,گسترش‌صنايع‌وخدمات‌كشاورزي‌,3,743,33873370,46520,45590,45590,-930,-2,46520,0,0,45590,45590
633,تملي707,تسهيلات مسكن ب. ملي-مهر97,3,19,13382764,741427,704356,704356,-37071,-5,704356,-37071,-5,704356,704356
634,ضخود7072,اختيارخ خودرو-1400-1400/07/07,3,71,60496000,1050,852,856,-194,-18.48,852,-198,-18.86,852,856
635,قهكمت,قندهكمتان‌,3,656,29624960,46080,45160,45160,-920,-2,46080,0,0,45160,45160
636,چكاوه,صنايع‌كاغذسازي‌كاوه‌,3,23078,416788680,18420,18060,18060,-360,-1.95,18420,0,0,18060,18060
637,وسالت,بانك قرض الحسنه رسالت,3,132318,154018152,1109,1164,1164,55,4.96,1109,0,0,1164,1164
638,وسهمدا,شركت س استان همدان,3,45,39600,890,880,880,-10,-1.12,890,0,0,880,880
639,كسرام,پارس‌ سرام‌,3,6650,54330500,8330,8170,8170,-160,-1.92,8330,0,0,8170,8170
640,خكمك,كمك‌فنرايندامين‌,3,900,23931000,27130,26590,26590,-540,-1.99,27130,0,0,26590,26590
641,وپسا,س. پتروشيمي ساختمان  خليج فارس,3,11035,32531180,3008,2948,2948,-60,-1.99,3008,0,0,2948,2948
642,وسصفا,شركت س استان اصفهان,3,30,31500,1070,1050,1050,-20,-1.87,1070,0,0,1050,1050
643,اخزا820,اسنادخزانه-م20بودجه98-020806,3,740,446701365,604087,602505,604000,-87,-0.01,603650,-437,-0.07,602401,604000
644,زگلدشت,كشت و دام گلدشت نمونه اصفهان,3,2432,33379200,14005,13725,13725,-280,-2,14005,0,0,13725,13725
645,اخزا807,اسنادخزانه-م7بودجه98-000719,3,50,45454328,908335,914890,911000,2665,0.29,909087,752,0.08,907042,914890
646,زمگسا,كشاورزي‌ ودامپروي‌ مگسال‌,3,1894,60323900,32490,31850,31850,-640,-1.97,32490,0,0,31850,31850
647,افاد73,منفعت دولت7-ش.خاص نوين0204,3,2200,2368000000,1040000,1000000,1080000,40000,3.85,1076364,36364,3.5,1000000,1080000
648,غدام,خوراك‌  دام‌ پارس‌,3,228,88185840,394670,386780,386780,-7890,-2,394660,-10,0,386780,386780
649,غدشت,دشت‌ مرغاب‌,3,170,48087900,288640,282870,282870,-5770,-2,288630,-10,0,282870,282870
650,ضصاد3003,اختيارخ وبصادر-3000-1400/03/12,3,40,2980000,55,75,74,19,34.55,74,19,34.55,74,75
651,اخزا805,اسنادخزانه-م5بودجه98-000422,3,1935,1847925000,954917,955000,955000,83,0.01,955000,83,0.01,955000,955000
652,سفاسي,شركت فارسيت اهواز,3,1421,20087256,14424,14136,14136,-288,-2,14424,0,0,14136,14136
653,كلوند,كاشي‌ الوند,3,983,44795310,46500,45570,45570,-930,-2,46500,0,0,45570,45570
654,اشاد10,مشاركت دولتي10-شرايط خاص001226,3,2100,2001923000,950225,960000,946024,-4201,-0.44,953297,3072,0.32,946024,960000
655,اعتماد2,صندوق س.اعتماد آفرين پارسيان-د,3,22400000,22400000,35965,1,1,-35964,-100,1,-35964,-100,1,1
656,كساوه,صنايع‌ كاشي‌ و سراميك‌ سينا,3,1169,80836350,70560,69150,69150,-1410,-2,70560,0,0,69150,69150
657,خفنر,فنرسازي‌خاور,3,6749,57299010,8660,8490,8490,-170,-1.96,8660,0,0,8490,8490
658,كيميا,معدني كيمياي زنجان گستران,3,2296,39913664,17738,17384,17384,-354,-2,17738,0,0,17384,17384
659,داراب,پتروشيمي داراب,3,16407,39409614,2451,2402,2402,-49,-2,2451,0,0,2402,2402
660,شلعاب,لعابيران‌,3,1030,22134700,21920,21490,21490,-430,-1.96,21920,0,0,21490,21490
661,قشهد,شهد,3,2000,40060000,20430,20030,20030,-400,-1.96,20430,0,0,20030,20030
662,وسرمد,بيمه  سرمد,3,19300,118019500,6239,6115,6115,-124,-1.99,6238,-1,-0.02,6115,6115
663,اراد35,مرابحه عام دولت3-ش.خ 0103,3,21000,20615000000,950000,950000,997500,47500,5,981667,31667,3.33,950000,997500
664,دسبحا,گروه دارويي سبحان,3,13000,247130000,19390,19010,19010,-380,-1.96,19390,0,0,19010,19010
665,دحاوي,الحاوي,2,1250,14975000,12224,11980,11980,-244,-2,12224,0,0,11980,11980
666,صگل039,صكوك اجاره گل گهر039-3ماهه20%,2,40,40000000,998898,1000000,1000000,1102,0.11,1000000,1102,0.11,1000000,1000000
667,ضمخا7071,اختيارخ اخابر-24000-1400/07/28,2,185,27750000,185,150,150,-35,-18.92,150,-35,-18.92,150,150
668,گكيش,توريستي ورفاهي آبادگران كيش,2,1435,68446630,48671,47698,47698,-973,-2,48668,-3,-0.01,47698,47698
669,دسانكو,داروسازي سبحان انكولوژي,2,700,10147200,14791,14496,14496,-295,-1.99,14791,0,0,14496,14496
670,ضفلا3008,اختيارخ فولاد-14266-1400/03/19,2,51,23755000,1,475,5,4,400,466,465,46500,5,475
671,ضسان2009,اختيارخ پارسان-18750-00/02/15,2,2,4200000,3000,1200,3000,0,0,2100,-900,-30,1200,3000
672,صفارس412,صكوك اجاره خليج فارس- 3ماهه16%,2,1000,986000000,975000,986000,986000,11000,1.13,986000,11000,1.13,986000,986000
673,توريل,توکاريل,2,2210,54520700,25173,24670,24670,-503,-2,25172,-1,0,24670,24670
674,دروز,داروسازي‌ روزدارو,2,457,15917310,35540,34830,34830,-710,-2,35540,0,0,34830,34830
675,ثجوان,تامين مسكن جوانان,2,5522,60178756,11120,10898,10898,-222,-2,11119,-1,-0.01,10898,10898
676,فجام,جام‌دارو,2,6040,61185200,10330,10130,10130,-200,-1.94,10330,0,0,10130,10130
677,ضملي7002,اختيارخ فملي-10000-1400/07/11,2,30,80200000,2506,2700,2660,154,6.15,2673,167,6.66,2660,2700
678,غپونه,نوش پونه مشهد,2,575,10501800,18636,18264,18264,-372,-2,18636,0,0,18264,18264
679,خوساز,محورسازان‌ايران‌خودرو,2,1650,12969000,8020,7860,7860,-160,-2,8020,0,0,7860,7860
680,صشستا311,صكوك اجاره شستا311-بدون ضامن,2,1009,1058980000,999981,1000000,1049980,49999,5,1049534,49553,4.96,1000000,1049980
681,طفلا3002,اختيارف فولاد-6420-1400/03/19,2,2,165000,75,80,85,10,13.33,82,7,9.33,80,85
682,وسزنجان,شركت س استان زنجان,2,3900,5460000,1420,1400,1400,-20,-1.41,1420,0,0,1400,1400
683,ضفلا3002,اختيارخ فولاد-6420-1400/03/19,2,11,39600000,3980,3600,3600,-380,-9.55,3600,-380,-9.55,3600,3600
684,زعف0008پ15,زعفران0008پوشالمعمول طلاسرخ(پ),2,129,12526600,99817,92000,100900,1083,1.08,97105,-2712,-2.72,92000,100900
685,لپيام,گسترش صنايع پيام,2,200,10756000,54877,53780,53780,-1097,-2,54876,-1,0,53780,53780
686,وايران,ليزينگ ايرانيان,2,3580,44141400,12580,12330,12330,-250,-1.99,12580,0,0,12330,12330
687,زماهان,مجتمع توليد گوشت مرغ ماهان,2,518,10457902,20601,20189,20189,-412,-2,20601,0,0,20189,20189
688,آبين,كشت و صنعت آبشيرين,2,2556,10556280,4214,4130,4130,-84,-1.99,4214,0,0,4130,4130
689,نگين,ص.س. زمين و ساختمان نگين شهرري,2,306,14556930,47550,47550,47580,30,0.06,47570,20,0.04,47550,47580
690,ولملت,واسپاري ملت,2,3305,26506100,8180,8020,8020,-160,-1.96,8180,0,0,8020,8020
691,وسمازن,س.سهام عدالت استان مازندران,2,20,19200,970,960,960,-10,-1.03,970,0,0,960,960
692,ريشمك,توليد و صادرات ريشمك,2,180,10074960,57114,55972,55972,-1142,-2,57114,0,0,55972,55972
693,ومعلم,بيمه معلم,2,3681,17996409,4988,4889,4889,-99,-1.98,4988,0,0,4889,4889
694,وزمين,بانك ايران زمين,2,3286,44196700,13724,13450,13450,-274,-2,13723,-1,-0.01,13450,13450
695,سنفت001,سلف موازي استاندارد سنفت001,2,166880,190006897920,1127414,1138584,1138584,11170,0.99,1138584,11170,0.99,1138584,1138584
696,بنيرو,نيروترانس‌,2,770,11388300,15090,14790,14790,-300,-1.99,15090,0,0,14790,14790
697,چافست,افست‌,2,825,13422750,16600,16270,16270,-330,-1.99,16600,0,0,16270,16270
698,كترام,توليدي‌ كاشي‌ تكسرام‌,2,2106,100245600,48570,47600,47600,-970,-2,48570,0,0,47600,47600
699,ضپنا2004,اختيارخ رمپنا-18000-1400/02/12,2,2,179000,99,89,90,-9,-9.09,89,-10,-10.1,89,90
700,ثالوند,سرمايه گذاري مسكن الوند,2,1261,39876603,32268,31623,31623,-645,-2,32267,-1,0,31623,31623
701,شاملا,معدني‌ املاح‌  ايران‌,2,10600,521732000,50220,49220,49220,-1000,-1.99,50210,-10,-0.02,49220,49220
702,غبهنوش,بهنوش‌ ايران‌,2,380,26657000,71580,70150,70150,-1430,-2,71580,0,0,70150,70150
703,نهال2,صندوق س. طلاي سرخ نوويرا,2,200000,200000,10569,1,1,-10568,-99.99,1,-10568,-99.99,1,1
704,گواهي ظرفيت,گواهي ظرفيت نقدي,2,3375000,45819000000,12930,13576,13576,646,5,13576,646,5,13576,13576
705,فولاد2,فولاد مباركه اصفهان,2,26500000,325625000000,12290,12290,12260,-30,-0.24,12288,-2,-0.02,12260,12290
706,دشيري,شيرين دارو,2,50000,11737550000,239541,234751,234751,-4790,-2,236672,-2869,-1.2,234751,234751
707,ضمخا7066,اختيارخ اخابر-12000-1400/07/28,2,6,7803000,1226,1202,1399,173,14.11,1300,74,6.04,1202,1399
708,سدبير,س. تدبيرگران فارس وخوزستان,2,105,9202200,89428,87640,87640,-1788,-2,89428,0,0,87640,87640
709,اخزا813,اسنادخزانه-م13بودجه98-010219,2,1745,1422175000,815696,815000,815000,-696,-0.09,815000,-696,-0.09,815000,815000
710,وساشرقي,شركت س استان آذربايجان شرقي,2,20,19200,970,960,960,-10,-1.03,970,0,0,960,960
711,افران2,صندوق س افرا نماد پايدار-ثابت,2,5500000,5500000,13132,1,1,-13131,-99.99,1,-13131,-99.99,1,1
712,ولصنم,ليزينگ‌صنعت‌ومعدن‌,2,970,10553600,11100,10880,10880,-220,-1.98,11100,0,0,10880,10880
713,صايپا308,صكوك مرابحه سايپا308-3ماهه 18%,2,30,29999980,995000,999999,1000000,5000,0.5,999999,4999,0.5,999999,1000000
714,اطلس2,صندوق س.توسعه اندوخته آينده-س,2,20000,20000,203327,1,1,-203326,-100,1,-203326,-100,1,1
715,اراد49,مرابحه عام دولت4-ش.خ 0206,2,4000,4040000000,990000,1010000,1010000,20000,2.02,1010000,20000,2.02,1010000,1010000
716,كاذر,فرآورده‌هاي‌نسوزآذر,2,330,10593000,32750,32100,32100,-650,-1.98,32750,0,0,32100,32100
717,افاد24,منفعت دولتي2-شرايط خاص14000626,2,10980000,10912407120000,985000,993916,993772,8772,0.89,993844,8844,0.9,993772,993916
718,ضسان2008,اختيارخ پارسان-16750-00/02/15,2,5,23000000,5000,4000,5000,0,0,4600,-400,-8,4000,5000
719,پست0008پ09,پسته بادامي30-28مه ولات0008(پ),2,604,1058358396,1668809,1752249,1752249,83440,5,1752249,83440,5,1752249,1752249
720,هجرتح,ح . پخش هجرت,2,1281,29683332,23644,23172,23172,-472,-2,23172,-472,-2,23172,23172
721,طملي3001,اختيارف فملي-9000-1400/03/02,2,2,145000,95,70,75,-20,-21.05,72,-23,-24.21,70,75
722,فنفت,صنايع تجهيزات نفت,2,775,25102250,33051,32390,32390,-661,-2,33050,-1,0,32390,32390
723,كپشير,پشم‌شيشه‌ايران‌,2,280,10970400,39970,39180,39180,-790,-1.98,39970,0,0,39180,39180
724,ضچاد2003,اختيارخ كچاد-18000-1400/02/05,1,2,6000000,5500,3000,3000,-2500,-45.45,3000,-2500,-45.45,3000,3000
725,خموتور,موتورسازان‌تراكتورسازي‌ايران‌,1,1519,22314110,14980,14690,14690,-290,-1.94,14980,0,0,14690,14690
726,حاريا,كشتيراني آريا,1,300,8338500,28953,27795,27795,-1158,-4,28952,-1,0,27795,27795
727,قلرست,قند لرستان‌,1,1000,35100000,35810,35100,35100,-710,-1.98,35810,0,0,35100,35100
728,فايرا2,آلومينيوم‌ايران‌,1,10000000,176300000000,17630,17630,17630,0,0,17630,0,0,17630,17630
729,پرداخت,به پرداخت ملت,1,158,5059160,32670,32020,32020,-650,-1.99,32670,0,0,32020,32020
730,ثاباد,توريستي ورفاهي آبادگران ايران,1,100,5314000,54220,53140,53140,-1080,-1.99,54220,0,0,53140,53140
731,وسيلام,شركت س استان ايلام,1,100,122000,1240,1220,1220,-20,-1.61,1240,0,0,1220,1220
732,نوري2,پتروشيمي نوري,1,1600000,96656000000,60410,60410,60410,0,0,60410,0,0,60410,60410
733,اراد464,مرابحه عام دولت4-ش.خ 0302,1,2800000,2800000000000,1000000,1000000,1000000,0,0,1000000,0,0,1000000,1000000
734,غشصفا,شيرپاستوريزه‌پگاه‌اصفهان‌,1,508,13939520,28000,27440,27440,-560,-2,28000,0,0,27440,27440
735,پلاست,كارخانجات توليدي پلاستيران,1,123,8677035,71984,70545,70545,-1439,-2,71983,-1,0,70545,70545
736,ضپنا2006,اختيارخ رمپنا-24000-1400/02/12,1,2,22000,11,11,11,0,0,11,0,0,11,11
737,شبندر2,پالايش نفت بندرعباس,1,4300000,98212000000,23300,22840,22840,-460,-1.97,22840,-460,-1.97,22840,22840
738,فن آوا,گروه فن آوا,1,50000,898850000,18343,17977,17977,-366,-2,18326,-17,-0.09,17977,17977
739,ثپرديس,سرمايه گذاري مسكن پرديس,1,510,5078070,10160,9957,9957,-203,-2,10160,0,0,9957,9957
740,واحصا,احياء صنايع خراسان,1,424,30235440,72765,71310,71310,-1455,-2,72763,-2,0,71310,71310
741,ضپنا2005,اختيارخ رمپنا-20000-1400/02/12,1,10,110000,1100,11,11,-1089,-99,11,-1089,-99,11,11
742,كمرجان,بازرگاني و توليدي مرجان كار,1,50,7200600,146951,144012,144012,-2939,-2,146951,0,0,144012,144012
743,كيسون,شركت كيسون,1,1000,11457000,11690,11457,11457,-233,-1.99,11690,0,0,11457,11457
744,صگل309,صكوك اجاره گل گهر309-3ماهه20%,1,1000,1120000000,1100000,1120000,1120000,20000,1.82,1120000,20000,1.82,1120000,1120000
745,بشهاب,لامپ‌  پارس‌ شهاب‌,1,1500,219360000,149220,146240,146240,-2980,-2,149210,-10,-0.01,146240,146240
746,ضملي7001,اختيارخ فملي-9000-1400/07/11,1,2,7300000,3690,3650,3650,-40,-1.08,3650,-40,-1.08,3650,3650
747,داريك,صندوق س.اعتماد داريك-د,1,1000,10531000,10529,10531,10531,2,0.02,10531,2,0.02,10531,10531
748,سميعا002,سلف موازي استاندارد سميعا002,1,2000,2629168000,1287190,1314584,1314584,27394,2.13,1314584,27394,2.13,1314584,1314584
749,ضفار3000,اختيارخ فارس-8000-1400/03/05,1,45,54090000,1706,1202,1202,-504,-29.54,1202,-504,-29.54,1202,1202
750,ضپنا2002,اختيارخ رمپنا-14000-1400/02/12,1,2,6400000,3400,3200,3200,-200,-5.88,3200,-200,-5.88,3200,3200
751,بكاب,صنايع‌جوشكاب‌يزد,1,296,104567920,360470,353270,353270,-7200,-2,360450,-20,-0.01,353270,353270
752,ضبدر3004,اختيارخ شبندر-24000-1400/03/30,1,1,2225000,2473,2225,2225,-248,-10.03,2225,-248,-10.03,2225,2225
753,طخود2005,اختيارف خودرو-2000-1400/02/08,1,1,4000,30,4,4,-26,-86.67,4,-26,-86.67,4,4
754,كرمان00,رهني كرمان موتور14001130,1,2893,2968218000,1000000,1026000,1026000,26000,2.6,1026000,26000,2.6,1026000,1026000
755,ثامان,سامان‌ گستراصفهان‌,1,4000,93760000,23910,23440,23440,-470,-1.97,23910,0,0,23440,23440
756,مداران,داده‌پردازي‌ايران‌,1,205,5047100,25120,24620,24620,-500,-1.99,25120,0,0,24620,24620
757,خشرق,الكتريك‌ خودرو شرق‌,1,500,7330000,14950,14660,14660,-290,-1.94,14950,0,0,14660,14660
758,قنيشا,قند  نيشابور,1,1000,65470000,66800,65470,65470,-1330,-1.99,66800,0,0,65470,65470
759,وصندوق2,سرمايه‌گذاري‌صندوق‌بازنشستگي‌,1,30000000,426900000000,14520,14230,14230,-290,-2,14230,-290,-2,14230,14230
760,پارسا306,صكوك اجاره پارسيان-6ماهه16%,1,1000,933851000,922351,933851,933851,11500,1.25,933851,11500,1.25,933851,933851
761,آينده,بازرگاني آينده سازان بهشت پارس,1,333,6486174,19875,19478,19478,-397,-2,19875,0,0,19478,19478
762,ضخود7077,اختيارخ خودرو-3000-1400/07/07,1,10,900000,120,90,90,-30,-25,90,-30,-25,90,90
763,پا ه 5,بار پايه هفته 5,1,135000,74250000,340,550,550,210,61.76,550,210,61.76,550,550
764,سلامت6,مرابحه سلامت6واجدشرايط خاص1400,1,500,497500000,985000,995000,995000,10000,1.02,995000,10000,1.02,995000,995000
765,فولاي,صنايع فولاد آلياژي يزد,1,100,5012700,51150,50127,50127,-1023,-2,51150,0,0,50127,50127
766,حپترو,حمل و نقل پتروشيمي( سهامي عام,1,1400,73976000,53910,52840,52840,-1070,-1.98,53910,0,0,52840,52840
767,كفرا,فراورده‌ هاي‌ نسوزايران‌,1,110,5111700,47410,46470,46470,-940,-1.98,47410,0,0,46470,46470
768,اروند03,منفعت صبا اروند تمدن14001113,1,500,500000000,987000,1000000,1000000,13000,1.32,1000000,13000,1.32,1000000,1000000
769,شلرد02,كود شيميايي اوره لردگان,1,22,22260480,995000,1011840,1011840,16840,1.69,1011840,16840,1.69,1011840,1011840
770,ولغدر,ليزينگ‌خودروغدير,1,1337,32235070,24600,24110,24110,-490,-1.99,24600,0,0,24110,24110
771,افاد62,منفعت دولت6-ش.خاص ملت0109,1,10000,10000000000,1000000,1000000,1000000,0,0,1000000,0,0,1000000,1000000
772,طجار2002,اختيارف وتجارت-2500-1400/02/22,1,1,100000,1,100,100,99,9900,100,99,9900,100,100
773,زير0003پ04,زيره سبز0003شركت مينوبذر(پ),1,85,45050000,540438,530000,530000,-10438,-1.93,530000,-10438,-1.93,530000,530000
774,دكيمي,كيميدارو,1,170,5001400,30020,29420,29420,-600,-2,30020,0,0,29420,29420
775,فافزا4,فولاد افزا سپاهان,1,600000,31769400000,53384,52949,52949,-435,-0.81,52949,-435,-0.81,52949,52949
776,تاپيكو2,س. نفت و گاز و پتروشيمي تأمين,1,13500000,150525000000,11150,11150,11150,0,0,11150,0,0,11150,11150
777,وليز,ليزينگ‌ايران‌,1,545,5095750,9540,9350,9350,-190,-1.99,9540,0,0,9350,9350
778,فسديد,لوله‌وتجهيزات‌ سديد - ورشكسته,1,182,20499934,113774,112637,112637,-1137,-1,113769,-5,0,112637,112637
779,ضجار2006,اختيارخ وتجارت-4500-1400/02/22,1,22,198000,2,9,9,7,350,9,7,350,9,9
780,افاد624,منفعت دولت6-ش.خاص ملت0109,1,1990000,1990000000000,1000000,1000000,1000000,0,0,1000000,0,0,1000000,1000000
781,خمحور,توليدمحورخودرو,1,159,9905700,63570,62300,62300,-1270,-2,63570,0,0,62300,62300
782,ضصاد3005,اختيارخ وبصادر-4000-1400/03/12,1,8,312000,40,39,39,-1,-2.5,39,-1,-2.5,39,39
783,زكشت,كشاورزي مكانيزه اصفهان كشت,1,130,5143450,40372,39565,39565,-807,-2,40372,0,0,39565,39565
784,بالاس,مهندسي ساختمان تاسيسات راه آهن,1,90,5097600,57795,56640,56640,-1155,-2,57795,0,0,56640,56640
785,صخود0412,ص مرابحه خودرو041- 3ماهه 18%,1,1000000,990900000000,1000000,990900,990900,-9100,-0.91,990900,-9100,-0.91,990900,990900
786,اشاد1,مشاركت دولتي1-شرايط خاص001026,1,300,297000000,999978,990000,990000,-9978,-1,990000,-9978,-1,990000,990000
787,وشمال,س. چشم انداز توسعه شمال,1,59,5122852,88599,86828,86828,-1771,-2,88599,0,0,86828,86828
788,كطبس,ذغال‌سنگ‌ نگين‌ ط‌بس‌,1,63,5043780,81690,80060,80060,-1630,-2,81690,0,0,80060,80060
789,نبروج,نساجي بروجرد,1,22,130460,5814,5930,5930,116,2,5814,0,0,5930,5930
790,افاد72,منفعت دولت7-ش.خاص سپهر0204,1,5000,3539025000,674100,707805,707805,33705,5,707805,33705,5,707805,707805
791,تصميم2,صندوق س با درآمد ثابت تصميم,1,1000000,1000000,16156,1,1,-16155,-99.99,1,-16155,-99.99,1,1
792,اراد494,مرابحه عام دولت4-ش.خ 0206,1,10000000,9363310000000,990000,936331,936331,-53669,-5.42,936331,-53669,-5.42,936331,936331
793,زنجان,صنايع كشاورزي وكود زنجان,1,550,5041850,9354,9167,9167,-187,-2,9354,0,0,9167,9167
794,ضفلا3005,اختيارخ فولاد-9986-1400/03/19,1,100,50100000,500,501,501,1,0.2,501,1,0.2,501,501
795,وپاسار2,بانك  پاسارگاد,1,22400000,300160000000,13400,13400,13400,0,0,13400,0,0,13400,13400
796,خپويش,سازه‌ پويش‌,1,86,5084320,60320,59120,59120,-1200,-1.99,60320,0,0,59120,59120
797,داوه,داروسازي آوه سينا,1,2000,39566000,20186,19783,19783,-403,-2,20186,0,0,19783,19783
798,غديس,پاكديس,1,564,7427316,13437,13169,13169,-268,-1.99,13437,0,0,13169,13169
799,تملي706,تسهيلات مسكن ب. ملي-شهريور97,1,6,3228144,566341,538024,538024,-28317,-5,538024,-28317,-5,538024,538024
800,حپارسا,توسعه حمل و نقل ريلي پارسيان,1,145,5006125,35229,34525,34525,-704,-2,35229,0,0,34525,34525
801,اراد514,مرابحه عام دولت5-ش.خ 0010,1,1000000,961000000000,969000,961000,961000,-8000,-0.83,961000,-8000,-0.83,961000,961000
802,اراد604,مرابحه عام دولتي6-ش.خ0210,1,3300000,3162588000000,947000,958360,958360,11360,1.2,958360,11360,1.2,958360,958360
803,قنقش,قند نقش جهان,1,76,5474432,73502,72032,72032,-1470,-2,73501,-1,0,72032,72032
804,ضغدر3001,اختيارخ وغدير-7200-1400/03/26,1,14,50400000,4170,3600,3600,-570,-13.67,3600,-570,-13.67,3600,3600
805,آكورد4,صندوق س. آرمان آتي كوثر-د,1,9470000,300009600000,31665,31680,31680,15,0.05,31680,15,0.05,31680,31680
806,وساغربي,شركت س استان آذربايجان غربي,1,15,11400,770,760,760,-10,-1.3,770,0,0,760,760
807,كشم0006پ02,كشمش تيزابي0006تاكستان(پ),1,1000,215000000,219000,215000,215000,-4000,-1.83,215000,-4000,-1.83,215000,215000
808,پا ه 6,بار پايه هفته 6,1,135000,74250000,440,550,550,110,25,550,110,25,550,550
809,ولشرق,ليزينگ ايران و شرق,1,3092,26433508,8723,8549,8549,-174,-1.99,8723,0,0,8549,8549
810,كاسپين,داروسازي كاسپين تامين,1,247,6320236,26110,25588,25588,-522,-2,26110,0,0,25588,25588
811,ثزاگرس,سرمايه گذاري توسعه عمران زاگرس,1,139,7582033,57417,54547,54547,-2870,-5,57416,-1,0,54547,54547
812,كسعدي,كاشي‌ سعدي‌,1,270,5656500,21370,20950,20950,-420,-1.97,21370,0,0,20950,20950
813,ياقوت2,صندوق س ياقوت آگاه-ثابت,1,20328600,20328600,12292,1,1,-12291,-99.99,1,-12291,-99.99,1,1
814,اراد24,مرابحه عام دولت2-ش.خ ساير0212,1,1000,1045000000,1025000,1045000,1045000,20000,1.95,1045000,20000,1.95,1045000,1045000
815,وتعاون,بيمه  تعاون,1,850,5264050,6319,6193,6193,-126,-1.99,6319,0,0,6193,6193
816,رطب0002پ01,رطب مضافتي0002افشارتعاون بم(پ),1,67,10978821,156060,163863,163863,7803,5,163863,7803,5,163863,163863
817,تملي804,تسهيلات مسكن ب. ملي-تير98,1,7,5151664,774686,735952,735952,-38734,-5,735952,-38734,-5,735952,735952
818,ركيش,كارت اعتباري ايران كيش,1,263,6130530,23780,23310,23310,-470,-1.98,23780,0,0,23310,23310
819,فلامي,لاميران‌,1,566,24875700,44840,43950,43950,-890,-1.98,44840,0,0,43950,43950
820,زعف0008پ18,زعفران0008نگين بهرامن(پ),1,100,14298600,143114,142986,142986,-128,-0.09,142986,-128,-0.09,142986,142986
821,كهرام,توليدي گرانيت بهسرام,1,48,5343504,113594,111323,111323,-2271,-2,113593,-1,0,111323,111323
822,افاد74,منفعت دولت7-ش.خاص ساير0204,1,1000,1045000000,1000000,1045000,1045000,45000,4.5,1045000,45000,4.5,1045000,1045000
823,وثخوز,سرمايه گذاري و توسعه خوزستان,1,148,9930356,70628,67097,67097,-3531,-5,70626,-2,0,67097,67097
824,اخزا8212,اسنادخزانه-م21بودجه98-020906,1,322000,191912000000,599929,596000,596000,-3929,-0.65,596000,-3929,-0.65,596000,596000
825,اراد654,مرابحه عام دولتي65-ش.خ0210,1,3230277,3073046497302,970000,951326,951326,-18674,-1.93,951326,-18674,-1.93,951326,951326
826,شتوكا,توكا رنگ فولاد سپاهان,1,103,5475068,54240,53156,53156,-1084,-2,54240,0,0,53156,53156
827,ضفار3002,اختيارخ فارس-10000-1400/03/05,1,5,5800000,982,1160,1160,178,18.13,1160,178,18.13,1160,1160
828,اراد36,مرابحه عام دولت3-ش.خ 0104,1,1000,1102000000,1050000,1102000,1102000,52000,4.95,1102000,52000,4.95,1102000,1102000
829,كچاد2,معدني‌وصنعتي‌چادرملو,1,13000000,298870000000,22990,22990,22990,0,0,22990,0,0,22990,22990
830,اراد61,مرابحه عام دولت61-ش.خ0309,1,25000,25000000000,1000000,1000000,1000000,0,0,1000000,0,0,1000000,1000000
831,وسخراش,شركت س استان خراسان شمالي,1,100,135000,1370,1350,1350,-20,-1.46,1370,0,0,1350,1350
832,غپآذر,شير پگاه آذربايجان شرقي,1,78,5025150,65739,64425,64425,-1314,-2,65739,0,0,64425,64425
833,ثتوسا,س.توسعه و عمران استان اردبيل,1,255,9940410,39777,38982,38982,-795,-2,39777,0,0,38982,38982
834,صايپا0122,صكوك مرابحه سايپا012-3ماهه 16%,1,700000,700000000000,1000001,1000000,1000000,-1,0,1000000,-1,0,1000000,1000000
835,همراه2,شركت ارتباطات سيار ايران,1,5800000,149930000000,25850,25850,25850,0,0,25850,0,0,25850,25850
