,نماد,نام,تعداد,حجم,ارزش,دیروز,اولین,آخرین معامله - مقدار,آخرین معامله - تغییر,آخرین معامله - درصد,قیمت پایانی - مقدار,قیمت پایانی - تغییر,قیمت پایانی - درصد,کمترین,بیشترین
2,پالايش,صندوق پالايشي يکم-سهام,35706,52503522,3426678239500,64000,64000,66200,2200,3.44,65270,1270,1.98,63410,66630
3,فگستر,گسترش صنايع روي ايرانيان,28508,2090236,18260301696,8320,8736,8736,416,5,8736,416,5,8736,8736
4,دارا يكم,صندوق واسطه گري مالي يكم-سهام,21137,16481844,1854926161970,113040,110200,113600,560,0.5,112540,-500,-0.44,109510,114110
5,شپنا,پالايش نفت اصفهان,17661,138236910,1252115273690,9020,8770,9200,180,2,9060,40,0.44,8610,9430
6,فتوسا,توليد و توسعه سرب روي ايرانيان,16878,2052858,18596840622,8628,9059,9059,431,5,9059,431,5,9059,9059
7,كارين2,صندوق س نگين سامان-ثابت,12990,129900000,129900000,10016,1,1,-10015,-99.99,1,-10015,-99.99,1,1
8,كزغال,زغال سنگ پروده طبس,12724,6980723,213031750635,30255,30000,30351,96,0.32,30517,262,0.87,29810,31400
9,شتران,پالايش نفت تهران,11866,162034161,1156790463400,6890,6740,7230,340,4.93,7140,250,3.63,6650,7230
10,فملي,ملي‌ صنايع‌ مس‌ ايران‌,11234,58126298,661274072180,11450,11220,11450,0,0,11380,-70,-0.61,11050,11640
11,ولپارس,ليزينگ پارسيان,10356,6791532,25517640811,3676,3493,3859,183,4.98,3757,81,2.2,3493,3859
12,شستا,سرمايه گذاري تامين اجتماعي,9759,33399412,317789935310,9500,9210,9620,120,1.26,9510,10,0.11,9210,9780
13,خگستر,گسترش‌سرمايه‌گذاري‌ايران‌خودرو,8263,436742145,777335396602,1860,1767,1796,-64,-3.44,1780,-80,-4.3,1767,1839
14,امينح,ح . تامين سرمايه امين,7808,4595992,23018436477,4997,4910,5021,24,0.48,5008,11,0.22,4910,5050
15,ثاميد,توسعه و عمران اميد,7374,53488672,72923460750,1345,1330,1363,18,1.34,1363,18,1.34,1310,1395
16,اپال,فرآوري معدني اپال كاني پارس,7351,5980013,110033479070,18130,18050,18460,330,1.82,18390,260,1.43,18050,18710
17,كرمان,س. توسعه و عمران استان كرمان,7194,265617907,243631358265,956,915,909,-47,-4.92,917,-39,-4.08,909,947
18,بركت,گروه دارويي بركت,7179,31638723,727504047250,24170,22970,22970,-1200,-4.96,22990,-1180,-4.88,22970,23500
19,وبصادر,بانك صادرات ايران,6892,318272551,547579857099,1807,1717,1740,-67,-3.71,1720,-87,-4.81,1717,1744
20,شبندر,پالايش نفت بندرعباس,6890,32071727,609918539710,19040,18290,19230,190,1,19020,-20,-0.11,18130,19700
21,بوعلي,پتروشيمي بوعلي سينا,6264,1955960,88163243970,44850,43250,44590,-260,-0.58,45070,220,0.49,43250,46000
22,وكبهمن,مديريت سرمايه گذاري كوثربهمن,6089,2769255,28486735008,10072,9840,10190,118,1.17,10287,215,2.13,9840,10499
23,وسپهر,سرمايه گذاري مالي سپهرصادرات,5935,16019219,145688056340,9094,9094,9230,136,1.5,9095,1,0.01,9094,9230
24,وبملت,بانك ملت,5887,295107467,1138970064664,4853,3870,3850,-1003,-20.67,3860,-993,-20.46,3800,3900
25,امين,تامين سرمايه امين,5454,6187127,43935954470,7090,7100,7100,10,0.14,7100,10,0.14,7100,7120
26,ذوب,سهامي ذوب آهن  اصفهان,4984,85126537,239710973808,2794,2794,2842,48,1.72,2816,22,0.79,2725,2880
27,آريا,پليمر آريا ساسول,4943,1592101,117543528244,73364,75000,74250,886,1.21,73829,465,0.63,73001,75000
28,آبادا,توليد نيروي برق آبادان,4694,1871373,16124159750,9000,8570,8560,-440,-4.89,8620,-380,-4.22,8550,8860
29,خبهمن,گروه‌بهمن‌,4516,154623257,163644292069,1072,1027,1072,0,0,1058,-14,-1.31,1023,1090
30,ساوه,سيمان ساوه,4267,3396678,137876747360,42105,42920,41000,-1105,-2.62,40592,-1513,-3.59,40000,43180
31,شگويا,پتروشيمي تندگويان,4263,21601304,179888740143,8178,8170,8370,192,2.35,8328,150,1.83,8116,8499
32,كمند,صندوق س. با درآمد ثابت كمند,4228,174600873,1764357923944,10100,10105,10106,6,0.06,10105,5,0.05,10104,10107
33,پترول,گروه پتروشيمي س. ايرانيان,4023,26853527,216024809330,8020,7850,8110,90,1.12,8040,20,0.25,7810,8190
34,حكشتي,كشتيراني جمهوري اسلامي ايران,4006,24298283,326799314630,14090,13390,13390,-700,-4.97,13450,-640,-4.54,13390,13990
35,سيتا,سرمايه گذاري سيمان تامين,3967,6719240,100789740080,15000,15000,15000,0,0,15000,0,0,15000,15010
36,بپيوند,برق و انرژي پيوندگستر پارس,3861,3314789,31134697297,9595,9500,9501,-94,-0.98,9393,-202,-2.11,9121,9680
37,امين يكم,صندوق درآمد ثابت امين يكم فردا,3515,107690812,1080164474241,10027,10033,10033,6,0.06,10030,3,0.03,10028,10033
38,وتوصا,گروه س توسعه صنعتي ايران,3074,24941780,190808586030,7870,7480,7850,-20,-0.25,7650,-220,-2.8,7480,8210
39,وتجارت,بانك تجارت,2894,116258319,222892729440,2017,1917,1917,-100,-4.96,1917,-100,-4.96,1917,1950
40,وغدير,سرمايه‌گذاري‌غدير(هلدينگ‌,2805,19490170,178217212720,8980,8790,9200,220,2.45,9140,160,1.78,8790,9330
41,غگل,گلوكوزان‌,2687,42493376,95851743715,2192,2170,2301,109,4.97,2256,64,2.92,2114,2301
42,وپارس,بانك‌پارسيان‌,2644,99562245,269130363578,2697,2701,2702,5,0.19,2703,6,0.22,2693,2720
43,فارس,صنايع پتروشيمي خليج فارس,2528,20482903,173358274980,8510,8320,8440,-70,-0.82,8460,-50,-0.59,8230,8650
44,وخارزم,سرمايه گذاري خوارزمي,2488,31259274,105380163508,3430,3310,3410,-20,-0.58,3371,-59,-1.72,3283,3420
45,تسه0002,امتيازتسهيلاتمسكن ارديبهشت1400,2414,49088,26435724197,543970,549000,541000,-2970,-0.55,538537,-5433,-1,521126,555000
46,فروس,فروسيليس‌ ايران‌,2318,39464598,169590644313,4464,4241,4402,-62,-1.39,4297,-167,-3.74,4241,4570
47,ولساپا,ليزينگ رايان‌ سايپا,2244,35749762,93885831949,2582,2610,2602,20,0.77,2626,44,1.7,2524,2701
48,شبريز,پالايش نفت تبريز,2163,4956196,113266713540,23100,21960,23030,-70,-0.3,22850,-250,-1.08,21950,24000
49,غپينو,پارس‌ مينو,2116,61516432,350777723730,5910,5900,5620,-290,-4.91,5700,-210,-3.55,5620,5930
50,صبا,سرمايه گذاري صبا تامين,2051,5197714,35426715375,7009,6670,6870,-139,-1.98,6947,-62,-0.88,6670,6990
51,خودرو,ايران‌ خودرو,2044,75980956,124260731362,1674,1610,1650,-24,-1.43,1635,-39,-2.33,1605,1671
52,خفنر,فنرسازي‌خاور,1913,26719602,106121904960,8660,4000,3980,-4680,-54.04,3970,-4690,-54.16,3800,4200
53,اخابر,مخابرات ايران,1872,18250834,128977381960,7070,6800,7200,130,1.84,7070,0,0,6800,7350
54,كيان,صندوق س. با درآمد ثابت كيان,1811,20933577,597632706333,28533,28548,28552,19,0.07,28549,16,0.06,28547,28552
55,پيزد,مجتمع صنايع لاستيك يزد,1742,372117,19025843909,53790,51101,51101,-2689,-5,51129,-2661,-4.95,51101,52330
56,افران,صندوق س افرا نماد پايدار-ثابت,1722,70312863,940511529473,13366,13371,13377,11,0.08,13376,10,0.07,13371,13377
57,خساپا,سايپا,1652,82877604,124671507224,1579,1501,1510,-69,-4.37,1504,-75,-4.75,1501,1528
58,سپيدما,صندوق س. سپيد دماوند-د,1637,90896636,943505614196,10374,10382,10380,6,0.06,10380,6,0.06,10379,10384
59,وبانك,سرمايه گذاري گروه توسعه ملي,1628,12330826,80492622710,6460,6330,6580,120,1.86,6530,70,1.08,6320,6640
60,دكوثر,داروسازي‌ كوثر,1621,18445151,72794293770,6560,4080,3990,-2570,-39.18,3950,-2610,-39.79,3880,4090
61,سرو,صندوق س سروسودمند مدبران-سهام,1621,1889928,105146587530,56030,55450,56060,30,0.05,55640,-390,-0.7,54360,56800
62,فخوز,فولاد  خوزستان,1602,8268791,116598099800,13990,13820,14060,70,0.5,14100,110,0.79,13820,14410
63,فباهنرح,ح . مس‌ شهيدباهنر,1602,8190195,97338460480,12110,11600,12000,-110,-0.91,11880,-230,-1.9,11420,12500
64,اعتماد,صندوق س.اعتماد آفرين پارسيان-د,1590,21396330,782823407350,36571,36586,36589,18,0.05,36587,16,0.04,36585,36590
65,شپلي,پلي اكريل ايران,1573,23924692,216914935512,8890,9067,9067,177,1.99,9067,177,1.99,9000,9067
66,شپترو,پتروشيمي آبادان,1562,27535178,108445831339,4116,3911,3945,-171,-4.15,3938,-178,-4.32,3911,4140
67,ساروم,سيمان‌اروميه‌,1540,6134428,151458748020,35420,25200,24720,-10700,-30.21,24690,-10730,-30.29,23940,26460
68,سيدكو,سرمايه گذاري توسعه صنايع سيمان,1523,17346361,104141397240,5800,5980,5900,100,1.72,6000,200,3.45,5820,6090
69,حفاري,حفاري شمال,1502,12544716,63563390390,5290,5050,5040,-250,-4.73,5070,-220,-4.16,5030,5250
70,وسبحان,سرمايه گذاري سبحان,1475,23405725,52019091329,2197,2155,2226,29,1.32,2222,25,1.14,2150,2272
71,بجهرم,توسعه مولد نيروگاهي جهرم,1453,18133203,33609320530,1853,1775,1890,37,2,1853,0,0,1775,1900
72,نوري,پتروشيمي نوري,1452,1555899,87834723220,56480,54980,56420,-60,-0.11,56450,-30,-0.05,54980,57200
73,كارين,صندوق س نگين سامان-ثابت,1397,66342813,664687072902,10016,10022,10019,3,0.03,10019,3,0.03,10017,10029
74,غسالم,سالمين‌,1397,25192202,73934040808,2944,2797,3091,147,4.99,2935,-9,-0.31,2797,3091
75,ونوين,بانك‌اقتصادنوين‌,1366,22365800,82032652984,3681,3650,3665,-16,-0.43,3668,-13,-0.35,3587,3750
76,فاسمين,كالسيمين‌,1358,5049340,62362004560,12230,11700,12410,180,1.47,12350,120,0.98,11700,12620
77,ساراب,سيمان‌ داراب‌,1305,4180891,84654973200,19370,20010,20330,960,4.96,20250,880,4.54,20000,20330
78,كچاد,معدني‌وصنعتي‌چادرملو,1290,4880736,106755771100,21760,20830,21970,210,0.97,21860,100,0.46,20830,22500
79,وساپا,سرمايه‌گذاري‌ سايپا,1281,12302190,49630686933,4029,3890,4066,37,0.92,4034,5,0.12,3890,4130
80,ومعادنح,ح . توسعه‌معادن‌وفلزات‌,1262,9414722,51346724620,5450,5260,5450,0,0,5450,0,0,5260,5700
81,آگاس,صندوق س.هستي بخش آگاه-س,1247,1246533,74470981840,59963,58810,60150,187,0.31,59742,-221,-0.37,58800,60700
82,سفارس,سيمان فارس و خوزستان,1242,4534039,64770498060,14090,14520,14320,230,1.63,14290,200,1.42,14030,14570
83,ورنا,سرمايه‌گذاري‌ رنا(هلدينگ‌,1202,11432491,46181388646,4054,3910,4070,16,0.39,4039,-15,-0.37,3910,4141
84,پارند,صندوق س. پارند پايدار سپهر,1201,45891487,517204669371,11264,11275,11275,11,0.1,11270,6,0.05,11269,11275
85,وپست,پست بانك ايران,1187,4758141,89431522640,18660,17760,19090,430,2.3,18800,140,0.75,17730,19590
86,سهگمت,سيمان‌هگمتان‌,1173,3927783,71183452710,18950,18020,18030,-920,-4.85,18120,-830,-4.38,18010,18800
87,ومعادن,توسعه‌معادن‌وفلزات‌,1169,11689886,87878906210,7590,7310,7570,-20,-0.26,7530,-60,-0.79,7310,7680
88,وسينا,بانك سينا,1164,29401310,64291255524,2187,2078,2216,29,1.33,2187,0,0,2078,2281
89,گشان,توسعه بين المللي پديده شانديز,1147,4447801,97258287765,22764,21854,21854,-910,-4,21867,-897,-3.94,21854,22300
90,شغدير,پتروشيمي غدير,1106,2784752,179797283890,62250,61560,65360,3110,5,64560,2310,3.71,61560,65360
91,غمارگ,مارگارين‌,1087,7631062,134638928040,18500,17580,17870,-630,-3.41,17640,-860,-4.65,17580,18460
92,سشرق,سيمان‌ شرق‌,1039,9641222,48502247550,5000,5060,5100,100,2,5030,30,0.6,4810,5140
93,وملل,اعتباري ملل,991,39787793,497355988113,12499,12500,12500,1,0.01,12500,1,0.01,12500,12524
94,تاپيكو,س. نفت و گاز و پتروشيمي تأمين,990,7000006,67137892470,9760,9300,9590,-170,-1.74,9660,-100,-1.02,9300,9800
95,كاوه,فولاد كاوه جنوب كيش,985,4972932,85207703810,17410,17040,17000,-410,-2.35,17150,-260,-1.49,16690,17970
96,وخارزمح,ح.سرمايه گذاري خوارزمي,964,5571030,12093455725,2210,2060,2192,-18,-0.81,2171,-39,-1.76,2060,2240
97,شيران,س. صنايع‌شيميايي‌ايران,964,3418993,61952086080,18470,17700,18150,-320,-1.73,18160,-310,-1.68,17700,18850
98,خكرمان,گروه اقتصادي كرمان خودرو,948,21514676,62184459672,3038,2887,2888,-150,-4.94,2890,-148,-4.87,2887,2990
99,شفن,پتروشيمي فناوران,905,233406,63886126890,282330,271500,276000,-6330,-2.24,276270,-6060,-2.15,268230,282000
100,شپديس,پتروشيمي پرديس,894,753282,69467228840,92620,91570,91640,-980,-1.06,92330,-290,-0.31,91410,93990
101,خصدرا,صنعتي‌ دريايي‌ ايران‌,880,34639297,71859104802,2137,2073,2073,-64,-2.99,2074,-63,-2.95,2073,2100
102,وشهر,بانك شهر,877,11984986,60148803881,4992,5000,5049,57,1.14,5019,27,0.54,4995,5179
103,شاراك,پتروشيمي شازند,871,3779726,93273220360,24970,24810,24400,-570,-2.28,24680,-290,-1.16,24110,25000
104,فباهنر,مس‌ شهيدباهنر,867,2135306,41210100090,20160,19160,19270,-890,-4.41,19300,-860,-4.27,19160,19990
105,زاگرس,پتروشيمي زاگرس,844,305441,60071682231,194710,191999,197899,3189,1.64,195931,1221,0.63,188500,204445
106,آسيا,بيمه آسيا,825,14791454,24320877290,1655,1590,1643,-12,-0.73,1644,-11,-0.66,1581,1693
107,ما,بيمه  ما,818,7274738,65925706940,9100,9100,8950,-150,-1.65,9060,-40,-0.44,8820,9200
108,تسه0001,امتيازتسهيلات مسكن فروردين1400,818,12916,7047915539,570958,543452,542411,-28547,-5,545673,-25285,-4.43,542411,599505
109,سصوفي,سيمان‌ صوفيان‌,806,4077784,46320482780,11460,11800,11230,-230,-2.01,11360,-100,-0.87,11210,11800
110,تنوين,تامين سرمايه نوين,796,21105893,155676182020,7390,7400,7300,-90,-1.22,7380,-10,-0.14,7200,7480
111,كگل,معدني و صنعتي گل گهر,776,4925454,65174866610,13340,12830,13100,-240,-1.8,13280,-60,-0.45,12750,13700
112,همراه,شركت ارتباطات سيار ايران,737,1863035,34514870350,20030,18300,18750,-1280,-6.39,19410,-620,-3.1,18300,19000
113,شبهرن,نفت‌ بهران‌,731,4029134,40647722060,10510,9990,10010,-500,-4.76,10150,-360,-3.43,9990,10430
114,رانفور,خدمات‌انفورماتيك‌,699,7863190,46776190480,6000,5700,6050,50,0.83,5960,-40,-0.67,5700,6050
115,وصنعت,سرمايه گذاري توسعه صنعت وتجارت,687,4434887,22414947330,5010,4910,5130,120,2.4,5050,40,0.8,4790,5140
116,سرچشمه,سرمايه گذاري مس سرچشمه,686,3352724,21284439617,6197,6180,6380,183,2.95,6348,151,2.44,6180,6450
117,آوا,صندوق س.سهام آواي معيار-س,686,4585974,28502239841,6226,6200,6200,-26,-0.42,6215,-11,-0.18,6110,6320
118,پكرمان,گروه‌ صنعتي‌ بارز,666,2718175,57925849070,20990,19960,21110,120,0.57,21310,320,1.52,19960,22030
119,دابور,داروسازي‌ ابوريحان‌,659,1252937,31144163050,23790,23110,24970,1180,4.96,24860,1070,4.5,23110,24970
120,البرز,بيمه البرز,656,8413216,28201163920,3354,3300,3369,15,0.45,3352,-2,-0.06,3300,3410
121,شتوكا,توكا رنگ فولاد سپاهان,651,1630108,42214580366,24764,26001,26002,1238,5,25897,1133,4.58,25001,26002
122,فنورد,نوردوقطعات‌ فولادي‌,637,236928,35142354310,151070,147320,148500,-2570,-1.7,148330,-2740,-1.81,143600,155000
123,تسه9912,امتياز تسهيلات مسكن اسفند99,635,10604,5826856165,571916,575000,543321,-28595,-5,549496,-22420,-3.92,543321,575000
124,والبر,سرمايه‌ گذاري‌ البرز(هلدينگ‌,608,4126607,46256518980,11780,11200,11200,-580,-4.92,11210,-570,-4.84,11200,11400
125,سمازن,سيمان‌مازندران‌,602,5505944,58626514050,10160,10590,10660,500,4.92,10650,490,4.82,10210,10660
126,ومهان,گروه توسعه مالي مهر آيندگان,601,2251796,25858104247,11614,11200,11540,-74,-0.64,11540,-74,-0.64,11200,11800
127,سبهان,سيمان‌ بهبهان‌,600,850440,70413358250,135430,85000,80750,-54680,-40.38,82800,-52630,-38.86,80750,85000
128,پاكشو,گروه صنعتي پاكشو,596,9585918,56553711580,6090,5790,6000,-90,-1.48,5990,-100,-1.64,5790,6090
129,شسپا,نفت سپاهان,594,1832884,25581285850,14180,13540,13980,-200,-1.41,14070,-110,-0.78,13540,14300
130,جوين,كشت و صنعت جوين,593,9617520,45613612722,4777,4778,4751,-26,-0.54,4743,-34,-0.71,4634,4800
131,بموتو,موتوژن‌,592,913995,38873664050,42310,40310,43600,1290,3.05,42530,220,0.52,40310,44190
132,حتايد,تايدواترخاورميانه,589,4359254,90544022510,21690,20610,21000,-690,-3.18,20770,-920,-4.24,20610,22000
133,بگيلان,توسعه مسير برق گيلان,589,284920,5136539094,18976,18028,18028,-948,-5,18819,-157,-0.83,18028,18029
134,تملت,تامين سرمايه بانك ملت,577,7481591,33684568020,4650,4640,4420,-230,-4.95,4500,-150,-3.23,4420,4640
135,سپاها,سيمان‌سپاهان‌,577,4042485,25900068530,6340,6480,6480,140,2.21,6410,70,1.1,6160,6550
136,كگلح,ح . معدني و صنعتي گل گهر,575,1988574,20333238160,10170,10040,10270,100,0.98,10230,60,0.59,10010,10460
137,فسپا,گروه‌صنعتي‌سپاهان‌,573,1181003,36716066020,30910,30200,31490,580,1.88,31090,180,0.58,30170,32000
138,وسكاب,س.ص.بازنشستگي كاركنان بانكها,572,3569283,15384400681,4354,4380,4336,-18,-0.41,4310,-44,-1.01,4240,4400
139,افق,فروشگاههاي زنجيره اي افق كوروش,569,369712,23529894780,64780,63200,64150,-630,-0.97,64430,-350,-0.54,63000,64770
140,طلا,صندوق س.پشتوانه طلاي لوتوس,560,559790,41292642077,72286,73912,74099,1813,2.51,73765,1479,2.05,73060,74197
141,ارزش,صندوق س ارزش آفرين بيدار-سهام,555,2726058,21955589090,8120,8000,8130,10,0.12,8050,-70,-0.86,7930,8160
142,سخزر,سيمان‌ خزر,555,2294799,39648383300,16310,16890,17730,1420,8.71,17280,970,5.95,16330,17730
143,تاصيكو,سرمايه گذاري صدرتامين,547,4560793,41946347870,9660,9180,9180,-480,-4.97,9490,-170,-1.76,9180,9370
144,كروي,توسعه‌ معادن‌ روي‌ ايران‌,547,1934128,36305704260,19720,18740,18850,-870,-4.41,18770,-950,-4.82,18740,19350
145,شبصير,توليدات پتروشيمي قائد بصير,537,728400,49848768334,68583,65320,69700,1117,1.63,68436,-147,-0.21,65320,71000
146,آكورد,صندوق س. آرمان آتي كوثر-د,535,12524723,403704640390,32216,32232,32232,16,0.05,32233,17,0.05,32232,32237
147,پارسان,گسترش نفت و گاز پارسيان,530,6490484,110247936660,17500,16630,17300,-200,-1.14,17000,-500,-2.86,16630,17410
148,مدير,ص.س.مديريت ثروت ص.بازنشستگي-س,527,2068042,15008392839,7335,7150,7310,-25,-0.34,7257,-78,-1.06,7150,7386
149,سبجنو,سيمان‌ بجنورد,519,1113411,38118801990,42510,34000,34300,-8210,-19.31,34240,-8270,-19.45,33000,35690
150,لوتوس,تامين سرمايه لوتوس پارسيان,514,6622332,41631827600,6320,6040,6500,180,2.85,6290,-30,-0.47,6020,6600
151,غبشهر,صنعتي‌ بهشهر,512,2058611,36605977580,18620,17690,17690,-930,-4.99,17780,-840,-4.51,17690,18600
152,زگلدشتح,ح.كشت و دام گلدشت نمونه اصفهان,497,2975316,16539419044,5342,5130,5609,267,5,5559,217,4.06,5130,5609
153,دعبيد,لابراتوارداروسازي‌  دكترعبيدي‌,492,662507,15855735480,24900,24180,23880,-1020,-4.1,24540,-360,-1.45,23660,24960
154,ولملت,واسپاري ملت,489,4359364,20939242740,5030,4780,4780,-250,-4.97,4800,-230,-4.57,4780,5000
155,فايرا,آلومينيوم‌ايران‌,482,3361099,56411964620,17490,16620,16620,-870,-4.97,16870,-620,-3.54,16620,17250
156,وصنا,گروه‌صنايع‌بهشهرايران‌,474,3174929,13254313469,4317,4111,4279,-38,-0.88,4179,-138,-3.2,4102,4350
157,ياقوت,صندوق س ياقوت آگاه-ثابت,470,2961220,36609131796,12370,12369,12362,-8,-0.06,12363,-7,-0.06,12362,12371
158,كنور,توسعه معدني و صنعتي صبانور,470,844348,40908237540,48310,45910,47990,-320,-0.66,48410,100,0.21,45910,49240
159,وگردش,بانك گردشگري,467,1313318,19682157726,15049,14606,15070,21,0.14,15035,-14,-0.09,14606,15130
160,وثنو,سرمايه گذاري ساختماني نوين,462,6761618,27020540508,3907,3790,4024,117,2.99,3996,89,2.28,3790,4024
161,تسه9908,امتياز تسهيلات مسكن آبان99,461,11820,6410946194,564731,592967,549000,-15731,-2.79,542381,-22350,-3.96,536495,592967
162,فزرين,زرين معدن آسيا,457,11332497,248953240800,26510,22000,20900,-5610,-21.16,21968,-4542,-17.13,20900,22000
163,فردا,صندوق س آواي فرداي زاگرس-ثابت,456,20045930,215291232559,10734,10740,10741,7,0.07,10740,6,0.06,10738,10743
164,ونفت,سرمايه‌گذاري‌ صنعت‌ نفت‌,454,2611067,32310347570,12960,12340,12320,-640,-4.94,12370,-590,-4.55,12320,12910
165,ثمسكن,سرمايه‌گذاري‌ مسكن‌,452,2986160,11471626910,3796,3700,3821,25,0.66,3832,36,0.95,3700,3940
166,سپ,پرداخت الكترونيك سامان كيش,450,722540,17340121040,23510,23010,24020,510,2.17,23690,180,0.77,23010,24500
167,وتوس,توسعه‌شهري‌توس‌گستر,441,2567071,35313267810,14320,13800,13750,-570,-3.98,13760,-560,-3.91,13690,14260
168,هرمز,فولاد هرمزگان جنوب,436,1805429,26369577912,14602,14010,14770,168,1.15,14603,1,0.01,14010,14990
169,گوهران,سرمايه گذاري توسعه گوهران اميد,432,1165135,8055957681,6948,6792,6899,-49,-0.71,6930,-18,-0.26,6792,7035
170,وتوسم,سرمايه‌گذاري‌توسعه‌ملي‌,429,3113336,20202322000,6250,6350,6560,310,4.96,6490,240,3.84,6270,6560
171,خراسان,پتروشيمي خراسان,429,300557,18860820220,64940,62200,62120,-2820,-4.34,64020,-920,-1.42,61710,64990
172,وارس,سرمايه گذاري ارس صبا,426,2342975,30434474777,13623,12942,12942,-681,-5,12990,-633,-4.65,12942,13600
173,رمپنا,گروه مپنا (سهامي عام),411,5587946,68055309460,12770,12140,12140,-630,-4.93,12400,-370,-2.9,12140,12810
174,زر,صندوق س.پشتوانه سكه طلاي زر,407,432870,19109434890,42367,43475,44200,1833,4.33,44146,1779,4.2,42936,44970
175,واتي,سرمايه‌ گذاري‌ آتيه‌ دماوند,405,3224471,26975996570,8680,8880,8490,-190,-2.19,8370,-310,-3.57,8250,8880
176,شرنگي,شيميايي رنگين,397,111532,29608461512,257964,265702,265702,7738,3,265471,7507,2.91,262000,265702
177,ضجار7038,اختيارخ وتجارت-1800-1400/07/21,388,22086,5269040000,324,250,230,-94,-29.01,239,-85,-26.23,225,250
178,وسلرستا,شركت س استان لرستان,368,25249797,17245611351,718,683,683,-35,-4.87,694,-24,-3.34,683,683
179,تيپيكو,سرمايه گذاري دارويي تامين,367,373329,12766912240,33550,33720,34360,810,2.41,33690,140,0.42,33560,34480
180,فنوال,نورد آلومينيوم‌,358,1055672,24331751610,24210,23000,23000,-1210,-5,23050,-1160,-4.79,23000,23990
181,وبيمه,سرمايه‌ گذاري‌ صنعت‌ بيمه‌,356,52080111,116763608862,2360,2242,2242,-118,-5,2242,-118,-5,2242,2242
182,سشمال,سيمان‌ شمال‌,353,1690922,13901326040,8570,8650,8150,-420,-4.9,8220,-350,-4.08,8150,8740
183,شيراز,پتروشيمي‌شيراز,351,761292,36862298250,50040,48010,49090,-950,-1.9,49420,-620,-1.24,47540,50200
184,قشرين,قند شيرين خراسان,342,1212092,13054082666,10545,10260,10861,316,3,10770,225,2.13,10260,10861
185,شاوان,پالايش نفت لاوان,337,301458,20841000318,72258,69000,69169,-3089,-4.27,70199,-2059,-2.85,68646,71000
186,تسه9911,امتياز تسهيلات مسكن بهمن99,328,3607,1972711645,574023,556009,545322,-28701,-5,546912,-27111,-4.72,545322,557630
187,دكپسول,توليد ژلاتين كپسول ايران,328,407916,10983829018,28276,26863,26863,-1413,-5,27176,-1100,-3.89,26863,28000
188,فولاژ,فولاد آلياژي ايران,327,1174716,16309535710,14290,13590,13950,-340,-2.38,14190,-100,-0.7,13580,14800
189,شنفت,نفت‌ پارس‌,320,814730,35428375590,45380,44530,44500,-880,-1.94,43840,-1540,-3.39,43120,47600
190,بترانس,ايران‌ ترانسفو,312,5313529,11408146763,2259,2147,2147,-112,-4.96,2218,-41,-1.81,2147,2147
191,پرديس,سرمايه گذاري پرديس,308,1331950,5518532806,4201,4070,4173,-28,-0.67,4177,-24,-0.57,4010,4293
192,شخارك,پتروشيمي‌ خارك‌,305,524926,21528694630,41820,39740,40790,-1030,-2.46,41640,-180,-0.43,39740,41810
193,تصميم,صندوق س با درآمد ثابت تصميم,304,1416534,23221052277,16389,16393,16393,4,0.02,16393,4,0.02,16391,16395
194,سكه0012پ01,سكه تمام بهارتحويلي 1روزه رفاه,295,107100,109365264900,1008603,1015502,1018100,9497,0.94,1021151,12548,1.24,1015502,1022499
195,شرانل,نفت ايرانول,293,432872,16645395233,39068,38900,38301,-767,-1.96,38735,-333,-0.85,37500,39400
196,كرماشا,صنايع پتروشيمي كرمانشاه,291,645670,18859581790,30180,28680,29260,-920,-3.05,29740,-440,-1.46,28680,30600
197,اطلس,صندوق س.توسعه اندوخته آينده-س,286,291390,54504283145,188054,186025,187300,-754,-0.4,187049,-1005,-0.53,185501,188995
198,كاردان,صندوق س تجارت شاخصي كاردان,282,58852,7901254320,135600,134990,134080,-1520,-1.12,134260,-1340,-0.99,132000,136500
199,واعتبار,سرمايه گذاري اعتبار ايران,277,3915705,32311559070,8680,8250,8250,-430,-4.95,8250,-430,-4.95,8250,8580
200,وصندوق,سرمايه‌گذاري‌صندوق‌بازنشستگي‌,275,1629914,21014844960,13400,12730,12730,-670,-5,13300,-100,-0.75,12730,13400
201,گوهر,صندوق سكه طلاي كيان,275,565382,28794273191,49499,50500,50901,1402,2.83,50929,1430,2.89,50201,51530
202,مبين,مبين انرژي خليج فارس,269,1818602,27146230630,15220,14560,14800,-420,-2.76,15150,-70,-0.46,14480,15980
203,تسه9910,امتياز تسهيلات مسكن دي99,267,3204,1762085870,574548,545821,546000,-28548,-4.97,549964,-24584,-4.28,545821,579996
204,جم پيلن,پلي پروپيلن جم - جم پيلن,266,274610,17640171910,64350,64200,64020,-330,-0.51,64310,-40,-0.06,62710,66000
205,حسينا,توسعه خدمات دريايي وبندري سينا,263,342864,17652626597,50647,48844,52860,2213,4.37,51486,839,1.66,48844,53041
206,كاما,باما,262,1482658,13284615680,9430,8960,8960,-470,-4.98,9260,-170,-1.8,8960,8960
207,واحيا,م .صنايع و معادن احياء سپاهان,262,1023557,145995366127,143384,139500,141100,-2284,-1.59,142635,-749,-0.52,139260,145000
208,وبشهر,توسعه‌ صنايع‌ بهشهر(هلدينگ,256,2611871,23348021830,9080,8720,9170,90,0.99,8970,-110,-1.21,8640,9200
209,فپنتا,سپنتا,254,29648,9189485520,316900,301090,311500,-5400,-1.7,312110,-4790,-1.51,301090,320800
210,آساميد2,صندوق س.مشترك آسمان اميد -د,248,24800000,24800000,12059,1,1,-12058,-99.99,1,-12058,-99.99,1,1
211,آساس,صندوق س.آسمان آرماني سهام-س,248,153378,22153440312,147446,145501,144700,-2746,-1.86,144437,-3009,-2.04,143000,147990
212,وسپه,سرمايه‌گذاري‌ سپه‌,246,1246177,7372275080,5980,5830,5880,-100,-1.67,5960,-20,-0.33,5830,6000
213,عيار,صندوق س. پشتوانه طلاي مفيد,245,270347,7035084413,25447,25990,26005,558,2.19,26022,575,2.26,25645,26288
214,وسگيلا,شركت س استان گيلان,234,20198636,12765569382,665,632,632,-33,-4.96,654,-11,-1.65,632,634
215,تسه9909,امتياز تسهيلات مسكن آذر99,230,3111,1699975955,573500,544955,544825,-28675,-5,546440,-27060,-4.72,544825,559700
216,پارس,پتروشيمي پارس,222,200834,28646093750,144410,140610,143000,-1410,-0.98,143890,-520,-0.36,140440,144600
217,سكرما,سيمان‌ كرمان‌,220,684404,8440792320,12600,13000,12030,-570,-4.52,12440,-160,-1.27,12010,13000
218,ثشاهد,سرمايه‌ گذاري‌ شاهد,218,354763,5459802570,17090,15390,15390,-1700,-9.95,16710,-380,-2.22,15390,15390
219,كاريس,صندوق س.سپهر كاريزما-س,215,3800329,38378163230,10115,10110,10060,-55,-0.54,10099,-16,-0.16,10020,10150
220,تسه9803,امتياز تسهيلات مسكن خرداد98,213,3479,1809553049,536418,514010,524500,-11918,-2.22,520136,-16282,-3.04,509598,530000
221,جم,پتروشيمي جم,213,386000,12998490730,33780,32610,33400,-380,-1.12,33770,-10,-0.03,32610,34000
222,پارسيان,بيمه پارسيان,199,1271891,9005992900,7290,6940,7060,-230,-3.16,7160,-130,-1.78,6940,7280
223,خزاميا,زامياد,195,2718044,17449842480,6750,6420,6420,-330,-4.89,6420,-330,-4.89,6420,6420
224,رتاپ,تجارت الكترونيك  پارسيان,195,1254325,6986916490,5860,5570,5570,-290,-4.95,5710,-150,-2.56,5570,5680
225,پارتا,مجتمع‌صنعتي‌آرتاويل‌تاير,192,538367,17966383524,32400,33372,33372,972,3,32994,594,1.83,33372,33372
226,وكار,بانك‌ كارآفرين‌,183,2033402,5410095163,2761,2623,2650,-111,-4.02,2748,-13,-0.47,2623,2750
227,شپاكسا,پاكسان‌,181,309948,5882753570,19340,19030,18880,-460,-2.38,19180,-160,-0.83,18420,19980
228,سكه0012پ04,سكه تمام بهارتحويلي1روز صادرات,176,134800,137533809400,1008087,1020000,1020009,11922,1.18,1020280,12193,1.21,1018500,1026000
229,وپترو,سرمايه‌گذاري صنايع پتروشيمي‌,174,1799694,18431875310,10770,10240,10240,-530,-4.92,10240,-530,-4.92,10240,10400
230,اخزا910,اسنادخزانه-م10بودجه99-020807,171,222225,135019067900,605957,608499,608998,3041,0.5,607578,1621,0.27,606508,609782
231,سپر,صندوق س سپر سرمايه بيدار- ثابت,169,6038856,71548377903,11844,11848,11849,5,0.04,11848,4,0.03,11848,11851
232,ماديرا,صنايع ماشين هاي اداري ايران,167,2825887,17955685998,6688,6354,6354,-334,-4.99,6400,-288,-4.31,6354,6354
233,تسه9907,امتياز تسهيلات مسكن مهر99,166,2320,1258500508,567149,539411,538792,-28357,-5,542457,-24692,-4.35,538792,553440
234,شلرد,كود شيميايي اوره لردگان,160,1248835,7117110665,5875,5699,5699,-176,-3,5814,-61,-1.04,5699,5699
235,وحكمت,بيمه حكمت صبا,152,2708287,7545520164,2872,2786,2786,-86,-2.99,2803,-69,-2.4,2786,2849
236,تماوند,تامين سرمايه دماوند,151,573471,2783729344,4927,4780,4928,1,0.02,4912,-15,-0.3,4780,5000
237,وخاور,بانك خاورميانه,149,3435576,28412001590,8270,8200,8270,0,0,8270,0,0,8200,8330
238,وبوعلي,سرمايه‌گذاري‌بوعلي‌,148,1117646,3737408224,3519,3344,3344,-175,-4.97,3470,-49,-1.39,3344,3344
239,وتعاون,بيمه  تعاون,147,5001632,30534963360,6293,6105,6105,-188,-2.99,6105,-188,-2.99,6105,6105
240,سحرخيز,صندوق س. گروه زعفران سحرخيز,144,212703,1735347489,8129,8050,8220,91,1.12,8159,30,0.37,8011,8232
241,اوصتا,صندوق انديشه ورزان صباتامين -د,140,1619037,30280455717,18699,18700,18701,2,0.01,18703,4,0.02,18700,18710
242,ضشنا8001,اختيارخ شپنا-8000-1400/08/16,136,2525,4411739000,1663,1850,1950,287,17.26,1747,84,5.05,1650,2200
243,شراز,پالايش نفت شيراز,136,62406,6038990331,101562,96484,96484,-5078,-5,100834,-728,-0.72,96484,98000
244,آريان,سرمايه گذاري پارس آريان,135,2521928,25602613056,10465,10152,10152,-313,-2.99,10365,-100,-0.96,10152,10152
245,خمحور,توليدمحورخودرو,134,362401,20120693190,56810,56000,53200,-3610,-6.35,55520,-1290,-2.27,53200,56000
246,شوينده,مديريت صنعت شوينده ت.ص.بهشهر,133,348137,6452693760,18940,19000,18500,-440,-2.32,18740,-200,-1.06,18090,19000
247,بفجر,فجر انرژي خليج فارس,133,265891,5576947510,21250,20710,21000,-250,-1.18,21220,-30,-0.14,20660,21400
248,مارون,پتروشيمي مارون,131,106078,15037760532,145273,138010,140110,-5163,-3.55,144729,-544,-0.37,138010,145280
249,شلعابح,ح . لعابيران‌,129,1727732,9026839910,5450,5900,5170,-280,-5.14,5220,-230,-4.22,5170,5900
250,سيستم,همكاران سيستم,127,542661,10684012300,20710,20000,19680,-1030,-4.97,19930,-780,-3.77,19680,20110
251,سفانو,سيمان فارس نو,127,896313,25450439030,32080,29500,28030,-4050,-12.62,28390,-3690,-11.5,28030,29510
252,فخاس,فولاد خراسان,125,586418,13466461030,24100,22900,22900,-1200,-4.98,23940,-160,-0.66,22900,24080
253,ضپاس7029,اختيارخ وپارس-2500-1400/07/28,125,6311,2242576000,356,325,355,-1,-0.28,355,-1,-0.28,323,390
254,نهال,صندوق س. طلاي سرخ نوويرا,123,135067,1151556399,8558,8400,8525,-33,-0.39,8526,-32,-0.37,8400,8605
255,تسه9810,امتياز تسهيلات مسكن دي98,123,2121,1143879295,562321,534205,534300,-28021,-4.98,539311,-23010,-4.09,534205,569299
256,سپاس,صندوق س. پاداش سهامداري توسعه1,120,2705358,27337276276,10100,10105,10104,4,0.04,10105,5,0.05,10104,10108
257,اخزا902,اسنادخزانه-م2بودجه99-011019,119,273572,197519982646,718056,725000,722900,4844,0.67,722004,3948,0.55,714955,725000
258,وپاسار,بانك  پاسارگاد,118,408802,6397751300,16470,15650,15650,-820,-4.98,16420,-50,-0.3,15650,15650
259,فيروزا,صندوق بادرآمد ثابت فيروزه آسيا,117,4734083,108417092680,22902,22915,22900,-2,-0.01,22901,-1,0,22851,22929
260,ارمغان,ص سرمايه گذاري ارمغان ايرانيان,116,1802381,18225123740,10104,10104,10110,6,0.06,10112,8,0.08,10104,10133
261,تماوندح,ح . تامين سرمايه دماوند,114,1605564,4823390264,3096,3004,3004,-92,-2.97,3004,-92,-2.97,3004,3050
262,سرود,سيمان‌شاهرود,114,360451,5746600410,15770,16330,15920,150,0.95,15840,70,0.44,15770,16330
263,ضپال2007,اختيارخ اپال-32000-1401/02/12,113,7058,376675000,52,50,55,3,5.77,53,1,1.92,48,80
264,تسه9904,امتياز تسهيلات مسكن تير99,112,1028,561150283,571992,547385,543393,-28599,-5,545866,-26126,-4.57,543393,555000
265,تسه9902,امتياز تسهيلات مسكن ارديبهشت99,111,1339,730716717,568900,545000,540455,-28445,-5,545718,-23182,-4.07,540455,560000
266,شصفها,پتروشيمي‌ اصفهان‌,111,181915,21403473150,118237,115873,120000,1763,1.49,117656,-581,-0.49,115873,120000
267,ضصاد8030,اختيارخ وبصادر-1600-1400/08/12,103,3082,748240000,390,275,230,-160,-41.03,243,-147,-37.69,228,280
268,دلر,داروسازي‌ اكسير,102,438875,12666071980,30370,28860,28860,-1510,-4.97,29000,-1370,-4.51,28860,29240
269,دمعيار,صندوق س. توازن معيار-د,101,3436746,34419054126,10009,10018,10014,5,0.05,10015,6,0.06,10014,10020
270,كيان2,صندوق س. با درآمد ثابت كيان,100,10000000,10000000,28533,1,1,-28532,-100,1,-28532,-100,1,1
271,فيروزه,صندوق شاخص30 شركت فيروزه- سهام,100,21762,2620699330,122000,120300,120220,-1780,-1.46,120430,-1570,-1.29,119560,122500
272,بساما,بيمه سامان,97,691757,12683364595,19300,18335,18335,-965,-5,18488,-812,-4.21,18335,18335
273,زعف0008پ20,زعفران0008نگين وحدت جام(پ),93,24941,2956955737,118586,115600,118500,-86,-0.07,118558,-28,-0.02,115600,119998
274,تسه9906,امتياز تسهيلات مسكن شهريور99,93,1434,818628758,586262,557025,556949,-29313,-5,570871,-15391,-2.63,556949,615574
275,فردا2,صندوق س آواي فرداي زاگرس-ثابت,90,9000000,9000000,10734,1,1,-10733,-99.99,1,-10733,-99.99,1,1
276,ضملي7002,اختيارخ فملي-10000-1400/07/11,90,573,1421414000,2422,2422,2500,78,3.22,2481,59,2.44,2350,2798
277,كوير,توليدي فولاد سپيد فراب كوير,88,1714161,23261164770,14280,13570,13570,-710,-4.97,14000,-280,-1.96,13570,13570
278,خاور,ايران خودرو ديزل,88,3284025,13139384025,4124,4001,4001,-123,-2.98,4001,-123,-2.98,4001,4001
279,مداران,داده‌پردازي‌ايران‌,88,757027,14375942730,19980,18990,18990,-990,-4.95,18990,-990,-4.95,18990,18990
280,لبوتان,گروه‌صنعتي‌بوتان‌,87,113148,5571873080,51830,51940,49340,-2490,-4.8,50790,-1040,-2.01,49240,51940
281,سمتاز,سيمان ممتازان كرمان,86,451452,9889318307,22161,21497,21511,-650,-2.93,21906,-255,-1.15,21497,22050
282,ضشنا8002,اختيارخ شپنا-9000-1400/08/16,83,1713,2254372000,1222,1500,1350,128,10.47,1316,94,7.69,1220,1600
283,تسه9903,امتياز تسهيلات مسكن خرداد99,81,1145,648746871,577247,548385,548385,-28862,-5,566591,-10656,-1.85,548385,606109
284,ضصاد3001,اختيارخ وبصادر-2000-1400/03/12,78,4758,51545000,33,29,10,-23,-69.7,11,-22,-66.67,10,29
285,غگرجي,بيسكويت‌  گرجي‌,78,1014799,12492175690,12950,12310,12310,-640,-4.94,12330,-620,-4.79,12310,12310
286,زپارس,ملي كشت و صنعت و دامپروري پارس,77,226034,25238427460,117500,111640,111630,-5870,-5,111660,-5840,-4.97,111630,116650
287,اخزا911,اسنادخزانه-م11بودجه99-020906,76,322551,192821901311,597003,597000,596712,-291,-0.05,597803,800,0.13,596699,600000
288,تسه9905,امتياز تسهيلات مسكن مرداد99,75,743,419471131,579861,550868,550868,-28993,-5,564564,-15297,-2.64,550868,608853
289,بپاس,بيمه پاسارگاد,74,41997,3950279817,99011,94061,94061,-4950,-5,98812,-199,-0.2,94061,94061
290,ثبهساز,بهساز كاشانه تهران,74,523498,950148870,1910,1815,1815,-95,-4.97,1904,-6,-0.31,1815,1815
291,اخزا908,اسنادخزانه-م8بودجه99-020606,73,229515,144394728267,628508,625019,628509,1,0,629130,622,0.1,624890,632000
292,كخاك,صنايع‌خاك‌چيني‌ايران‌,71,209044,6833109410,34370,32660,32660,-1710,-4.98,33780,-590,-1.72,32660,33650
293,ضخود7074,اختيارخ خودرو-1800-1400/07/07,71,2214,369656000,176,150,165,-11,-6.25,167,-9,-5.11,150,176
294,وساخت,سرمايه‌ گذاري‌ ساختمان‌ايران‌,70,59936,2202648000,38680,36750,36750,-1930,-4.99,38410,-270,-0.7,36750,36750
295,وسهمدا,شركت س استان همدان,70,3944662,3108393656,829,788,788,-41,-4.95,825,-4,-0.48,788,788
296,آساميد,صندوق س.مشترك آسمان اميد -د,66,1419513,17125775338,12059,12063,12069,10,0.08,12065,6,0.05,12063,12070
297,اخزا909,اسنادخزانه-م9بودجه99-020316,64,156491,103194619035,659098,661502,657910,-1188,-0.18,659428,330,0.05,657910,663000
298,اخزا903,اسنادخزانه-م3بودجه99-011110,62,278321,198798952338,710259,714690,715399,5140,0.72,714279,4020,0.57,700800,715399
299,فسازان,غلتك سازان سپاهان,61,1149417,33310104660,30500,28980,28980,-1520,-4.98,28980,-1520,-4.98,28980,28980
300,دارا2,صندوق س. دارا الگوريتم-د,60,6000000,6000000,9975,1,1,-9974,-99.99,1,-9974,-99.99,1,1
301,زعف0008پ10,زعفران0008نگين طلاي سرخ(پ),60,22289,2667171909,119721,122100,121000,1279,1.07,119663,-58,-0.05,119000,122110
302,سكه0011پ02,سكه تمام بهارتحويلي 1روزه ملت,60,19500,19881415000,1007912,1021300,1018500,10588,1.05,1019560,11648,1.16,1018133,1021698
303,كماسه,تامين‌ ماسه‌ ريخته‌گري‌,58,102083,2849136530,29370,27910,27910,-1460,-4.97,29070,-300,-1.02,27910,27910
304,اخزا901,اسنادخزانه-م1بودجه99-010621,57,121568,93174567952,766739,763400,771000,4261,0.56,766440,-299,-0.04,763400,772581
305,ضشنا8003,اختيارخ شپنا-10000-1400/08/16,56,1306,1371851000,924,950,1080,156,16.88,1050,126,13.64,900,1150
306,نمرينو,ايران‌ مرينوس‌,55,219967,17958105880,77760,81640,81640,3880,4.99,81640,3880,4.99,81640,81640
307,وبازار,صندوق س شاخصي بازارآشنا,55,566621,4986733270,8880,8880,8800,-80,-0.9,8800,-80,-0.9,8800,8880
308,تسه9809,امتياز تسهيلات مسكن آذر98,55,940,512479911,558778,570000,531000,-27778,-4.97,545191,-13587,-2.43,530851,570000
309,تسه9901,امتياز تسهيلات مسكن فروردين99,55,609,332481066,570733,543001,542197,-28536,-5,545946,-24787,-4.34,542197,570000
310,دارا,صندوق س. دارا الگوريتم-د,54,932904,9306565851,9975,9977,9970,-5,-0.05,9976,1,0.01,9970,9981
311,صايند,صندوق س. گنجينه آينده روشن-د,54,303500,2955020720,9718,9748,9722,4,0.04,9736,18,0.19,9705,9800
312,تسه9812,امتياز تسهيلات مسكن اسفند98,54,440,244297240,584443,555221,555221,-29222,-5,555221,-29222,-5,555221,555221
313,آتيمس,صندوق س.آرمان آتيه درخشان مس-س,54,14436,2370923640,167022,165000,163600,-3422,-2.05,164237,-2785,-1.67,163500,166700
314,افق ملت,صندوق س در سهام افق ملت,54,20795,2431389720,120050,117200,116700,-3350,-2.79,116920,-3130,-2.61,116500,119980
315,خاتم,صندوق س خاتم ايساتيس پويا-ثابت,54,485216,5412413895,11147,11159,11157,10,0.09,11155,8,0.07,11149,11159
316,زعف0008پ16,زعفران0008نگين بيرجند(پ),53,33883,4043659234,118142,115305,118001,-141,-0.12,119342,1200,1.02,115305,120000
317,اخزا914,اسنادخزانه-م14بودجه99-021025,53,76415,44504876919,579849,581998,582120,2271,0.39,582410,2561,0.44,581998,583100
318,ضخود7075,اختيارخ خودرو-2000-1400/07/07,53,2187,291010000,127,128,130,3,2.36,133,6,4.72,110,140
319,اتكاي,بيمه اتكايي ايرانيان,51,141816,2002975203,14866,14123,14123,-743,-5,14800,-66,-0.44,14123,14195
320,كفرا,فراورده‌ هاي‌ نسوزايران‌,50,395570,8152697700,21690,20610,20610,-1080,-4.98,21020,-670,-3.09,20610,20610
321,آكورد2,صندوق س. آرمان آتي كوثر-د,50,5000000,5000000,32216,1,1,-32215,-100,1,-32215,-100,1,1
322,تسه9804,امتياز تسهيلات مسكن تير98,48,613,340395574,570174,549888,545000,-25174,-4.42,555295,-14879,-2.61,545000,562998
323,قشكر,شكرشاهرود,47,124228,417406080,3733,3360,3360,-373,-9.99,3721,-12,-0.32,3360,3360
324,زرين,صندوق س. سهام زرين كوروش-س,46,56181,510263525,9069,8900,9060,-9,-0.1,9082,13,0.14,8900,9270
325,تسه9806,امتياز تسهيلات مسكن شهريور98,46,655,361545149,564072,564998,546072,-18000,-3.19,551977,-12095,-2.14,541030,564998
326,دزهراوي,داروسازي‌زهراوي‌,46,753950,4757424500,6640,6310,6310,-330,-4.97,6530,-110,-1.66,6310,6310
327,تسه9808,امتياز تسهيلات مسكن آبان98,46,540,296090732,555191,560000,550030,-5161,-0.93,548316,-6875,-1.24,527452,560000
328,ختوقا,قطعات‌ اتومبيل‌ ايران‌,45,633845,1221419315,2028,1927,1927,-101,-4.98,2019,-9,-0.44,1927,1927
329,فاراك,ماشين‌ سازي‌ اراك‌,44,294538,617940724,2208,2098,2098,-110,-4.98,2203,-5,-0.23,2098,2098
330,وپويا,سرمايه گذاري پويا,43,319369,1833178060,6042,5740,5740,-302,-5,6003,-39,-0.65,5740,5740
331,فاما,صنعتي‌ آما,43,987004,14193117520,15130,14380,14380,-750,-4.96,14380,-750,-4.96,14380,14380
332,غگيلا,شيرپاستوريزه پگاه گيلان,43,154023,2637027783,18022,17121,17121,-901,-5,17847,-175,-0.97,17121,17121
333,گنجين,صندوق س. گنجينه يكم آويد-د,42,517144,6661160845,12874,12884,12880,6,0.05,12881,7,0.05,12879,12890
334,وبهمن,سرمايه‌گذاري‌بهمن‌,42,218246,2627681840,12670,12040,12040,-630,-4.97,12550,-120,-0.95,12040,12040
335,پخش,پخش البرز,42,246567,6975133863,29777,28289,28289,-1488,-5,29021,-756,-2.54,28289,28289
336,بكهنوج,توليد برق ماهتاب كهنوج,41,311867,471231037,1590,1511,1511,-79,-4.97,1587,-3,-0.19,1511,1511
337,سبزوا,سيمان لار سبزوار,41,314949,967838277,3234,3073,3073,-161,-4.98,3223,-11,-0.34,3073,3073
338,ستران,سيمان‌ تهران‌,41,196713,4148677170,22200,21090,21090,-1110,-5,21890,-310,-1.4,21090,21090
339,وبرق,س.کارکنان صنعت برق زنجان وقزوي,41,167351,6804156958,42797,40658,40658,-2139,-5,41230,-1567,-3.66,40658,40658
340,بورس,بورس اوراق بهادار تهران,40,389916,10917648000,29470,28000,28000,-1470,-4.99,29110,-360,-1.22,28000,28000
341,شصدف,صنعتي دوده فام,39,30113,912815369,31908,30313,30313,-1595,-5,31803,-105,-0.33,30313,30313
342,تسه9805,امتياز تسهيلات مسكن مرداد98,38,643,357155044,568765,594980,551045,-17720,-3.12,555451,-13314,-2.34,540330,594980
343,تسه9807,امتياز تسهيلات مسكن مهر98,38,454,249866878,558757,560000,543500,-15257,-2.73,550368,-8389,-1.5,530821,584000
344,ساروج,بين المللي ساروج بوشهر,38,81385,1369517833,16984,16477,16700,-284,-1.67,16962,-22,-0.13,16475,16970
345,ونيكي,سرمايه‌گذاري‌ ملي‌ايران‌,35,286803,2354652630,8640,8210,8210,-430,-4.98,8620,-20,-0.23,8210,8210
346,اراد41,مرابحه عام دولت4-ش.خ 0006,32,405500,413239613000,999999,1000000,1019999,20000,2,1019087,19088,1.91,1000000,1019999
347,اخزا809,اسنادخزانه-م9بودجه98-000923,32,46540,41574245710,892108,892000,893500,1392,0.16,893301,1193,0.13,892000,895999
348,تسه9811,امتياز تسهيلات مسكن بهمن98,31,339,185791323,576902,548057,548057,-28845,-5,548057,-28845,-5,548057,548057
349,خمحركه,نيرو محركه‌,31,118950,445824600,3945,3748,3748,-197,-4.99,3939,-6,-0.15,3748,3748
350,چخزر,صنايع چوب خزر كاسپين,30,18505,576837860,32812,31172,31172,-1640,-5,32745,-67,-0.2,31172,31172
351,سكه0112پ03,سكه تمام بهارتحويلي1روزه سامان,30,10700,10923996300,1006679,1021800,1019000,12321,1.22,1020934,14255,1.42,1017100,1022700
352,لخزر,پارس‌ خزر,30,1306,226486520,182540,173420,173420,-9120,-5,182390,-150,-0.08,173420,173420
353,ولانا,شركت ليزينگ آريا دانا,29,274748,9646951776,36197,35112,35112,-1085,-3,35116,-1081,-2.99,35112,35112
354,داريك,صندوق س.اعتماد داريك-د,29,636158,6625408567,10591,10597,10410,-181,-1.71,10415,-176,-1.66,10166,10597
355,ضترا8057,اختيارخ شتران-7000-1400/08/09,29,1060,1168840000,1198,500,1160,-38,-3.17,1103,-95,-7.93,500,1460
356,وتوكا,سرمايه‌گذاري‌توكافولاد(هلدينگ,29,95922,779845860,8550,8130,8130,-420,-4.91,8530,-20,-0.23,8130,8130
357,انرژي3,سايراشخاص بورس انرژي,29,4737,1063835460,236400,224580,224580,-11820,-5,236170,-230,-0.1,224580,224580
358,كدما,معدني‌ دماوند,29,4512,354282240,82650,78520,78520,-4130,-5,82550,-100,-0.12,78520,78520
359,ضجار7037,اختيارخ وتجارت-1600-1400/07/21,28,634,244450000,595,250,380,-215,-36.13,386,-209,-35.13,250,550
360,گكوثر,هتل پارسيان كوثر اصفهان,28,278493,546960252,2067,1964,1964,-103,-4.98,2063,-4,-0.19,1964,1964
361,ثعتما,س. ساختماني اعتماد گستر,28,81918,1907051040,24000,23280,23280,-720,-3,23802,-198,-0.83,23280,23280
362,اخزا814,اسنادخزانه-م14بودجه98-010318,28,85961,69812763891,809083,813990,812100,3017,0.37,812145,3062,0.38,812000,814000
363,سپيدما2,صندوق س. سپيد دماوند-د,27,270000000,270000000,10374,1,1,-10373,-99.99,1,-10373,-99.99,1,1
364,بايكا,كارخانجات كابلسازي ‌ايران‌,27,245263,9641043267,40524,39309,39309,-1215,-3,39309,-1215,-3,39309,39309
365,وهور,مديريت انرژي اميد  تابان هور,26,397375,752628250,1993,1894,1894,-99,-4.97,1992,-1,-0.05,1894,1894
366,فراز,صندوق س.سهام فراز داريك-س,26,38502,397882266,10333,10339,10333,0,0,10334,1,0.01,10333,10339
367,خريخت,صنايع‌ريخته‌گري‌ايران‌,25,432677,966600418,2351,2234,2234,-117,-4.98,2343,-8,-0.34,2234,2234
368,اخزا808,اسنادخزانه-م8بودجه98-000817,25,6689,6104895471,911971,905010,912007,36,0,912677,706,0.08,905007,914990
369,پتاير,ايران‌ تاير,25,151510,463469090,3219,3059,3059,-160,-4.97,3214,-5,-0.16,3059,3059
370,ضخود7073,اختيارخ خودرو-1600-1400/07/07,25,751,200429000,253,245,270,17,6.72,267,14,5.53,245,280
371,ضجار7040,اختيارخ وتجارت-2500-1400/07/21,25,697,66137000,99,100,99,0,0,95,-4,-4.04,80,100
372,شكبير,پتروشيمي اميركبير,24,177385,14061308950,81721,79270,79270,-2451,-3,81362,-359,-0.44,79270,79270
373,ضترا8055,اختيارخ شتران-5000-1400/08/09,24,239,579453000,2300,2300,2703,403,17.52,2424,124,5.39,2300,2703
374,اخزا815,اسنادخزانه-م15بودجه98-010406,24,25909,20810502620,802272,803118,803200,928,0.12,803215,943,0.12,803000,804999
375,زدشت,كشت و صنعت دشت خرم دره,23,115347,3119790309,28470,27047,27047,-1423,-5,28152,-318,-1.12,27047,27047
376,ضجار7039,اختيارخ وتجارت-2000-1400/07/21,23,631,91698000,215,160,143,-72,-33.49,145,-70,-32.56,120,160
377,لسرما,سرما آفرين‌,23,211390,4420164900,22010,20910,20910,-1100,-5,21660,-350,-1.59,20910,20910
378,اخزا821,اسنادخزانه-م21بودجه98-020906,22,118275,71008508085,597160,599700,600000,2840,0.48,600368,3208,0.54,599700,600500
379,سمايه,بانك سرمايه,22,1215451,5741790524,4870,4724,4724,-146,-3,4782,-88,-1.81,4724,4724
380,اخزا721,اسنادخزانه-م21بودجه97-000728,20,10255,9445083324,919287,923999,921102,1815,0.2,921022,1735,0.19,921000,923999
381,چكاپا,گروه صنايع كاغذ پارس,20,60449,291364180,5070,4820,4820,-250,-4.93,5070,0,0,4820,4820
382,خديزل,بهمن  ديزل,20,52033,1820842802,36835,34994,34994,-1841,-5,36596,-239,-0.65,34994,34994
383,ونيرو,سرمايه‌گذاري‌نيرو,20,151081,356400079,2483,2359,2359,-124,-4.99,2480,-3,-0.12,2359,2359
384,كلوند,كاشي‌ الوند,19,75293,1460684200,20420,19400,19400,-1020,-5,20310,-110,-0.54,19400,19400
385,اخزا907,اسنادخزانه-م7بودجه99-020704,19,54969,34172306767,619009,617909,619800,791,0.13,621665,2656,0.43,617909,622700
386,معيار,سرمايه گذاري معيار صنعت پارس,19,60914,3387610282,57332,55613,55613,-1719,-3,56746,-586,-1.02,55613,55613
387,شفارا,پتروشيمي فارابي,19,571461,1811531370,3336,3170,3170,-166,-4.98,3304,-32,-0.96,3170,3170
388,تايرا,تراكتورسازي‌ايران‌,18,23111,533170770,24280,23070,23070,-1210,-4.98,24260,-20,-0.08,23070,23070
389,چكارن,كارتن‌ ايران‌,18,109992,334815648,3204,3044,3044,-160,-4.99,3200,-4,-0.12,3044,3044
390,فسرب,ملي‌ سرب‌وروي‌ ايران‌,18,13088,899930880,72370,68760,68760,-3610,-4.99,72140,-230,-0.32,68760,68760
391,دروز,داروسازي‌ روزدارو,18,244817,6962595480,29930,28440,28440,-1490,-4.98,29200,-730,-2.44,28440,28440
392,وكادو,تكادو,18,645143,8103641223,12949,12561,12561,-388,-3,12603,-346,-2.67,12561,12561
393,پرداخت,به پرداخت ملت,18,22711,461487520,21380,20320,20320,-1060,-4.96,21360,-20,-0.09,20320,20320
394,صنوين,صندوق سرمايه‌گذاري صنوين-مختلط,18,7064,718866100,102000,101710,102000,0,0,101760,-240,-0.24,101500,102450
395,دتوزيعح,ح . توزيع دارو پخش,18,19443,635144355,34225,35936,32514,-1711,-5,32667,-1558,-4.55,32514,35936
396,ثروتم,صندوق س. ثروت آفرين پارسيان-س,18,70890,5024001840,70465,70791,70986,521,0.74,70870,405,0.57,70320,71439
397,حبندر,دريايي و کشتيراني خط دريابندر,17,106070,3364540400,32701,31720,31720,-981,-3,32357,-344,-1.05,31720,31720
398,كگهر,سنگ آهن گهرزمين,17,33069,1306456983,41586,39507,39507,-2079,-5,41562,-24,-0.06,39507,39507
399,ثاخت,بين‌المللي‌توسعه‌ساختمان,17,296283,671080995,2384,2265,2265,-119,-4.99,2378,-6,-0.25,2265,2265
400,تملي710,تسهيلات مسكن ب. ملي-دي97,17,139,121829077,855241,812479,898003,42762,5,876468,21227,2.48,812479,898003
401,فمراد,آلومراد,16,14239,1118900620,82710,78580,78580,-4130,-4.99,82380,-330,-0.4,78580,78580
402,خودكفا,اقتصادي و خودكفايي آزادگان,16,26639,449026984,17377,16856,16856,-521,-3,17371,-6,-0.03,16856,16856
403,غاذر,كشت‌وصنعت‌پياذر,16,11500,610305000,55860,53070,53070,-2790,-4.99,55740,-120,-0.21,53070,53070
404,ضملي7004,اختيارخ فملي-14000-1400/07/11,16,287,208390000,883,1000,840,-43,-4.87,726,-157,-17.78,700,1000
405,اخزا811,اسنادخزانه-م11بودجه98-001013,16,11670,10325542100,882019,884999,884600,2581,0.29,884794,2775,0.31,882009,886500
406,وثوق,سرمايه گذاري وثوق امين,16,11015,163848125,15335,14875,14875,-460,-3,15327,-8,-0.05,14875,14875
407,اطلس2,صندوق س.توسعه اندوخته آينده-س,16,160000,160000,188054,1,1,-188053,-100,1,-188053,-100,1,1
408,اخزا818,اسنادخزانه-م18بودجه98-010614,15,17036,13189980727,772094,776829,773100,1006,0.13,774242,2148,0.28,773100,776829
409,كالا,بورس كالاي ايران,15,16009,472265500,31050,29500,29500,-1550,-4.99,31030,-20,-0.06,29500,29500
410,هفجر102,اختيارف ت بفجر26401-01/02/11,15,78580,50212620,178,639,639,461,258.99,639,461,258.99,639,639
411,الماس,صندوق س.امين تدبيرگران فردا-س,15,578,57349766,100066,97001,100099,33,0.03,99221,-845,-0.84,97001,101000
412,غشهداب,كشت و صنعت شهداب ناب خراسان,15,50547,188085387,3916,3721,3721,-195,-4.98,3913,-3,-0.08,3721,3721
413,تمحركه,ماشين سازي نيرو محركه,15,15484,274330028,18649,17717,17717,-932,-5,18622,-27,-0.14,17717,17717
414,شاروم,پتروشيمي اروميه,15,11252,204640124,19144,18187,18187,-957,-5,19130,-14,-0.07,18187,18187
415,اخزا812,اسنادخزانه-م12بودجه98-001111,15,16391,14304415195,872616,872617,872699,83,0.01,872699,83,0.01,872616,878999
416,كسرا,سراميك‌هاي‌صنعتي‌اردكان‌,14,18255,332058450,19140,18190,18190,-950,-4.96,19120,-20,-0.1,18190,18190
417,همبين102,اختيارف ت مبين19752-01/02/10,14,71807,83583348,996,1164,1164,168,16.87,1164,168,16.87,1164,1164
418,پلوله,گازلوله‌,14,16757,446339452,28037,26636,26636,-1401,-5,27971,-66,-0.24,26636,26636
419,زعف0008پ05,زعفران0008نگين زرين(پ),14,3843,463141800,119227,119700,122000,2773,2.33,120516,1289,1.08,119600,122000
420,تليسه,دامداري تليسه نمونه,14,32172,131390448,4298,4084,4084,-214,-4.98,4296,-2,-0.05,4084,4084
421,ختور,رادياتور ايران‌,14,53028,960337080,19060,18110,18110,-950,-4.98,19000,-60,-0.31,18110,18110
422,كمنگنز,معادن‌منگنزايران‌,13,2526,189399480,78920,74980,74980,-3940,-4.99,78860,-60,-0.08,74980,74980
423,زعف0008پ08,زعفران0008نگين روستا(پ),13,5845,691936765,118930,117000,119000,70,0.06,118381,-549,-0.46,116011,120000
424,بذر,صندوق س بذر اميد آفرين-سهام,13,3301,275079960,84230,83470,83140,-1090,-1.29,83330,-900,-1.07,83110,85400
425,بكام,كارخانجات توليدي شهيد قندي,13,34082,125762580,3884,3690,3690,-194,-4.99,3882,-2,-0.05,3690,3690
426,ضمخا7075,اختيارخ اخابر-9000-1400/07/28,13,73,35739000,560,310,520,-40,-7.14,490,-70,-12.5,310,600
427,باران,بيمه زندگي باران50%تاديه,13,486139,1921707467,3838,3953,3953,115,3,3859,21,0.55,3953,3953
428,شساخت,مهندسي و ساختمان صنايع نفت,13,6992,290216944,42790,41507,41507,-1283,-3,42781,-9,-0.02,41507,41507
429,نوين,بيمه نوين,13,193596,1068456324,5809,5519,5519,-290,-4.99,5787,-22,-0.38,5519,5519
430,سخند,صندوق س.سپهرخبرگان نفت-د,13,99300,993336880,10012,10001,10054,42,0.42,10003,-9,-0.09,10000,10069
431,اخزا806,اسنادخزانه-م6بودجه98-000519,12,10001,9592359150,959374,959000,959000,-374,-0.04,959140,-234,-0.02,958100,960000
432,ضصاد3002,اختيارخ وبصادر-2500-1400/03/12,12,472,882000,5,5,2,-3,-60,2,-3,-60,1,5
433,دپارس,پارس‌ دارو,12,52640,1986107200,39710,37730,37730,-1980,-4.99,39440,-270,-0.68,37730,37730
434,شكربن,كربن‌ ايران‌,12,6446,440841940,71980,68390,68390,-3590,-4.99,71860,-120,-0.17,68390,68390
435,ضملي7005,اختيارخ فملي-16000-1400/07/11,12,165,33999000,247,212,250,3,1.21,206,-41,-16.6,200,250
436,درهآور,دارويي ره آورد تامين,12,6221,160029004,27077,25724,25724,-1353,-5,27061,-16,-0.06,25724,25724
437,غگلپا,شير پاستوريزه پگاه گلپايگان,12,14715,754747065,53990,51291,51291,-2699,-5,53822,-168,-0.31,51291,51291
438,غزر,صنعتي زر ماكارون,12,7330,169469600,24330,23120,23120,-1210,-4.97,24320,-10,-0.04,23120,23120
439,هجرت,پخش هجرت,12,3158,84176490,28057,26655,26655,-1402,-5,28049,-8,-0.03,26655,26655
440,فرآور,فرآوري‌موادمعدني‌ايران‌,12,10806,321478500,31310,29750,29750,-1560,-4.98,31270,-40,-0.13,29750,29750
441,دتماد,توليدمواداوليه‌داروپخش‌,12,13138,519082380,41580,39510,39510,-2070,-4.98,41500,-80,-0.19,39510,39510
442,سامان,بانك سامان,12,19273,172743899,9240,8963,8963,-277,-3,9239,-1,-0.01,8963,8963
443,حخزر,كشتيراني درياي خزر,12,500200,12978189200,27311,25946,25946,-1365,-5,26019,-1292,-4.73,25946,25946
444,وملي,گروه‌ صنعتي‌ ملي‌ (هلدينگ‌,12,983,155333660,166330,158020,158020,-8310,-5,166250,-80,-0.05,158020,158020
445,اخزا723,اسنادخزانه-م23بودجه97-000824,12,6078,5543842432,910457,911999,916390,5933,0.65,912116,1659,0.18,910000,916410
446,وآرين,شركت توسعه اقتصادي آرين,11,46433,155875581,3460,3357,3357,-103,-2.98,3458,-2,-0.06,3357,3357
447,اخزا904,اسنادخزانه-م4بودجه99-011215,11,7030,4937903447,695304,699990,700000,4696,0.68,702404,7100,1.02,699990,705000
448,تملي701,تسهيلات مسكن ب. ملي-فروردين97,11,310,174039504,567308,538943,595673,28365,5,561418,-5890,-1.04,538943,595673
449,فرابورس,فرابورس ايران,11,27720,815827320,30979,29431,29431,-1548,-5,30941,-38,-0.12,29431,29431
450,هپارس102,اختيارف ت پارس-177010-01/02/05,11,7726,21547814,1745,2789,2789,1044,59.83,2789,1044,59.83,2789,2789
451,اخزا813,اسنادخزانه-م13بودجه98-010219,10,3790,3126546926,824156,820000,825101,945,0.11,824946,790,0.1,820000,826102
452,دماوند,توليد نيروي برق دماوند,10,3422,99764988,30688,29154,29154,-1534,-5,30686,-2,-0.01,29154,29154
453,ضخوز7037,اختيارخ فخوز-12000-1400/07/14,10,48,185133000,3350,4400,3330,-20,-0.6,3857,507,15.13,3100,4500
454,برن0003پ01,برنج طارم0003تجارت مازندران(پ),10,1877,518422000,276064,275000,276000,-64,-0.02,276197,133,0.05,275000,277000
455,هنوري102,اختيارف ت نوري73761-01/02/15,10,20800,94702400,4002,4553,4553,551,13.77,4553,551,13.77,4553,4553
456,زعف0008پ09,زعفران0008نگين نوين(پ),10,1726,205700655,116361,116040,120000,3639,3.13,119178,2817,2.42,115605,120000
457,هاي وب,داده گسترعصرنوين-هاي وب,10,11198,110300300,10360,9850,9850,-510,-4.92,10360,0,0,9850,9850
458,ضمخا7080,اختيارخ اخابر-6000-1400/07/28,10,365,544800000,1,1360,1600,1599,159900,1493,1492,149200,1250,1900
459,ضملي7003,اختيارخ فملي-12000-1400/07/11,10,138,181595000,1373,950,1400,27,1.97,1316,-57,-4.15,950,1590
460,غشان,شيرپاستوريزه‌پگاه‌خراسان‌,10,4950,34303500,7290,6930,6930,-360,-4.94,7290,0,0,6930,6930
461,شلعاب,لعابيران‌,10,118064,1484064480,13230,12570,12570,-660,-4.99,13160,-70,-0.53,12570,12570
462,بمپنا,توليد برق عسلويه  مپنا,10,3233,202916012,66067,62764,62764,-3303,-5,66030,-37,-0.06,62764,62764
463,ضغدر8056,اختيارخ وغدير-8000-1400/08/26,9,139,315910000,2110,2000,2500,390,18.48,2273,163,7.73,2000,2500
464,ثفارس,عمران‌وتوسعه‌فارس‌,9,20575,189701500,9700,9220,9220,-480,-4.95,9690,-10,-0.1,9220,9220
465,كبافق,معادن‌ بافق‌,9,1491,66036390,46620,44290,44290,-2330,-5,46610,-10,-0.02,44290,44290
466,اخزا820,اسنادخزانه-م20بودجه98-020806,9,4271,2601716008,607316,608860,609880,2564,0.42,609158,1842,0.3,608860,609880
467,كفپارس,فرآورده‌هاي‌ نسوز پارس‌,9,22933,69509923,3190,3031,3031,-159,-4.98,3189,-1,-0.03,3031,3031
468,شاملا,معدني‌ املاح‌  ايران‌,9,70177,2534793240,38020,36120,36120,-1900,-5,37670,-350,-0.92,36120,36120
469,دارو,كارخانجات‌داروپخش‌,9,52625,1561383750,31230,29670,29670,-1560,-5,31090,-140,-0.45,29670,29670
470,شكلر,نيروكلر,9,1990,77749300,41120,39070,39070,-2050,-4.99,41110,-10,-0.02,39070,39070
471,اراد33,مرابحه عام دولت3-ش.خ 0303,8,4000,3559192500,891253,860000,892799,1546,0.17,889798,-1455,-0.16,860000,892799
472,وآوا,سرمايه گذاري آوا نوين,8,22491,189734076,8880,8436,8436,-444,-5,8874,-6,-0.07,8436,8436
473,ضخود7077,اختيارخ خودرو-3000-1400/07/07,8,700,21900000,28,30,39,11,39.29,31,3,10.71,30,39
474,دسينا,داروسازي‌ سينا,8,8906,174201360,20580,19560,19560,-1020,-4.96,20570,-10,-0.05,19560,19560
475,تملي612,تسهيلات مسكن بانك ملي-اسفند96,8,67,39888450,567000,595350,595350,28350,5,595350,28350,5,595350,595350
476,زعف0008پ11,زعفران0008نگين سحرخيز(پ),8,1379,168053000,121574,121000,122000,426,0.35,121866,292,0.24,121000,122000
477,لپارس,پارس‌ الكتريك‌,8,7752,648067200,88000,83600,83600,-4400,-5,87800,-200,-0.23,83600,83600
478,اخزا807,اسنادخزانه-م7بودجه98-000719,8,669,619630420,923525,928800,929570,6045,0.65,926204,2679,0.29,925000,929570
479,مفاخر,توسعه فناوري اطلاعات خوارزمي,8,260000,14870700000,60205,57195,57195,-3010,-5,57195,-3010,-5,57195,57195
480,وپخش,داروپخش‌ (هلدينگ‌,8,5959,537501800,94940,90200,90200,-4740,-4.99,94860,-80,-0.08,90200,90200
481,دانا,بيمه دانا,8,129013,714732020,5830,5540,5540,-290,-4.97,5820,-10,-0.17,5540,5540
482,آپ,آسان پرداخت پرشين,8,25733,401434800,16420,15600,15600,-820,-4.99,16400,-20,-0.12,15600,15600
483,تابا,تابان نيرو سپاهان,8,30000,1635540000,56204,54518,54518,-1686,-3,55920,-284,-0.51,54518,54518
484,شسينا,صنايع‌شيميايي‌سينا,8,578,71180700,129630,123150,123150,-6480,-5,129600,-30,-0.02,123150,123150
485,قاسم,قاسم ايران,8,6114,63065910,10857,10315,10315,-542,-4.99,10854,-3,-0.03,10315,10315
486,دجابر,داروسازي‌ جابرابن‌حيان‌,7,3761,70142650,19630,18650,18650,-980,-4.99,19630,0,0,18650,18650
487,اخزا720,اسنادخزانه-م20بودجه97-000324,7,216,213811548,987900,987758,990000,2100,0.21,989868,1968,0.2,987758,990000
488,وآيند,بانك  آينده,7,16225,259389075,16313,15987,15987,-326,-2,16312,-1,-0.01,15987,15987
489,ودي,بيمه  دي,7,10325,197754725,20161,19153,19153,-1008,-5,20151,-10,-0.05,19153,19153
490,ضمخا7077,اختيارخ اخابر-7000-1400/07/28,7,108,62675000,940,580,700,-240,-25.53,580,-360,-38.3,579,700
491,كپارس,كاشي‌ پارس‌,7,11998,1694357560,148650,141220,141220,-7430,-5,147770,-880,-0.59,141220,141220
492,بهپاك,صنعتي بهپاك,7,70908,454803912,6751,6414,6414,-337,-4.99,6740,-11,-0.16,6414,6414
493,مرقام,ايران‌ارقام‌,7,29925,551817000,19410,18440,18440,-970,-5,19370,-40,-0.21,18440,18440
494,كيميا,معدني كيمياي زنجان گستران,7,5286,88144050,17552,16675,16675,-877,-5,17547,-5,-0.03,16675,16675
495,ضترا8056,اختيارخ شتران-6000-1400/08/09,7,34,66392000,2200,2000,2000,-200,-9.09,1953,-247,-11.23,1799,2000
496,دتوليد,داروسازي توليد دارو,7,16050,400303050,26253,24941,24941,-1312,-5,26216,-37,-0.14,24941,24941
497,كگاز,شيشه‌ و گاز,7,3892,68187840,18440,17520,17520,-920,-4.99,18440,0,0,17520,17520
498,تملي703,تسهيلات مسكن ب. ملي-خرداد97,7,74,51313626,667278,700641,700641,33363,5,693427,26149,3.92,633915,700641
499,ضملت3001,اختيارخ وبملت-3500-1400/03/19,7,310,179050000,1434,600,600,-834,-58.16,578,-856,-59.69,550,600
500,افران2,صندوق س افرا نماد پايدار-ثابت,7,53200000,53200000,13366,1,1,-13365,-99.99,1,-13365,-99.99,1,1
501,رافزا,رايان هم افزا,7,304,30584224,105901,100606,100606,-5295,-5,105890,-11,-0.01,100606,100606
502,لابسا,آبسال‌,6,12244,574855800,49420,46950,46950,-2470,-5,49320,-100,-0.2,46950,46950
503,كهمدا,شيشه‌ همدان‌,6,6961,65711840,9930,9440,9440,-490,-4.93,9930,0,0,9440,9440
504,كرازي,كارخانجات‌توليدي‌شيشه‌رازي‌,6,1842,37982040,21700,20620,20620,-1080,-4.98,21700,0,0,20620,20620
505,تملي708,تسهيلات مسكن ب. ملي-آبان97,6,55,48467874,883644,839462,927826,44182,5,881234,-2410,-0.27,839462,927826
506,اخزا817,اسنادخزانه-م17بودجه98-010512,6,8331,6553068400,785667,785000,788120,2453,0.31,786588,921,0.12,785000,788120
507,دفرا,فرآورده‌هاي‌ تزريقي‌ ايران‌,6,14845,340841200,24160,22960,22960,-1200,-4.97,24130,-30,-0.12,22960,22960
508,خكمك,كمك‌فنرايندامين‌,6,51600,1313220000,26780,25450,25450,-1330,-4.97,26660,-120,-0.45,25450,25450
509,بنيرو,نيروترانس‌,6,8227,117234750,14990,14250,14250,-740,-4.94,14980,-10,-0.07,14250,14250
510,ضسپا3002,اختيارخ خساپا-1800-1400/03/26,6,204,10164000,53,50,41,-12,-22.64,50,-3,-5.66,41,50
511,خفولا,خدمات فني فولاد يزد,6,8067,338128305,43211,41915,41915,-1296,-3,43166,-45,-0.1,41915,41915
512,ضخود7076,اختيارخ خودرو-2500-1400/07/07,6,150,11282000,71,60,88,17,23.94,75,4,5.63,60,88
513,تكنو,تكنوتار,6,59585,1208383800,21340,20280,20280,-1060,-4.97,21250,-90,-0.42,20280,20280
514,قثابت,قند ثابت‌ خراسان‌,6,1867,106997770,60320,57310,57310,-3010,-4.99,60300,-20,-0.03,57310,57310
515,اراد35,مرابحه عام دولت3-ش.خ 0103,6,4000,3985915200,956058,980000,999962,43904,4.59,996479,40421,4.23,980000,999962
516,ولبهمن,شركت بهمن ليزينگ,6,112740,749833740,7001,6651,6651,-350,-5,6982,-19,-0.27,6651,6651
517,وسرضوي,س.سهام عدالت استان خراسان رضوي,6,230656,225812224,1030,979,979,-51,-4.95,1030,0,0,979,979
518,ضصاد8031,اختيارخ وبصادر-1800-1400/08/12,6,156,28100000,217,204,158,-59,-27.19,180,-37,-17.05,150,210
519,توريل,توکاريل,5,3080,47290320,16162,15354,15354,-808,-5,16160,-2,-0.01,15354,15354
520,اراد50,مرابحه عام دولت5-ش.خ0302,5,110000,110000000000,1000000,1000000,1000000,0,0,1000000,0,0,1000000,1000000
521,قصفها,قنداصفهان‌,5,1585,229856700,152650,145020,145020,-7630,-5,152520,-130,-0.09,145020,145020
522,غويتا,ويتانا,5,1595,27197940,17949,17052,17052,-897,-5,17948,-1,-0.01,17052,17052
523,كحافظ,كاشي‌ وسراميك‌ حافظ‌,5,4115,46088000,11780,11200,11200,-580,-4.92,11780,0,0,11200,11200
524,ثنوسا,نوسازي‌وساختمان‌تهران‌,5,10700,129363000,12720,12090,12090,-630,-4.95,12710,-10,-0.08,12090,12090
525,ثجوان,تامين مسكن جوانان,5,5000,53765000,11085,10753,10753,-332,-3,11083,-2,-0.02,10753,10753
526,سيمرغ,سيمرغ,5,5062,86661440,18020,17120,17120,-900,-4.99,18010,-10,-0.06,17120,17120
527,ضغدر8055,اختيارخ وغدير-7000-1400/08/26,5,164,490800000,2800,2900,3000,200,7.14,2993,193,6.89,2900,3000
528,تپكو,توليدتجهيزات‌سنگين‌هپكو,5,9127,48373100,5408,5300,5300,-108,-2,5408,0,0,5300,5300
529,اخزا816,اسنادخزانه-م16بودجه98-010503,5,11800,9344023520,786403,790006,792000,5597,0.71,791866,5463,0.69,790006,792000
530,تفيرو,مهندسي فيروزا,5,8571,167134500,19118,19500,19500,382,2,19131,13,0.07,19500,19500
531,بسويچ,پارس‌سويچ‌,5,2012,52533320,27480,26110,26110,-1370,-4.99,27480,0,0,26110,26110
532,ضسپا8039,اختيارخ خساپا-1200-1400/08/26,5,85,31670000,433,392,370,-63,-14.55,373,-60,-13.86,370,392
533,ضپاس7028,اختيارخ وپارس-2000-1400/07/28,5,61,42852000,753,751,720,-33,-4.38,702,-51,-6.77,690,751
534,پكوير,كوير تاير,5,3843,46116000,12630,12000,12000,-630,-4.99,12630,0,0,12000,12000
535,بخاور,بيمه زندگي خاورميانه,5,13980,83558460,6291,5977,5977,-314,-4.99,6289,-2,-0.03,5977,5977
536,گدنا,تهيه توزيع غذاي دنا آفرين فدك,5,995,31879800,33726,32040,32040,-1686,-5,33722,-4,-0.01,32040,32040
537,ختراك,ريخته‌گري‌ تراكتورسازي‌ ايران‌,5,33000,456720000,14560,13840,13840,-720,-4.95,14540,-20,-0.14,13840,13840
538,اخزا905,اسنادخزانه-م5بودجه99-020218,5,14654,9845660536,669087,672568,670135,1048,0.16,671875,2788,0.42,670135,673499
539,سجام,مجتمع سيمان غرب آسيا,5,6796,26307316,3990,3871,3871,-119,-2.98,3990,0,0,3871,3871
540,ضشنا8000,اختيارخ شپنا-7000-1400/08/16,5,23,65489000,2100,2750,3000,900,42.86,2847,747,35.57,2510,3000
541,اخزا716,اسنادخزانه-م16بودجه97-000407,5,1946,1912979622,982000,982001,983000,1000,0.1,983032,1032,0.11,982001,983401
542,وهنر,گروه توسعه هنر ايران,5,87400,672980000,8105,7700,7700,-405,-5,8076,-29,-0.36,7700,7700
543,ساذري,آذريت‌,5,5246,32939634,6097,6279,6279,182,2.99,6098,1,0.02,6279,6279
544,ضسپا8040,اختيارخ خساپا-1400-1400/08/26,5,96,24280000,292,255,255,-37,-12.67,253,-39,-13.36,250,255
545,ديران,ايران‌دارو,4,11050,181441000,17280,16420,16420,-860,-4.98,17270,-10,-0.06,16420,16420
546,ضخود4002,اختيارخ خودرو-1800-1400/04/02,4,101,11853000,111,117,118,7,6.31,117,6,5.41,117,118
547,دشيري,شيرين دارو,4,290,62983940,228616,217186,217186,-11430,-5,228538,-78,-0.03,217186,217186
548,خموتور,موتورسازان‌تراكتورسازي‌ايران‌,4,6686,94874340,14930,14190,14190,-740,-4.96,14930,0,0,14190,14190
549,خبازرس,بازرسي مهندسي و صنعتي ايران,4,23500,576948500,25310,24551,24551,-759,-3,25265,-45,-0.18,24551,24551
550,خنصير,مهندسي‌نصيرماشين‌,4,2183,224761680,108370,102960,102960,-5410,-4.99,108280,-90,-0.08,102960,102960
551,اخزا804,اسنادخزانه-م4بودجه98-000421,4,3445,3355430000,973002,974000,974000,998,0.1,974000,998,0.1,974000,974000
552,زعف0008پ19,زعفران0008نگين تروند قاينات(پ),4,1544,182219156,119000,118000,118999,-1,0,118018,-982,-0.83,117800,118999
553,قجام,فرآوردههاي غذايي وقندتربت‌جام‌,4,759,10212345,13729,13455,13455,-274,-2,13728,-1,-0.01,13455,13455
554,سصفها,سيمان‌اصفهان‌,4,30500,3674945000,126830,120490,120490,-6340,-5,125860,-970,-0.76,120490,120490
555,زملارد,كشاورزي و دامپروري ملارد شير,4,1114,38655800,36526,34700,34700,-1826,-5,36521,-5,-0.01,34700,34700
556,ولراز,ليزينگ رازي,4,418,22264352,56067,53264,53264,-2803,-5,56060,-7,-0.01,53264,53264
557,حريل,ريل پردازسير,4,19245,100381920,5490,5216,5216,-274,-4.99,5488,-2,-0.04,5216,5216
558,ريشمك,توليد و صادرات ريشمك,4,20669,1084523099,55232,52471,52471,-2761,-5,55018,-214,-0.39,52471,52471
559,تملي706,تسهيلات مسكن ب. ملي-شهريور97,4,51,22956375,473815,450125,450125,-23690,-5,450125,-23690,-5,450125,450125
560,زفكا,كشت و دامداري فكا,4,5467,65177574,12549,11922,11922,-627,-5,12546,-3,-0.02,11922,11922
561,اخزا722,اسنادخزانه-م22بودجه97-000428,4,925,898729990,971600,971600,971600,0,0,971600,0,0,971599,971600
562,ضپيك7041,اختيارخ تاپيكو-9000-00/07/18,4,38,58130000,1720,1600,1450,-270,-15.7,1530,-190,-11.05,1360,1600
563,زعف0008پ15,زعفران0008پوشالمعمول طلاسرخ(پ),4,195,17227910,87000,84500,90226,3226,3.71,88348,1348,1.55,84500,90226
564,دسانكو,داروسازي سبحان انكولوژي,4,10500,146916000,14728,13992,13992,-736,-5,14720,-8,-0.05,13992,13992
565,غپآذر,شير پگاه آذربايجان شرقي,4,400,20831600,54820,52079,52079,-2741,-5,54816,-4,-0.01,52079,52079
566,تملي802,تسهيلات مسكن ب. ملي-ارديبهشت98,4,82,58720274,741417,704347,778487,37070,5,716101,-25316,-3.41,704347,778487
567,شگل,گلتاش‌,4,2908,27800480,10060,9560,9560,-500,-4.97,10060,0,0,9560,9560
568,دسبحا,گروه دارويي سبحان,4,16000,281600000,18520,17600,17600,-920,-4.97,18510,-10,-0.05,17600,17600
569,اخزا713,اسنادخزانه-م13بودجه97-000518,4,320,307194420,961000,958334,960999,-1,0,959983,-1017,-0.11,958334,960999
570,دامين,داروسازي‌ امين‌,4,6445,30742650,5020,4770,4770,-250,-4.98,5020,0,0,4770,4770
571,غنوش,نوش‌ مازندران‌,4,1200,64176000,56290,53480,53480,-2810,-4.99,56280,-10,-0.02,53480,53480
572,كاذر,فرآورده‌هاي‌نسوزآذر,4,3032,47784320,16580,15760,15760,-820,-4.95,16580,0,0,15760,15760
573,كسعدي,كاشي‌ سعدي‌,4,21931,444322060,21320,20260,20260,-1060,-4.97,21290,-30,-0.14,20260,20260
574,دلقما,دارويي‌ لقمان‌,4,1800,41940000,24520,23300,23300,-1220,-4.98,24520,0,0,23300,23300
575,ضغدر3002,اختيارخ وغدير-8200-1400/03/26,4,25,32000000,1275,1300,1350,75,5.88,1280,5,0.39,1100,1350
576,اعتلا,شركت سرمايه گذاري اعتلاء البرز,4,29000,198157000,7192,6833,6833,-359,-4.99,7187,-5,-0.07,6833,6833
577,سرو2,صندوق س سروسودمند مدبران-سهام,4,400000,400000,56030,1,1,-56029,-100,1,-56029,-100,1,1
578,آسام,صندوق س.آرمان سپهر آشنا-م,4,1140,115480850,98827,101323,101125,2298,2.33,101299,2472,2.5,101125,101323
579,ضفار3001,اختيارخ فارس-9000-1400/03/05,4,46,471000,20,10,10,-10,-50,10,-10,-50,10,11
580,اخزا805,اسنادخزانه-م5بودجه98-000422,4,166,161274790,970913,971224,979897,8984,0.93,971535,622,0.06,971221,979897
581,حفارس,حمل و نقل بين المللي خليج فارس,3,22251,99951492,4728,4492,4492,-236,-4.99,4726,-2,-0.04,4492,4492
582,كشم0006پ02,كشمش تيزابي0006تاكستان(پ),3,112,24566000,217667,218000,220000,2333,1.07,219339,1672,0.77,218000,220000
583,بزاگرس,نيروگاه زاگرس كوثر,3,4529,30720207,7140,6783,6783,-357,-5,7139,-1,-0.01,6783,6783
584,دشيمي,شيمي‌ داروئي‌ داروپخش‌,3,10800,312660000,30470,28950,28950,-1520,-4.99,30440,-30,-0.1,28950,28950
585,جهرم,پتروشيمي جهرم,3,11920,20073280,1772,1684,1684,-88,-4.97,1772,0,0,1684,1684
586,كمينا,شيشه سازي مينا,3,2416,58665312,25032,24282,24282,-750,-3,25027,-5,-0.02,24282,24282
587,زكوثر,سرمايه گذاري كشاورزي كوثر,3,2645,52847100,21030,19980,19980,-1050,-4.99,21030,0,0,19980,19980
588,تپمپي,پمپ‌ سازي‌ ايران‌,3,1550,27931000,18960,18020,18020,-940,-4.96,18960,0,0,18020,18020
589,خرينگ,رينگ‌سازي‌مشهد,3,1721,81713080,49970,47480,47480,-2490,-4.98,49960,-10,-0.02,47480,47480
590,كلر,كلر پارس,3,207,25386480,129094,122640,122640,-6454,-5,129084,-10,-0.01,122640,122640
591,وايران,ليزينگ ايرانيان,3,2382,28155240,12440,11820,11820,-620,-4.98,12440,0,0,11820,11820
592,غمينو,شركت صنايع غذايي مينو شرق,3,12504,117637632,9903,9408,9408,-495,-5,9899,-4,-0.04,9408,9408
593,كطبس,ذغال‌سنگ‌ نگين‌ ط‌بس‌,3,2405,159475550,69790,66310,66310,-3480,-4.99,69750,-40,-0.06,66310,66310
594,ضخوز7036,اختيارخ فخوز-10000-1400/07/14,3,3,14970000,5000,4990,4990,-10,-0.2,4990,-10,-0.2,4990,4990
595,غالبر,لبنيات‌ كالبر,3,1700,31892000,19740,18760,18760,-980,-4.96,19740,0,0,18760,18760
596,غبهنوش,بهنوش‌ ايران‌,3,180,11775600,68860,65420,65420,-3440,-5,68860,0,0,65420,65420
597,غفارس,شير پاستوريزه پگاه فارس,3,13956,241801656,18237,17326,17326,-911,-5,18221,-16,-0.09,17326,17326
598,بميلا,توسعه بازرگاني آهن وفولادميلاد,3,2590,31020430,12347,11977,11977,-370,-3,12346,-1,-0.01,11977,11977
599,كسرام,پارس‌ سرام‌,3,16020,125116200,8220,7810,7810,-410,-4.99,8220,0,0,7810,7810
600,پلاسك,پلاسكوكار,3,101610,707205600,7320,6960,6960,-360,-4.92,7300,-20,-0.27,6960,6960
601,پارسا306,صكوك اجاره پارسيان-6ماهه16%,3,940,930600000,970000,990000,990000,20000,2.06,990000,20000,2.06,990000,990000
602,تملي801,تسهيلات مسكن ب. ملي-فروردين98,3,60,42901500,680977,715025,715025,34048,5,715025,34048,5,715025,715025
603,ضملت3000,اختيارخ وبملت-3000-1400/03/19,3,19,18175000,1617,1000,651,-966,-59.74,957,-660,-40.82,651,1000
604,سكرد,سيمان كردستان,3,2718,25304580,9790,9310,9310,-480,-4.9,9790,0,0,9310,9310
605,ضپيك7039,اختيارخ تاپيكو-7000-00/07/18,3,20,62550000,3360,3200,2600,-760,-22.62,3127,-233,-6.93,2600,3200
606,شتولي,تولي‌پرس‌,3,2163,74320680,35791,34360,34360,-1431,-4,35769,-22,-0.06,34360,34360
607,ضفار3000,اختيارخ فارس-8000-1400/03/05,3,107,49300000,300,15,920,620,206.67,461,161,53.67,15,920
608,آوا2,صندوق س.سهام آواي معيار-س,3,750000,750000,6226,1,1,-6225,-99.98,1,-6225,-99.98,1,1
609,ولصنم,ليزينگ‌صنعت‌ومعدن‌,3,1427,14997770,11060,10510,10510,-550,-4.97,11060,0,0,10510,10510
610,دبالك,مواد اوليه دارويي البرز بالك,3,10270,201713070,20674,19641,19641,-1033,-5,20659,-15,-0.07,19641,19641
611,كمند2,صندوق س. با درآمد ثابت كمند,2,80000000,80000000,10100,1,1,-10099,-99.99,1,-10099,-99.99,1,1
612,اراد65,مرابحه عام دولتي65-ش.خ0210,2,1100,1055495000,969333,955000,964990,-4343,-0.45,959541,-9792,-1.01,955000,964990
613,ثباغ,شهر سازي و خانه سازي باغميشه,2,1850,22873400,13014,12364,12364,-650,-4.99,13013,-1,-0.01,12364,12364
614,ضبدر8073,اختيارخ شبندر-14000-1400/08/30,2,9,54240000,1,6000,6060,6059,605900,6027,6026,602600,6000,6060
615,دتوزيع,توزيع دارو پخش,2,251,11368794,47677,45294,45294,-2383,-5,47676,-1,0,45294,45294
616,اخزا810,اسنادخزانه-م10بودجه98-001006,2,1000,886611000,884604,886611,886611,2007,0.23,886611,2007,0.23,886611,886611
617,كتوكا,توليدي و خدمات صنايع نسوز توكا,2,668,21762104,34292,32578,32578,-1714,-5,34289,-3,-0.01,32578,32578
618,ضترا3003,اختيارخ شتران-9000-1400/03/09,2,39,39000,79,1,1,-78,-98.73,1,-78,-98.73,1,1
619,نطرين,عطرين نخ قم,2,1500,17104500,12003,11403,11403,-600,-5,12002,-1,-0.01,11403,11403
620,ثاباد,توريستي ورفاهي آبادگران ايران,2,280,14364000,54000,51300,51300,-2700,-5,54000,0,0,51300,51300
621,ضسپا3004,اختيارخ خساپا-2500-1400/03/26,2,200,1000000,5,5,5,0,0,5,0,0,5,5
622,شسم,توليد سموم‌ علف‌ كش,2,244,23013592,92469,94318,94318,1849,2,92477,8,0.01,94318,94318
623,ثنور,سرمايه گذاري كوه نور,2,1721,15600865,9542,9065,9065,-477,-5,9541,-1,-0.01,9065,9065
624,تكشا,گسترش‌صنايع‌وخدمات‌كشاورزي‌,2,607,23745840,41170,39120,39120,-2050,-4.98,41170,0,0,39120,39120
625,خفناور,مهندسي صنعتي روان فن آور,2,608,28515808,48351,46901,46901,-1450,-3,48347,-4,-0.01,46901,46901
626,وليز,ليزينگ‌ايران‌,2,5110,46347700,9540,9070,9070,-470,-4.93,9540,0,0,9070,9070
627,غشهد,شهد ايران ‌,2,1224,8066160,6930,6590,6590,-340,-4.91,6930,0,0,6590,6590
628,سنفت001,سلف موازي استاندارد سنفت001,2,55800,65044107000,1165665,1165665,1165665,0,0,1165665,0,0,1165665,1165665
629,زعف0008پ12,زعفران0008پوشالمعمول سحرخيز(پ),2,100,8888800,85930,88800,88900,2970,3.46,88888,2958,3.44,88800,88900
630,اراد364,مرابحه عام دولت3-ش.خ 0104,2,490000,463246000000,950000,945400,945400,-4600,-0.48,945400,-4600,-0.48,945400,945400
631,كترام,توليدي‌ كاشي‌ تكسرام‌,2,217,9982000,48420,46000,46000,-2420,-5,48420,0,0,46000,46000
632,كوثر,بيمه كوثر,2,1500,20800500,14596,13867,13867,-729,-4.99,14596,0,0,13867,13867
633,شستا004,اجاره تامين اجتماعي-نوين000523,2,46881,46693476000,994000,996000,996000,2000,0.2,996000,2000,0.2,996000,996000
634,ضسپا3005,اختيارخ خساپا-3000-1400/03/26,2,200,600000,3,3,3,0,0,3,0,0,3,3
635,زشگزا,شير و گوشت زاگرس شهركرد,2,4000,31160000,8200,7790,7790,-410,-5,8199,-1,-0.01,7790,7790
636,ضبدر3000,اختيارخ شبندر-14000-1400/03/30,2,15,73500000,6600,4900,4900,-1700,-25.76,4900,-1700,-25.76,4900,4900
637,پسهند,صنايع‌ لاستيكي‌  سهند,2,456,16461600,37990,36100,36100,-1890,-4.97,37990,0,0,36100,36100
638,نگين,ص.س. زمين و ساختمان نگين شهرري,2,156,7416240,47800,47540,47540,-260,-0.54,47540,-260,-0.54,47540,47540
639,تصميم2,صندوق س با درآمد ثابت تصميم,2,2000000,2000000,16389,1,1,-16388,-99.99,1,-16388,-99.99,1,1
640,ضخود7072,اختيارخ خودرو-1400-1400/07/07,2,100,40000000,418,400,400,-18,-4.31,400,-18,-4.31,400,400
641,سيلام,سيمان‌ ايلام‌,2,2500,26225000,11040,10490,10490,-550,-4.98,11040,0,0,10490,10490
642,داوه,داروسازي آوه سينا,2,830,15902800,20168,19160,19160,-1008,-5,20167,-1,0,19160,19160
643,غمهرا,توليدي‌مهرام‌,2,104,12042160,121880,115790,115790,-6090,-5,121870,-10,-0.01,115790,115790
644,خعمرا,توسعه و عمران شهرستان نائين,2,400,9651600,23427,24129,24129,702,3,23428,1,0,24129,24129
645,لپيام,گسترش صنايع پيام,2,468,24370632,54814,52074,52074,-2740,-5,54807,-7,-0.01,52074,52074
646,كايتا,ايتالران‌,2,8074,77389290,9306,9585,9585,279,3,9308,2,0.02,9585,9585
647,لكما,كارخانجات‌مخابراتي‌ايران‌,2,1800,10639800,6093,5911,5911,-182,-2.99,6093,0,0,5911,5911
648,اتكام,شركت بيمه اتكايي امين,2,14877,62959464,4454,4232,4232,-222,-4.98,4453,-1,-0.02,4232,4232
649,سمگا,گروه سرمايه گذاري ميراث فرهنگي,2,386,10481058,28582,27153,27153,-1429,-5,28582,0,0,27153,27153
650,وسديد,گروه ‌صنعتي‌سديد,2,19800,56073600,2889,2832,2832,-57,-1.97,2889,0,0,2832,2832
651,سنفت010,سلف موازي استاندارد سنفت010,2,130000,200999500000,1531040,1546150,1546150,15110,0.99,1546150,15110,0.99,1546150,1546150
652,ضمخا7070,اختيارخ اخابر-20000-1400/07/28,2,41,5742000,299,141,140,-159,-53.18,140,-159,-53.18,140,141
653,وگستر,گسترش سرمايه گذاري ايرانيان,2,1554,27925380,18915,17970,17970,-945,-5,18913,-2,-0.01,17970,17970
654,حآسا,آسيا سير ارس,2,307,11682271,40055,38053,38053,-2002,-5,40053,-2,0,38053,38053
655,گكيش,توريستي ورفاهي آبادگران كيش,2,1000,46880000,48329,46880,46880,-1449,-3,48322,-7,-0.01,46880,46880
656,زبينا,كشاورزي و دامپروري بينالود,2,3700,13704800,3898,3704,3704,-194,-4.98,3898,0,0,3704,3704
657,دارا4,صندوق س. دارا الگوريتم-د,2,38239040,382390400000,9975,10000,10000,25,0.25,10000,25,0.25,10000,10000
658,تبرك,گروه كارخانجات صنعتي تبرك,2,827,15535195,19773,18785,18785,-988,-5,19772,-1,-0.01,18785,18785
659,تملي807,تسهيلات مسكن ب. ملي-مهر98,2,25,12838560,513543,513543,513542,-1,0,513542,-1,0,513542,513543
660,ضملت3003,اختيارخ وبملت-4500-1400/03/19,2,3,600000,536,300,150,-386,-72.01,200,-336,-62.69,150,300
661,رنيك,جنرال مكانيك,2,855,18055035,22228,21117,21117,-1111,-5,22227,-1,0,21117,21117
662,ولشرق,ليزينگ ايران و شرق,2,200650,1606002600,8425,8004,8004,-421,-5,8377,-48,-0.57,8004,8004
663,تكمبا,كمباين‌ سازي‌ ايران‌,2,1800,13248000,7740,7360,7360,-380,-4.91,7740,0,0,7360,7360
664,كاسپين,داروسازي كاسپين تامين,2,422,10351238,25819,24529,24529,-1290,-5,25818,-1,0,24529,24529
665,سفاسي,شركت فارسيت اهواز,2,729,10196523,14419,13987,13987,-432,-3,14419,0,0,13987,13987
666,ضترا3002,اختيارخ شتران-8000-1400/03/09,2,25,5500000,765,100,300,-465,-60.78,220,-545,-71.24,100,300
667,شفا,سرمايه گذاري شفادارو,2,673,27256500,42630,40500,40500,-2130,-5,42630,0,0,40500,40500
668,سپيدما4,صندوق س. سپيد دماوند-د,2,199756200,2073469356000,10374,10380,10380,6,0.06,10380,6,0.06,10380,10380
669,آرمان,بيمه آرمان,1,10000,78910000,8135,7891,7891,-244,-3,8133,-2,-0.02,7891,7891
670,اراد654,مرابحه عام دولتي65-ش.خ0210,1,3230277,3009003025500,969333,931500,931500,-37833,-3.9,931500,-37833,-3.9,931500,931500
671,ضغدر3003,اختيارخ وغدير-9200-1400/03/26,1,2,762000,305,381,381,76,24.92,381,76,24.92,381,381
672,شدوص,دوده‌ صنعتي‌ پارس‌,1,500,10210000,21490,20420,20420,-1070,-4.98,21490,0,0,20420,20420
673,قشهد,شهد,1,282,5470800,20420,19400,19400,-1020,-5,20420,0,0,19400,19400
674,بساما2,بيمه سامان,1,10000000,192430000000,19300,19243,19243,-57,-0.3,19243,-57,-0.3,19243,19243
675,ساربيل,سيمان آرتا اردبيل,1,400,20312000,53450,50780,50780,-2670,-5,53450,0,0,50780,50780
676,ولتجار,واسپاري تجارت وسرمايه ايرانيان,1,779,5654761,7483,7259,7259,-224,-2.99,7483,0,0,7259,7259
677,شپاس,نفت پاسارگاد,1,1000,19484000,20509,19484,19484,-1025,-5,20508,-1,0,19484,19484
678,كساپا,سايپاشيشه‌,1,250,9257500,38970,37030,37030,-1940,-4.98,38970,0,0,37030,37030
679,اراد644,مرابحه عام دولتي64-ش.خ0111,1,5910000,5574802530000,944500,943283,943283,-1217,-0.13,943283,-1217,-0.13,943283,943283
680,ضسپا8041,اختيارخ خساپا-1600-1400/08/26,1,100,19200000,210,192,192,-18,-8.57,192,-18,-8.57,192,192
681,ضملي7006,اختيارخ فملي-18000-1400/07/11,1,1,10000,1,10,10,9,900,10,9,900,10,10
682,غپونه,نوش پونه مشهد,1,27000,486810000,18587,18030,18030,-557,-3,18559,-28,-0.15,18030,18030
683,سنفت009,سلف موازي استاندارد سنفت009,1,13000,19978790000,1535600,1536830,1536830,1230,0.08,1536830,1230,0.08,1536830,1536830
684,خوساز,محورسازان‌ايران‌خودرو,1,1000,6870000,7230,6870,6870,-360,-4.98,7230,0,0,6870,6870
685,ثپرديس,سرمايه گذاري مسكن پرديس,1,10328,99634216,10154,9647,9647,-507,-4.99,10150,-4,-0.04,9647,9647
686,افرا,افرانت,1,155,5043080,34248,32536,32536,-1712,-5,34247,-1,0,32536,32536
687,اخزا8214,اسنادخزانه-م21بودجه98-020906,1,3400000,2059380000000,597160,605700,605700,8540,1.43,605700,8540,1.43,605700,605700
688,ضسپا3003,اختيارخ خساپا-2000-1400/03/26,1,1,18000,22,18,18,-4,-18.18,18,-4,-18.18,18,18
689,بنو,بيمه تجارت نو,1,6000,172308000,30229,28718,28718,-1511,-5,30221,-8,-0.03,28718,28718
690,فلوله,لوله‌وماشين‌سازي‌ايران‌,1,250,5152500,21690,20610,20610,-1080,-4.98,21690,0,0,20610,20610
691,آگاس2,صندوق س.هستي بخش آگاه-س,1,100000,100000,59963,1,1,-59962,-100,1,-59962,-100,1,1
692,ثقزوي4,شركت عمران و سازندگي قزوين,1,2100000,66819900000,31819,31819,31819,0,0,31819,0,0,31819,31819
693,كمرجان,بازرگاني و توليدي مرجان كار,1,36,5024088,146903,139558,139558,-7345,-5,146900,-3,0,139558,139558
694,اراد504,مرابحه عام دولت5-ش.خ0302,1,220000,220000000000,1000000,1000000,1000000,0,0,1000000,0,0,1000000,1000000
695,غشوكو,شوكو پارس,1,187,5054610,28452,27030,27030,-1422,-5,28451,-1,0,27030,27030
696,غچين,كشت‌ و صنعت‌ چين‌ چين,1,1000,18700000,19680,18700,18700,-980,-4.98,19680,0,0,18700,18700
697,ضترا3004,اختيارخ شتران-10000-1400/03/09,1,10,40000,4,4,4,0,0,4,0,0,4,4
698,وتعاون2,بيمه  تعاون,1,14900000,90964500000,6293,6105,6105,-188,-2.99,6105,-188,-2.99,6105,6105
699,وسهرمز,شركت س استان هرمزگان,1,5840,5080800,915,870,870,-45,-4.92,915,0,0,870,870
700,ثتوسا,س.توسعه و عمران استان اردبيل,1,244,9008968,38865,36922,36922,-1943,-5,38863,-2,-0.01,36922,36922
701,ثنظام,س. ساختماني نظام مهندسي ايران,1,120,5520720,47428,46006,46006,-1422,-3,47427,-1,0,46006,46006
702,فسا,پتروشيمي فسا,1,3000,5142000,1766,1714,1714,-52,-2.94,1766,0,0,1714,1714
703,وسگلستا,شركت س استان گلستان,1,4313,5080714,1240,1178,1178,-62,-5,1240,0,0,1178,1178
704,وآذر,سرمايه‌گذاري‌توسعه‌آذربايجان‌,1,65,5071950,82130,78030,78030,-4100,-4.99,82130,0,0,78030,78030
705,پست0008پ08,پسته فندقي32-30مه ولات0008(پ),1,4,6400000,1581375,1600000,1600000,18625,1.18,1600000,18625,1.18,1600000,1600000
706,شستان,پتروشيمي گلستان,1,1350,5055750,3821,3745,3745,-76,-1.99,3821,0,0,3745,3745
707,ضصاد3003,اختيارخ وبصادر-3000-1400/03/12,1,1,5000,6,5,5,-1,-16.67,5,-1,-16.67,5,5
708,غديس,پاكديس,1,590,7522500,13421,12750,12750,-671,-5,13421,0,0,12750,12750
709,رتكو,كنترل‌خوردگي‌تكين‌كو,1,608,9952960,17230,16370,16370,-860,-4.99,17230,0,0,16370,16370
710,زكشت,كشاورزي مكانيزه اصفهان كشت,1,135,5176845,40365,38347,38347,-2018,-5,40364,-1,0,38347,38347
711,ومعلم,بيمه معلم,1,2110,9961310,4969,4721,4721,-248,-4.99,4969,0,0,4721,4721
712,خپويش,سازه‌ پويش‌,1,100,5717000,60170,57170,57170,-3000,-4.99,60170,0,0,57170,57170
713,خلنت,لنت‌ ترمزايران‌,1,102,5942520,61320,58260,58260,-3060,-4.99,61320,0,0,58260,58260
714,زنجان,صنايع كشاورزي وكود زنجان,1,714,6473838,9347,9067,9067,-280,-3,9347,0,0,9067,9067
715,وپسا,س. پتروشيمي ساختمان  خليج فارس,1,20000,58920000,3006,2946,2946,-60,-2,3005,-1,-0.03,2946,2946
716,زگلدشت,كشت و دام گلدشت نمونه اصفهان,1,432,5653584,13775,13087,13087,-688,-4.99,13775,0,0,13087,13087
717,ضملي7000,اختيارخ فملي-8000-1400/07/11,1,1,4300000,5944,4300,4300,-1644,-27.66,4300,-1644,-27.66,4300,4300
718,ثاصفا,شركت‌ ساختمان‌ اصفهان‌,1,1200,32329200,27774,26941,26941,-833,-3,27771,-3,-0.01,26941,26941
719,شرق1400,مشاركت ليزينگ ايران وشرق140010,1,100,100800000,1008000,1008000,1008000,0,0,1008000,0,0,1008000,1008000
720,تابان03,اجاره تابان سپهر14021206,1,1000,1000000000,930000,1000000,1000000,70000,7.53,1000000,70000,7.53,1000000,1000000
721,ضبدر8076,اختيارخ شبندر-20000-1400/08/30,1,15,67500000,3500,4500,4500,1000,28.57,4500,1000,28.57,4500,4500
722,كهرام,توليدي گرانيت بهسرام,1,90,9907470,113487,110083,110083,-3404,-3,113484,-3,0,110083,110083
723,زعف0008پ18,زعفران0008نگين بهرامن(پ),1,49,5880000,116600,120000,120000,3400,2.92,120000,3400,2.92,120000,120000
724,كساوه,صنايع‌ كاشي‌ و سراميك‌ سينا,1,147,9790200,70100,66600,66600,-3500,-4.99,70100,0,0,66600,66600
725,داراب,پتروشيمي داراب,1,2500,5822500,2451,2329,2329,-122,-4.98,2451,0,0,2329,2329
726,ركيش,كارت اعتباري ايران كيش,1,500,11270000,23720,22540,22540,-1180,-4.97,23720,0,0,22540,22540
727,پارس2,پتروشيمي پارس,1,691641,99879876810,144410,144410,144410,0,0,144410,0,0,144410,144410
728,سپرمي,پرميت‌,1,600,5413800,8934,9023,9023,89,1,8934,0,0,9023,9023
729,نتوس,پشم‌ بافي‌ توس,1,588,12027540,21087,20455,20455,-632,-3,21086,-1,0,20455,20455
730,ضپيك7040,اختيارخ تاپيكو-8000-00/07/18,1,10,16100000,2693,1610,1610,-1083,-40.22,1610,-1083,-40.22,1610,1610
731,چافست,افست‌,1,350,5519500,16590,15770,15770,-820,-4.94,16590,0,0,15770,15770
732,شاراك2,پتروشيمي شازند,1,4000000,99880000000,24970,24970,24970,0,0,24970,0,0,24970,24970
733,چكاوه,صنايع‌كاغذسازي‌كاوه‌,1,350,6104000,18350,17440,17440,-910,-4.96,18350,0,0,17440,17440
734,تاصيكو2,سرمايه گذاري صدرتامين,1,5978607,56019547590,9660,9370,9370,-290,-3,9370,-290,-3,9370,9370
735,وسنا,سرمايه گذاري نيروگاهي ايران,1,500,7447500,15678,14895,14895,-783,-4.99,15678,0,0,14895,14895
736,آينده,بازرگاني آينده سازان بهشت پارس,1,262,5044286,19848,19253,19253,-595,-3,19848,0,0,19253,19253
737,خمهر,مهركام‌پارس‌,1,2551,5466793,2255,2143,2143,-112,-4.97,2255,0,0,2143,2143
738,ضپيك7042,اختيارخ تاپيكو-10000-00/07/18,1,20,38000000,1300,1900,1900,600,46.15,1900,600,46.15,1900,1900
739,گواهي ظرفيت,گواهي ظرفيت نقدي,1,2000000,36378000000,18189,18189,18189,0,0,18189,0,0,18189,18189
740,ضترا8058,اختيارخ شتران-8000-1400/08/09,1,10,9000000,710,900,900,190,26.76,900,190,26.76,900,900
741,ضصاد3000,اختيارخ وبصادر-1800-1400/03/12,1,35,3150000,123,90,90,-33,-26.83,90,-33,-26.83,90,90
742,خساپا4,سايپا,1,402000000,604608000000,1579,1504,1504,-75,-4.75,1504,-75,-4.75,1504,1504
743,ضشنا8004,اختيارخ شپنا-12000-1400/08/16,1,10,8500000,1200,850,850,-350,-29.17,850,-350,-29.17,850,850
744,وآفري,بيمه كارآفرين,1,1854,5845662,3318,3153,3153,-165,-4.97,3318,0,0,3153,3153
745,ضملت3002,اختيارخ وبملت-4000-1400/03/19,1,30,14700000,977,490,490,-487,-49.85,490,-487,-49.85,490,490
746,فنفت,صنايع تجهيزات نفت,1,165,5289075,33046,32055,32055,-991,-3,33045,-1,0,32055,32055
747,كگل2,معدني و صنعتي گل گهر,1,3880000,51759200000,13340,13340,13340,0,0,13340,0,0,13340,13340
748,كپشير,پشم‌شيشه‌ايران‌,1,150,5692500,39940,37950,37950,-1990,-4.98,39940,0,0,37950,37950
749,اخزا9142,اسنادخزانه-م14بودجه99-021025,1,533675,311132525000,579849,583000,583000,3151,0.54,583000,3151,0.54,583000,583000
750,قلرست,قند لرستان‌,1,478,16261560,35810,34020,34020,-1790,-5,35810,0,0,34020,34020
751,غشاذر,پگاه‌آذربايجان‌غربي‌,1,10800,101196000,9860,9370,9370,-490,-4.97,9860,0,0,9370,9370
752,شپارس,بين‌ المللي‌ محصولات‌  پارس‌,1,240,5052000,22150,21050,21050,-1100,-4.97,22150,0,0,21050,21050
753,اراد214,مرابحه عام دولت2ش.خ صادرات0212,1,10300000,9747961200000,1000000,946404,946404,-53596,-5.36,946404,-53596,-5.36,946404,946404
754,ضملت3004,اختيارخ وبملت-5000-1400/03/19,1,1,2000,331,2,2,-329,-99.4,2,-329,-99.4,2,2
755,دقاضي,داروسازي شهيد قاضي,1,133,5578685,43242,41945,41945,-1297,-3,43241,-1,0,41945,41945
756,ساينا,صنايع بهداشتي ساينا,1,50,6935050,146001,138701,138701,-7300,-5,145997,-4,0,138701,138701
757,قنيشا,قند  نيشابور,1,100,6087000,64070,60870,60870,-3200,-4.99,64070,0,0,60870,60870
758,اخزا9082,اسنادخزانه-م8بودجه99-020606,1,284456,179633964000,628508,631500,631500,2992,0.48,631500,2992,0.48,631500,631500
759,فافزا,فولاد افزا سپاهان,1,170,7878140,47775,46342,46342,-1433,-3,47774,-1,0,46342,46342
760,ثامان,سامان‌ گستراصفهان‌,1,2309,49805130,22700,21570,21570,-1130,-4.98,22700,0,0,21570,21570
761,فوكا,فولاد كاويان,1,500,5509000,11358,11018,11018,-340,-2.99,11358,0,0,11018,11018
762,زنگان,صنعت روي زنگان,1,51,5043798,104103,98898,98898,-5205,-5,104101,-2,0,98898,98898
763,اراد614,مرابحه عام دولت61-ش.خ0309,1,400000,400000000000,1000000,1000000,1000000,0,0,1000000,0,0,1000000,1000000
764,ضغدر3000,اختيارخ وغدير-6200-1400/03/26,1,2,6000000,2998,3000,3000,2,0.07,3000,2,0.07,3000,3000
765,ضپنا8000,اختيارخ رمپنا-10000-1400/08/05,1,1,3100000,3500,3100,3100,-400,-11.43,3100,-400,-11.43,3100,3100
766,داريك2,صندوق س.اعتماد داريك-د,1,500000,500000,10591,1,1,-10590,-99.99,1,-10590,-99.99,1,1
767,ضپاس7026,اختيارخ وپارس-1600-1400/07/28,1,5,5500000,964,1100,1100,136,14.11,1100,136,14.11,1100,1100
768,طلا2,صندوق س.پشتوانه طلاي لوتوس,1,100000,100000,72286,1,1,-72285,-100,1,-72285,-100,1,1
769,انرژي12,نهادهاي مالي بورس انرژي,1,486000,109145880000,236400,224580,224580,-11820,-5,224580,-11820,-5,224580,224580
770,غصينو,صنعتي مينو,1,200,12725600,66976,63628,63628,-3348,-5,66976,0,0,63628,63628
