,نماد,نام,تعداد,حجم,ارزش,دیروز,اولین,آخرین معامله - مقدار,آخرین معامله - تغییر,آخرین معامله - درصد,قیمت پایانی - مقدار,قیمت پایانی - تغییر,قیمت پایانی - درصد,کمترین,بیشترین
2,فگستر,گسترش صنايع روي ايرانيان,88314,14155677,129835869444,8736,9172,9172,436,4.99,9172,436,4.99,9172,9172
3,پالايش,صندوق پالايشي يکم-سهام,32784,45392443,3057812126360,65270,66550,67350,2080,3.19,67360,2090,3.2,65500,68400
4,فتوسا,توليد و توسعه سرب روي ايرانيان,30001,2031211,19318847821,9059,9511,9511,452,4.99,9511,452,4.99,9511,9511
5,دارا يكم,صندوق واسطه گري مالي يكم-سهام,19142,14638230,1703559715690,112540,114500,116190,3650,3.24,116380,3840,3.41,114000,118050
6,وبملت,بانك ملت,17637,489590257,1877642399416,3860,3785,3870,10,0.26,3835,-25,-0.65,3740,3950
7,اپال,فرآوري معدني اپال كاني پارس,17307,8719108,160965069270,18390,18420,18470,80,0.44,18460,70,0.38,18300,18720
8,بركت,گروه دارويي بركت,16412,48695529,1131732881040,22990,22500,23090,100,0.43,23240,250,1.09,22200,24050
9,شپنا,پالايش نفت اصفهان,13626,140374280,1331759164200,9060,9200,9510,450,4.97,9490,430,4.75,9190,9510
10,ثاميد,توسعه و عمران اميد,11644,95891994,134561287154,1363,1342,1431,68,4.99,1403,40,2.93,1342,1431
11,امينح,ح . تامين سرمايه امين,11389,5201095,26094312550,5008,4947,5020,12,0.24,5017,9,0.18,4931,5050
12,فملي,ملي‌ صنايع‌ مس‌ ايران‌,10783,52206778,615334197860,11380,11590,11740,360,3.16,11790,410,3.6,11250,11940
13,خگستر,گسترش‌سرمايه‌گذاري‌ايران‌خودرو,10761,404751903,754194534023,1780,1825,1869,89,5,1863,83,4.66,1810,1869
14,بوعلي,پتروشيمي بوعلي سينا,10569,2213782,100360040460,45070,44000,44710,-360,-0.8,45330,260,0.58,44000,46280
15,وتجارت,بانك تجارت,10228,320922755,604955618986,1917,1822,1889,-28,-1.46,1885,-32,-1.67,1822,1970
16,شتران,پالايش نفت تهران,9968,128281427,950079926130,7140,7300,7390,250,3.5,7410,270,3.78,7210,7490
17,وسپهر,سرمايه گذاري مالي سپهرصادرات,9855,12563963,114258611076,9095,9095,9094,-1,-0.01,9094,-1,-0.01,9094,9100
18,شستا,سرمايه گذاري تامين اجتماعي,9485,26366242,256473701350,9510,9520,9720,210,2.21,9730,220,2.31,9520,9870
19,وكبهمن,مديريت سرمايه گذاري كوثربهمن,9278,4939150,51310275117,10287,10287,10500,213,2.07,10388,101,0.98,10200,10570
20,ولپارس,ليزينگ پارسيان,9244,3407036,13437349984,3757,3944,3944,187,4.98,3930,173,4.6,3944,3944
21,وپاسار,بانك  پاسارگاد,9139,124935469,1957458532760,16420,15600,15700,-720,-4.38,15670,-750,-4.57,15600,15890
22,كارين2,صندوق س نگين سامان-ثابت,8490,84900000,84900000,10019,1,1,-10018,-99.99,1,-10018,-99.99,1,1
23,آبادا,توليد نيروي برق آبادان,8392,2190777,19639331090,8620,8310,9050,430,4.99,8960,340,3.94,8310,9050
24,خزاميا,زامياد,8295,100582785,621807373380,6420,6100,6100,-320,-4.98,6180,-240,-3.74,6100,6450
25,كرمان,س. توسعه و عمران استان كرمان,7398,239011087,218691570124,917,891,906,-11,-1.2,915,-2,-0.22,891,942
26,امين,تامين سرمايه امين,7391,5859365,41669139710,7100,7100,7100,0,0,7110,10,0.14,7100,7390
27,بپيوند,برق و انرژي پيوندگستر پارس,7279,5476307,53146910940,9393,9499,9862,469,4.99,9705,312,3.32,9311,9862
28,فولاد,فولاد مباركه اصفهان,7232,65478842,582914427500,8870,9000,8880,10,0.11,8900,30,0.34,8790,9000
29,سيتا,سرمايه گذاري سيمان تامين,7192,13767570,206525007390,15000,15000,15000,0,0,15000,0,0,15000,15040
30,بگيلان,توسعه مسير برق گيلان,6805,1830670,33095994746,18819,17879,17942,-877,-4.66,18079,-740,-3.93,17879,18610
31,شبندر,پالايش نفت بندرعباس,5862,22871852,454005525390,19020,19140,19970,950,4.99,19850,830,4.36,19140,19970
32,آريا,پليمر آريا ساسول,5352,2265245,173204039916,73829,74000,76800,2971,4.02,76462,2633,3.57,74000,77500
33,ذوب,سهامي ذوب آهن  اصفهان,5216,120896258,356441668664,2816,2821,2956,140,4.97,2948,132,4.69,2821,2956
34,وبصادر,بانك صادرات ايران,5139,123366761,215487344426,1720,1712,1746,26,1.51,1747,27,1.57,1712,1779
35,غگرجي,بيسكويت‌  گرجي‌,4883,20453406,242732259390,12330,11720,11820,-510,-4.14,11870,-460,-3.73,11720,12240
36,پترول,گروه پتروشيمي س. ايرانيان,4687,29632011,247747040490,8040,8110,8350,310,3.86,8360,320,3.98,8050,8440
37,گشان,توسعه بين المللي پديده شانديز,4597,8600063,185137236401,21867,21431,21799,-68,-0.31,21527,-340,-1.55,21430,22000
38,خبهمن,گروه‌بهمن‌,4571,273895037,303505895350,1058,1090,1109,51,4.82,1108,50,4.73,1071,1110
39,حكشتي,كشتيراني جمهوري اسلامي ايران,4406,12387744,166823081420,13450,13430,13190,-260,-1.93,13470,20,0.15,13130,13870
40,پيزد,مجتمع صنايع لاستيك يزد,4260,329405,16431483868,51129,48934,49799,-1330,-2.6,49882,-1247,-2.44,48573,51685
41,بترانس,ايران‌ ترانسفو,4128,80664474,172603767672,2218,2108,2136,-82,-3.7,2140,-78,-3.52,2108,2280
42,كمند,صندوق س. با درآمد ثابت كمند,3911,151150143,1528222331119,10105,10111,10112,7,0.07,10111,6,0.06,10110,10113
43,شگويا,پتروشيمي تندگويان,3760,21459356,184134133719,8328,8340,8620,292,3.51,8581,253,3.04,8340,8690
44,ساوه,سيمان ساوه,3729,1239521,50266927463,40592,39300,39781,-811,-2,40554,-38,-0.09,39300,41900
45,سدور,سيمان‌ دورود,3428,38773298,309830551660,11450,8000,8400,-3050,-26.64,7990,-3460,-30.22,7600,8400
46,ختوقا,قطعات‌ اتومبيل‌ ايران‌,3346,81720069,158424096947,2019,1919,1919,-100,-4.95,1939,-80,-3.96,1919,2000
47,امين يكم,صندوق درآمد ثابت امين يكم فردا,3194,59597501,598017640907,10030,10034,10035,5,0.05,10034,4,0.04,10032,10037
48,كارين,صندوق س نگين سامان-ثابت,2976,144194539,1445226701483,10019,10021,10022,3,0.03,10023,4,0.04,10021,10024
49,ماديرا,صنايع ماشين هاي اداري ايران,2792,22505769,140987145702,6400,6221,6180,-220,-3.44,6264,-136,-2.13,6080,6600
50,وخارزم,سرمايه گذاري خوارزمي,2732,29493711,102425502907,3371,3361,3490,119,3.53,3473,102,3.03,3361,3534
51,وپارس,بانك‌پارسيان‌,2665,62094896,168861997856,2703,2712,2716,13,0.48,2719,16,0.59,2711,2761
52,فارس,صنايع پتروشيمي خليج فارس,2663,23054173,202906447810,8460,8730,8730,270,3.19,8800,340,4.02,8650,8880
53,تسه0002,امتيازتسهيلاتمسكن ارديبهشت1400,2647,53568,28092972822,538537,540002,542000,3463,0.64,524436,-14101,-2.62,511611,564990
54,نوري,پتروشيمي نوري,2626,4962478,292492091090,56450,57240,59270,2820,5,58940,2490,4.41,57240,59270
55,صبا,سرمايه گذاري صبا تامين,2394,5544634,38851564241,6947,6726,6952,5,0.07,6968,21,0.3,6726,7120
56,خمحركه,نيرو محركه‌,2363,34348147,129414760286,3939,3743,3743,-196,-4.98,3768,-171,-4.34,3743,3930
57,درهآور,دارويي ره آورد تامين,2280,3858633,100796178495,27061,25708,25718,-1343,-4.96,26122,-939,-3.47,25708,27970
58,ساروم,سيمان‌اروميه‌,2275,4324288,106148545360,24690,23480,24940,250,1.01,24550,-140,-0.57,23480,25400
59,وبانك,سرمايه گذاري گروه توسعه ملي,2260,16451163,110082203950,6530,6500,6830,300,4.59,6690,160,2.45,6500,6850
60,كيان,صندوق س. با درآمد ثابت كيان,2225,13904551,397196979153,28549,28566,28568,19,0.07,28566,17,0.06,28565,28568
61,وغدير,سرمايه‌گذاري‌غدير(هلدينگ‌,2163,15257949,143332437580,9140,9140,9390,250,2.74,9390,250,2.74,9140,9530
62,تملت,تامين سرمايه بانك ملت,2106,11517113,49736922580,4500,4290,4280,-220,-4.89,4320,-180,-4,4280,4500
63,اعتماد,صندوق س.اعتماد آفرين پارسيان-د,2057,23672930,866525655850,36587,36605,36605,18,0.05,36604,17,0.05,36603,36608
64,رمپنا,گروه مپنا (سهامي عام),2051,12721011,151713042470,12400,11780,11840,-560,-4.52,11930,-470,-3.79,11780,12500
65,فخوز,فولاد  خوزستان,2046,8116985,117426689800,14100,13960,14590,490,3.48,14470,370,2.62,13960,14690
66,بپاس,بيمه پاسارگاد,2031,3518326,332725643454,98812,93872,95001,-3811,-3.86,94569,-4243,-4.29,93872,100000
67,پارند,صندوق س. پارند پايدار سپهر,1898,80299910,905462479274,11270,11275,11279,9,0.08,11276,6,0.05,11275,11279
68,ساراب,سيمان‌ داراب‌,1824,7268559,143193774660,20250,20500,19690,-560,-2.77,19700,-550,-2.72,19240,20810
69,خصدرا,صنعتي‌ دريايي‌ ايران‌,1811,43152326,87016516122,2074,2012,2012,-62,-2.99,2016,-58,-2.8,2012,2064
70,اخابر,مخابرات ايران,1735,11933566,87161292600,7070,7130,7230,160,2.26,7240,170,2.4,7130,7420
71,ونوين,بانك‌اقتصادنوين‌,1674,33750603,129121549203,3668,3660,3850,182,4.96,3826,158,4.31,3660,3851
72,شبريز,پالايش نفت تبريز,1649,3445655,80326354890,22850,22900,23050,200,0.88,23250,400,1.75,22870,23780
73,خودرو,ايران‌ خودرو,1618,51893654,87911536394,1635,1699,1698,63,3.85,1682,47,2.87,1680,1699
74,سبجنو,سيمان‌ بجنورد,1594,1875185,62804570980,34240,32550,33320,-920,-2.69,33490,-750,-2.19,32550,34990
75,ومعادنح,ح . توسعه‌معادن‌وفلزات‌,1591,11720231,65899997040,5450,5440,5630,180,3.3,5620,170,3.12,5440,5880
76,شلرد,كود شيميايي اوره لردگان,1586,14650687,83839439067,5814,5640,5640,-174,-2.99,5723,-91,-1.57,5640,5988
77,كفرا,فراورده‌ هاي‌ نسوزايران‌,1556,3403035,68738686570,21020,19970,20430,-590,-2.81,20200,-820,-3.9,19970,21020
78,بجهرم,توسعه مولد نيروگاهي جهرم,1549,28418145,55202857507,1853,1853,1945,92,4.96,1943,90,4.86,1853,1945
79,ولساپا,ليزينگ رايان‌ سايپا,1517,29089503,78521800869,2626,2600,2712,86,3.27,2699,73,2.78,2600,2750
80,فباهنرح,ح . مس‌ شهيدباهنر,1471,4482289,56237823670,11880,11820,12600,720,6.06,12550,670,5.64,11820,12890
81,وتوصا,گروه س توسعه صنعتي ايران,1471,11344961,91032688230,7650,7790,8030,380,4.97,8020,370,4.84,7790,8030
82,خاور,ايران خودرو ديزل,1450,27549682,107131722983,4001,3881,3881,-120,-3,3889,-112,-2.8,3881,4000
83,شپترو,پتروشيمي آبادان,1430,21902108,87312284083,3938,3851,4056,118,3,3986,48,1.22,3841,4056
84,وسبحان,سرمايه گذاري سبحان,1378,27748813,61390468335,2222,2160,2219,-3,-0.14,2212,-10,-0.45,2160,2250
85,حفاري,حفاري شمال,1376,9658449,49612842220,5070,5040,5190,120,2.37,5140,70,1.38,5040,5280
86,ميدكو,هلدينگ صنايع  معدني خاورميانه,1351,3078724,123635879836,39078,39800,40100,1022,2.62,40158,1080,2.76,39600,41790
87,وساپا,سرمايه‌گذاري‌ سايپا,1344,20328328,85932486948,4034,4040,4235,201,4.98,4227,193,4.78,4040,4235
88,خساپا,سايپا,1335,52132943,81193932426,1504,1560,1551,47,3.13,1544,40,2.66,1549,1561
89,سرو,صندوق س سروسودمند مدبران-سهام,1331,1036096,59127617940,55640,56200,57060,1420,2.55,57070,1430,2.57,56200,57800
90,شغدير,پتروشيمي غدير,1300,1480787,98313546970,64560,66170,67000,2440,3.78,66390,1830,2.83,65300,67770
91,شيران,س. صنايع‌شيميايي‌ايران,1290,7707619,146097755450,18160,18150,19060,900,4.96,18950,790,4.35,18150,19060
92,كاوه,فولاد كاوه جنوب كيش,1276,10698548,186067334630,17150,17000,17200,50,0.29,17390,240,1.4,16990,17970
93,غمارگ,مارگارين‌,1269,3160723,55990359190,17640,17000,17710,70,0.4,17710,70,0.4,17000,18280
94,آگاس,صندوق س.هستي بخش آگاه-س,1248,1162278,70918010411,59742,60640,61000,1258,2.11,61016,1274,2.13,60010,61489
95,سصوفي,سيمان‌ صوفيان‌,1218,4412824,50148504590,11360,11000,11060,-300,-2.64,11360,0,0,10900,11880
96,فاسمين,كالسيمين‌,1211,6568916,84711295660,12350,12550,12960,610,4.94,12900,550,4.45,12350,12960
97,غگل,گلوكوزان‌,1204,19659943,46399496566,2256,2344,2368,112,4.96,2360,104,4.61,2310,2368
98,ومعادن,توسعه‌معادن‌وفلزات‌,1195,9354591,71734008360,7530,7420,7650,120,1.59,7620,90,1.2,7420,7860
99,ورنا,سرمايه‌گذاري‌ رنا(هلدينگ‌,1148,12531471,52592607715,4039,4000,4190,151,3.74,4197,158,3.91,3950,4240
100,وخارزمح,ح.سرمايه گذاري خوارزمي,1096,3550320,8042099298,2171,2130,2255,84,3.87,2265,94,4.33,2130,2320
101,كچاد,معدني‌وصنعتي‌چادرملو,1075,2899843,65095198520,21860,22000,22380,520,2.38,22180,320,1.46,22000,22830
102,دزهراوي,داروسازي‌زهراوي‌,1054,8170822,50822983070,6530,6210,6210,-320,-4.9,6220,-310,-4.75,6210,6380
103,تاصيكو,سرمايه گذاري صدرتامين,1024,9125897,85921534170,9490,9100,9300,-190,-2,9430,-60,-0.63,9100,9650
104,ومهان,گروه توسعه مالي مهر آيندگان,1012,6399438,74685532827,11540,11321,11650,110,0.95,11671,131,1.14,11321,11900
105,سقاين,سيمان‌ قائن‌,1003,710033,35381485950,52730,49300,49540,-3190,-6.05,49830,-2900,-5.5,47010,51760
106,سمازن,سيمان‌مازندران‌,983,3939729,42896469970,10650,11000,10600,-50,-0.47,10890,240,2.25,10320,11180
107,تنوين,تامين سرمايه نوين,980,31671809,234377828170,7380,7380,7400,20,0.27,7400,20,0.27,7360,7440
108,خاذين,سايپاآذين‌,961,21695725,69778681220,4558,3349,3182,-1376,-30.19,3216,-1342,-29.44,3182,3349
109,وارس,سرمايه گذاري ارس صبا,956,6125008,77916397046,12990,12601,13131,141,1.09,12721,-269,-2.07,12601,13379
110,سهگمت,سيمان‌هگمتان‌,924,2427585,44125379760,18120,17260,18010,-110,-0.61,18180,60,0.33,17260,18440
111,سفارس,سيمان فارس و خوزستان,923,3983018,58331975020,14290,14390,14630,340,2.38,14650,360,2.52,14010,14890
112,وسخوز,شركت س استان خوزستان,920,70058000,64593476000,970,922,922,-48,-4.95,937,-33,-3.4,922,922
113,گكوثر,هتل پارسيان كوثر اصفهان,913,24382678,48150829196,2063,1960,1960,-103,-4.99,1975,-88,-4.27,1960,2038
114,سشرق,سيمان‌ شرق‌,905,11507479,59012190080,5030,5120,5140,110,2.19,5130,100,1.99,5000,5280
115,شپديس,پتروشيمي پرديس,892,695749,64690273160,92330,90260,93550,1220,1.32,92760,430,0.47,90260,94000
116,تسه0001,امتيازتسهيلات مسكن فروردين1400,888,15921,8411594795,545673,570000,540000,-5673,-1.04,528333,-17340,-3.18,518390,572956
117,تاپيكو,س. نفت و گاز و پتروشيمي تأمين,886,4337973,42567307650,9660,9590,9740,80,0.83,9720,60,0.62,9400,9990
118,آوا,صندوق س.سهام آواي معيار-س,868,7629913,47961079019,6215,6200,6249,34,0.55,6286,71,1.14,6200,6350
119,كگلح,ح . معدني و صنعتي گل گهر,838,4111176,43777807100,10230,10110,10730,500,4.89,10650,420,4.11,10110,10730
120,افق,فروشگاههاي زنجيره اي افق كوروش,835,943244,61574462210,64430,62570,67640,3210,4.98,65100,670,1.04,62570,67650
121,وبوعلي,سرمايه‌گذاري‌بوعلي‌,831,8601095,29696716923,3470,3297,3505,35,1.01,3453,-17,-0.49,3297,3643
122,سامان,بانك سامان,819,5911359,52759717966,9239,8778,8820,-419,-4.54,8925,-314,-3.4,8778,9190
123,هرمز,فولاد هرمزگان جنوب,819,6323230,95984066033,14603,14604,15333,730,5,15083,480,3.29,14604,15333
124,ما,بيمه  ما,809,9340791,83888529470,9060,9090,9200,140,1.55,8980,-80,-0.88,8650,9220
125,وپست,پست بانك ايران,808,4929662,97068987730,18800,19200,19740,940,5,19690,890,4.73,19100,19740
126,ومهان ت.ف0109,اختيارف.تبعي ومهان010902,807,1291500000,1291500000,1000,1,1,-999,-99.9,1,-999,-99.9,1,1
127,خديزل,بهمن  ديزل,803,1711692,61730820709,36596,34767,37690,1094,2.99,36064,-532,-1.45,34767,38000
128,فباهنر,مس‌ شهيدباهنر,798,1508533,30164387060,19300,18990,20000,700,3.63,20000,700,3.63,18990,20240
129,زاگرس,پتروشيمي زاگرس,791,284183,57906257749,195931,200000,204500,8569,4.37,200467,4536,2.32,200000,205189
130,كگل,معدني و صنعتي گل گهر,771,4304319,57841273860,13280,13030,13570,290,2.18,13360,80,0.6,13030,13650
131,كماسه,تامين‌ ماسه‌ ريخته‌گري‌,760,2565647,70997982650,29070,27620,27620,-1450,-4.99,27670,-1400,-4.82,27620,29000
132,البرز,بيمه البرز,738,18846831,64180439126,3352,3353,3398,46,1.37,3405,53,1.58,3350,3470
133,فسازان,غلتك سازان سپاهان,730,2416108,66759488960,28980,27540,28450,-530,-1.83,27630,-1350,-4.66,27540,28780
134,پاكشو,گروه صنعتي پاكشو,718,5186538,30947249270,5990,5770,5970,-20,-0.33,5980,-10,-0.17,5770,6100
135,سپاها,سيمان‌سپاهان‌,701,7789079,52186595800,6410,6260,6730,320,4.99,6700,290,4.52,6260,6730
136,امين يكم2,صندوق درآمد ثابت امين يكم فردا,700,70000000,70000000,10030,1,1,-10029,-99.99,1,-10029,-99.99,1,1
137,وملل,اعتباري ملل,698,17532105,219423369390,12500,12502,12502,2,0.02,12516,16,0.13,12502,12800
138,آسيا,بيمه آسيا,687,14867585,24626950401,1644,1650,1630,-14,-0.85,1656,12,0.73,1600,1690
139,وصنعت,سرمايه گذاري توسعه صنعت وتجارت,684,5046135,26256421360,5050,5100,5230,180,3.56,5200,150,2.97,5100,5280
140,سخزر,سيمان‌ خزر,680,1665791,29976614870,17280,17730,18110,830,4.8,18000,720,4.17,17300,18140
141,شبهرن,نفت‌ بهران‌,657,2317450,23547605670,10150,10000,10160,10,0.1,10160,10,0.1,10000,10360
142,ارزش,صندوق س ارزش آفرين بيدار-سهام,654,4596471,37433518000,8050,8050,8100,50,0.62,8140,90,1.12,8050,8220
143,طلا,صندوق س.پشتوانه طلاي لوتوس,649,2486610,183437411265,73765,72550,73726,-39,-0.05,73770,5,0.01,72550,74047
144,واعتبار,سرمايه گذاري اعتبار ايران,643,3476166,27590278870,8250,8010,7840,-410,-4.97,7940,-310,-3.76,7840,8470
145,دابور,داروسازي‌ ابوريحان‌,639,1812236,47073807070,24860,23620,26100,1240,4.99,25980,1120,4.51,23620,26100
146,رانفور,خدمات‌انفورماتيك‌,636,6369722,37971124740,5960,5830,6000,40,0.67,5960,0,0,5830,6050
147,سپ,پرداخت الكترونيك سامان كيش,631,1031608,24343019750,23690,24470,24020,330,1.39,23640,-50,-0.21,22600,24470
148,كروي,توسعه‌ معادن‌ روي‌ ايران‌,630,2173918,41687352000,18770,18010,19290,520,2.77,19180,410,2.18,18010,19700
149,وشهر,بانك شهر,619,6366992,31879084304,5019,5049,5001,-18,-0.36,5007,-12,-0.24,4999,5089
150,تسه9912,امتياز تسهيلات مسكن اسفند99,616,11363,6019352325,549496,523111,523000,-26496,-4.82,529733,-19763,-3.6,522022,569898
151,كاما,باما,604,2859129,25160335200,9260,8800,8800,-460,-4.97,8930,-330,-3.56,8800,8800
152,همراه,شركت ارتباطات سيار ايران,603,917597,17239157090,19410,18440,18680,-730,-3.76,19280,-130,-0.67,18440,19240
153,شاراك,پتروشيمي شازند,601,2496910,62645329550,24680,24400,25050,370,1.5,25000,320,1.3,24350,25360
154,سرچشمه,سرمايه گذاري مس سرچشمه,601,2580378,16448342918,6348,6380,6417,69,1.09,6374,26,0.41,6212,6498
155,شسپا,نفت سپاهان,579,1522454,21728614130,14070,14000,14200,130,0.92,14150,80,0.57,14000,14590
156,فايرا,آلومينيوم‌ايران‌,579,2289431,38602379900,16870,16100,16700,-170,-1.01,16860,-10,-0.06,16100,17310
157,ياقوت,صندوق س ياقوت آگاه-ثابت,575,5147570,63661626118,12363,12363,12369,6,0.05,12367,4,0.03,12363,12371
158,زر,صندوق س.پشتوانه سكه طلاي زر,573,801642,36226448670,44146,43610,45390,1244,2.82,45190,1044,2.36,43600,45698
159,دكپسول,توليد ژلاتين كپسول ايران,570,993136,25935839825,27176,25818,25818,-1358,-5,26115,-1061,-3.9,25818,28534
160,آريان,سرمايه گذاري پارس آريان,567,12485910,125662835207,10365,10055,10055,-310,-2.99,10064,-301,-2.9,10055,10279
161,رتاپ,تجارت الكترونيك  پارسيان,560,3743795,20389372970,5710,5430,5430,-280,-4.9,5450,-260,-4.55,5430,5560
162,خريخت,صنايع‌ريخته‌گري‌ايران‌,559,11098495,24897710082,2343,2226,2226,-117,-4.99,2243,-100,-4.27,2226,2358
163,حتايد,تايدواترخاورميانه,559,3164456,68385748190,20770,21000,21800,1030,4.96,21610,840,4.04,20060,21800
164,جوين,كشت و صنعت جوين,549,8271647,38786104658,4743,4743,4630,-113,-2.38,4689,-54,-1.14,4601,4775
165,پرداخت,به پرداخت ملت,548,1665808,34683323120,21360,20300,21000,-360,-1.69,20820,-540,-2.53,20300,22420
166,پارسان,گسترش نفت و گاز پارسيان,540,3943364,67818755650,17000,17130,17150,150,0.88,17120,120,0.71,16710,17600
167,وسكاب,س.ص.بازنشستگي كاركنان بانكها,540,4657122,20744011620,4310,4243,4517,207,4.8,4454,144,3.34,4243,4517
168,والبر,سرمايه‌ گذاري‌ البرز(هلدينگ‌,527,2481981,29070215830,11210,11200,11770,560,5,11710,500,4.46,10820,11770
169,آكورد,صندوق س. آرمان آتي كوثر-د,523,4723340,152325548421,32233,32249,32250,17,0.05,32250,17,0.05,32249,32253
170,فنوال,نورد آلومينيوم‌,516,1651725,39260445750,23050,22020,23940,890,3.86,23770,720,3.12,22020,24200
171,مدير,ص.س.مديريت ثروت ص.بازنشستگي-س,515,2130578,15687575860,7257,7104,7380,123,1.69,7363,106,1.46,7104,7450
172,غبشهر,صنعتي‌ بهشهر,515,1936011,35830101730,17780,17500,18660,880,4.95,18510,730,4.11,17500,18660
173,وسينا,بانك سينا,508,10574194,23610540999,2187,2150,2239,52,2.38,2233,46,2.1,2150,2279
174,وتوسم,سرمايه‌گذاري‌توسعه‌ملي‌,507,2942275,19996828670,6490,6780,6810,320,4.93,6800,310,4.78,6600,6810
175,غسالم,سالمين‌,506,6814655,20995952055,2935,3081,3081,146,4.97,3081,146,4.97,3081,3081
176,شفن,پتروشيمي فناوران,502,90765,25661387550,276270,270020,280510,4240,1.53,278030,1760,0.64,270000,289000
177,گوهران,سرمايه گذاري توسعه گوهران اميد,499,1069699,7438078850,6930,6811,6940,10,0.14,6942,12,0.17,6811,7000
178,وسلرستا,شركت س استان لرستان,499,30374017,20046851220,694,660,660,-34,-4.9,666,-28,-4.03,660,660
179,وصنا,گروه‌صنايع‌بهشهرايران‌,493,2140704,9141653889,4179,4151,4258,79,1.89,4239,60,1.44,4151,4380
180,خراسان,پتروشيمي خراسان,486,749524,47653516940,64020,63500,62250,-1770,-2.76,63580,-440,-0.69,61250,64500
181,وساخت,سرمايه‌ گذاري‌ ساختمان‌ايران‌,483,1164260,45808979650,38410,36500,40330,1920,5,39350,940,2.45,36500,40330
182,وپترو,سرمايه‌گذاري صنايع پتروشيمي‌,481,1751250,17867789880,10240,9800,10070,-170,-1.66,10200,-40,-0.39,9800,10650
183,غمينو,شركت صنايع غذايي مينو شرق,476,5034944,47353648320,9899,9405,9405,-494,-4.99,9405,-494,-4.99,9405,9405
184,وبيمه,سرمايه‌ گذاري‌ صنعت‌ بيمه‌,474,71201145,151658438850,2242,2130,2130,-112,-5,2130,-112,-5,2130,2130
185,وتوس,توسعه‌شهري‌توس‌گستر,462,2632927,36239292280,13760,13800,13840,80,0.58,13760,0,0,13600,13930
186,افران,صندوق س افرا نماد پايدار-ثابت,461,8471289,113353992787,13376,13380,13381,5,0.04,13381,5,0.04,13380,13385
187,ونفت,سرمايه‌گذاري‌ صنعت‌ نفت‌,458,2628283,33982086130,12370,12140,12980,610,4.93,12930,560,4.53,12140,12980
188,سشمال,سيمان‌ شمال‌,456,1610251,12806286760,8220,8090,7900,-320,-3.89,7960,-260,-3.16,7820,8140
189,ثمسكن,سرمايه‌گذاري‌ مسكن‌,455,4011342,15469577114,3832,3753,3858,26,0.68,3856,24,0.63,3753,3920
190,فنورد,نوردوقطعات‌ فولادي‌,452,113978,16868642070,148330,143630,147970,-360,-0.24,148000,-330,-0.22,143630,150970
191,ولملت,واسپاري ملت,441,4078856,18744645880,4800,4780,4600,-200,-4.17,4600,-200,-4.17,4560,4890
192,كرماشا,صنايع پتروشيمي كرمانشاه,441,810073,24079631390,29740,28680,29250,-490,-1.65,29730,-10,-0.03,28680,30180
193,فروس,فروسيليس‌ ايران‌,429,4754859,21406667987,4297,4340,4511,214,4.98,4502,205,4.77,4340,4511
194,تسه9908,امتياز تسهيلات مسكن آبان99,425,12124,6384091517,542381,532000,540000,-2381,-0.44,526566,-15815,-2.92,515262,540050
195,واتي,سرمايه‌ گذاري‌ آتيه‌ دماوند,421,1759084,15036666530,8370,8490,8630,260,3.11,8540,170,2.03,8200,8780
196,فردا,صندوق س آواي فرداي زاگرس-ثابت,421,15069978,161943003970,10740,10746,10746,6,0.06,10746,6,0.06,10745,10748
197,دعبيد,لابراتوارداروسازي‌  دكترعبيدي‌,417,559637,13646099260,24540,23940,23990,-550,-2.24,24490,-50,-0.2,23800,25110
198,ثاخت,بين‌المللي‌توسعه‌ساختمان,417,5618578,12029375498,2378,2141,2141,-237,-9.97,2166,-212,-8.92,2141,2141
199,وثنو,سرمايه گذاري ساختماني نوين,401,4621219,18987942306,3996,4110,4077,81,2.03,4109,113,2.83,3961,4115
200,خفنر,فنرسازي‌خاور,399,5353277,22139408710,3970,3990,4160,190,4.79,4140,170,4.28,3990,4160
201,دكوثر,داروسازي‌ كوثر,398,5582406,22922294660,3950,3830,4140,190,4.81,4110,160,4.05,3830,4140
202,تصميم,صندوق س با درآمد ثابت تصميم,397,2845228,46666543099,16393,16401,16404,11,0.07,16402,9,0.05,16400,16404
203,كنور,توسعه معدني و صنعتي صبانور,392,581411,28572186240,48410,48410,49750,1340,2.77,48770,360,0.74,47910,50180
204,وبشهر,توسعه‌ صنايع‌ بهشهر(هلدينگ,385,2295571,21064084140,8970,8910,9310,340,3.79,9110,140,1.56,8810,9410
205,شاوان,پالايش نفت لاوان,368,288290,20112327835,70199,66810,68000,-2199,-3.13,69925,-274,-0.39,66810,71500
206,لوتوس,تامين سرمايه لوتوس پارسيان,367,1876235,12227772060,6290,6300,6540,250,3.97,6410,120,1.91,6300,6580
207,وصندوق,سرمايه‌گذاري‌صندوق‌بازنشستگي‌,361,2779928,35683110390,13300,13180,12750,-550,-4.14,13150,-150,-1.13,12660,13390
208,تيپيكو,سرمايه گذاري دارويي تامين,360,364481,12631898020,33690,34360,34900,1210,3.59,33890,200,0.59,34020,35100
209,شوينده,مديريت صنعت شوينده ت.ص.بهشهر,360,640452,12494164600,18740,18910,19310,570,3.04,19420,680,3.63,18700,19670
210,ضجار7038,اختيارخ وتجارت-1800-1400/07/21,357,12164,3153624000,239,260,274,35,14.64,259,20,8.37,232,300
211,تسه9911,امتياز تسهيلات مسكن بهمن99,353,4823,2534154860,546912,521000,532000,-14912,-2.73,525431,-21481,-3.93,519567,550000
212,فپنتا,سپنتا,348,50301,16216674940,312110,310010,327710,15600,5,322390,10280,3.29,300250,327710
213,پارسيان,بيمه پارسيان,345,3171800,23694002630,7160,7380,7510,350,4.89,7470,310,4.33,7180,7510
214,پارس,پتروشيمي پارس,341,289966,41949528530,143890,143500,143840,-50,-0.03,144220,330,0.23,142400,149600
215,پرديس,سرمايه گذاري پرديس,340,1797558,7536500511,4177,4120,4180,3,0.07,4186,9,0.22,4051,4280
216,شيراز,پتروشيمي‌شيراز,339,1210281,59419351380,49420,49500,49000,-420,-0.85,49220,-200,-0.4,48500,49900
217,سيستم,همكاران سيستم,332,633874,12235346050,19930,18940,20190,260,1.3,19370,-560,-2.81,18940,20190
218,فولاژ,فولاد آلياژي ايران,329,785760,10885920980,14190,14190,13720,-470,-3.31,14130,-60,-0.42,13490,14250
219,بموتو,موتوژن‌,318,661068,29292514910,42530,43000,44650,2120,4.98,44310,1780,4.19,43000,44650
220,وسپه,سرمايه‌گذاري‌ سپه‌,316,1446633,8893022980,5960,5720,6180,220,3.69,6020,60,1.01,5720,6230
221,پكرمان,گروه‌ صنعتي‌ بارز,313,770519,16493801260,21310,21970,21000,-310,-1.45,21380,70,0.33,20870,21970
222,زپارس,ملي كشت و صنعت و دامپروري پارس,312,402710,43884460620,111660,106080,106080,-5580,-5,108970,-2690,-2.41,106080,114900
223,شبصير,توليدات پتروشيمي قائد بصير,311,665157,47703617143,68436,70740,71857,3421,5,71718,3282,4.8,69000,71857
224,شرنگي,شيميايي رنگين,303,71417,18976299405,265471,265471,265471,0,0,265711,240,0.09,265471,272000
225,وگردش,بانك گردشگري,293,2836027,41774443699,15035,14734,14584,-451,-3,14891,-144,-0.96,14584,15000
226,وساشرقي,شركت س استان آذربايجان شرقي,293,15000000,13830000000,970,922,922,-48,-4.95,961,-9,-0.93,922,922
227,مبين,مبين انرژي خليج فارس,291,1253044,18863699720,15150,14900,14760,-390,-2.57,15130,-20,-0.13,14720,15460
228,جم,پتروشيمي جم,285,515364,17450557870,33770,33400,33890,120,0.36,33790,20,0.06,33200,34300
229,زگلدشتح,ح.كشت و دام گلدشت نمونه اصفهان,283,899525,5174038678,5559,5450,5720,161,2.9,5752,193,3.47,5450,5830
230,تسه9910,امتياز تسهيلات مسكن دي99,274,4284,2267956435,549964,540000,522466,-27498,-5,529402,-20562,-3.74,522466,567990
231,فسپا,گروه‌صنعتي‌سپاهان‌,274,786225,25568765380,31090,30800,32640,1550,4.99,32520,1430,4.6,30800,32640
232,واحيا,م .صنايع و معادن احياء سپاهان,272,249838,35790696817,142635,140010,142950,315,0.22,143023,388,0.27,140010,144999
233,سكرما,سيمان‌ كرمان‌,269,793346,9806935560,12440,11820,12460,20,0.16,12390,-50,-0.4,11820,13060
234,فاما,صنعتي‌ آما,267,1359693,18634103990,14380,13670,13670,-710,-4.94,13700,-680,-4.73,13670,14000
235,جم پيلن,پلي پروپيلن جم - جم پيلن,263,420518,27376232700,64310,62810,64710,400,0.62,64730,420,0.65,62810,65630
236,وخاور,بانك خاورميانه,261,4279933,35546883380,8270,8200,8300,30,0.36,8300,30,0.36,8200,8400
237,ثبهساز,بهساز كاشانه تهران,258,6458218,11682916362,1904,1809,1809,-95,-4.99,1828,-76,-3.99,1809,1809
238,سپيدما,صندوق س. سپيد دماوند-د,255,12554660,130392801124,10380,10389,10385,5,0.05,10386,6,0.06,10385,10389
239,وملي,گروه‌ صنعتي‌ ملي‌ (هلدينگ‌,255,65543,9807199090,166250,149630,149630,-16620,-10,155240,-11010,-6.62,149630,149630
240,شپلي,پلي اكريل ايران,253,1727702,15977788096,9067,9248,9248,181,2,9248,181,2,9248,9248
241,شراز,پالايش نفت شيراز,253,103544,9955120555,100834,95840,95793,-5041,-5,99652,-1182,-1.17,95793,98198
242,وحكمت,بيمه حكمت صبا,253,2998412,8113630652,2803,2663,2670,-133,-4.74,2717,-86,-3.07,2663,2817
243,شپاكسا,پاكسان‌,249,641807,12331777280,19180,19430,19190,10,0.05,19210,30,0.16,18600,19480
244,تماوندح,ح . تامين سرمايه دماوند,249,1852249,5571007476,3004,2914,3010,6,0.2,3008,4,0.13,2914,3090
245,تسه9909,امتياز تسهيلات مسكن آذر99,242,3340,1775478393,546440,531825,519118,-27322,-5,531580,-14860,-2.72,519118,572989
246,آساس,صندوق س.آسمان آرماني سهام-س,241,58880,8545920702,144437,144700,144800,363,0.25,145141,704,0.49,144002,146897
247,كاريس,صندوق س.سپهر كاريزما-س,237,750159,7626917752,10099,10130,10079,-20,-0.2,10167,68,0.67,10068,10289
248,كاردان,صندوق س تجارت شاخصي كاردان,233,78245,10709953520,134260,136930,136890,2630,1.96,136880,2620,1.95,134220,139000
249,قشرين,قند شيرين خراسان,232,726500,8058432502,10770,11093,11093,323,3,11031,261,2.42,11000,11093
250,شخارك,پتروشيمي‌ خارك‌,230,181240,7426321510,41640,41490,40710,-930,-2.23,41590,-50,-0.12,40250,41490
251,وكار,بانك‌ كارآفرين‌,229,1873098,5015144998,2748,2651,2635,-113,-4.11,2740,-8,-0.29,2621,2730
252,شنفت,نفت‌ پارس‌,227,281970,12534065870,43840,42010,44070,230,0.52,44010,170,0.39,42010,45100
253,شرانل,نفت ايرانول,225,735388,28729829441,38735,37886,39390,655,1.69,39041,306,0.79,37886,39469
254,گوهر,صندوق سكه طلاي كيان,221,446587,22835559776,50929,49011,51280,351,0.69,51134,205,0.4,49011,51300
255,اطلس,صندوق س.توسعه اندوخته آينده-س,220,43136,8190222645,187049,186330,190150,3101,1.66,189870,2821,1.51,186330,191500
256,سرود,سيمان‌شاهرود,219,951472,15300195960,15840,15300,16010,170,1.07,16080,240,1.52,15300,16450
257,فخاس,فولاد خراسان,214,697586,15890004050,23940,22750,22750,-1190,-4.97,23740,-200,-0.84,22750,23640
258,شتوكا,توكا رنگ فولاد سپاهان,209,379965,10331628315,25897,27191,27191,1294,5,27191,1294,5,27191,27191
259,سكه0012پ01,سكه تمام بهارتحويلي 1روزه رفاه,199,66400,67382570200,1021151,1015000,1013102,-8049,-0.79,1014798,-6353,-0.62,1007730,1019800
260,اخزا910,اسنادخزانه-م10بودجه99-020807,194,276465,167955554456,607578,606000,608684,1106,0.18,607511,-67,-0.01,606000,608687
261,تماوند,تامين سرمايه دماوند,190,1278499,6231145808,4912,4910,4820,-92,-1.87,4895,-17,-0.35,4780,4925
262,حرهشا,رهشاد سپاهان (سهامي عام,189,71086,4370651624,64045,61484,61484,-2561,-4,61700,-2345,-3.66,61484,61484
263,سمتاز,سيمان ممتازان كرمان,187,663917,14807481701,21906,21249,22310,404,1.84,22303,397,1.81,21249,22563
264,كگهر,سنگ آهن گهرزمين,186,305535,12063753209,41562,39484,39484,-2078,-5,41341,-221,-0.53,39484,39507
265,خاتم,صندوق س خاتم ايساتيس پويا-ثابت,186,5151121,57467115501,11155,11160,11161,6,0.05,11156,1,0.01,11155,11161
266,ضپال2007,اختيارخ اپال-32000-1401/02/12,181,9071,504282000,53,100,58,5,9.43,56,3,5.66,46,101
267,اتكاي,بيمه اتكايي ايرانيان,173,5740485,80747873950,14800,14060,14060,-740,-5,14066,-734,-4.96,14060,14730
268,وسگيلا,شركت س استان گيلان,173,8089379,5032203738,654,622,622,-32,-4.89,650,-4,-0.61,622,632
269,بفجر,فجر انرژي خليج فارس,172,264633,5607845160,21220,21220,21040,-180,-0.85,21220,0,0,21040,21650
270,تسه9803,امتياز تسهيلات مسكن خرداد98,172,2276,1157769941,520136,500100,500000,-20136,-3.87,508686,-11450,-2.2,497025,529998
271,سكه0012پ04,سكه تمام بهارتحويلي1روز صادرات,166,110700,111982394600,1020280,1018898,1010000,-10280,-1.01,1011584,-8696,-0.85,1008000,1018898
272,نهال,صندوق س. طلاي سرخ نوويرا,159,153248,1301409511,8526,8230,8514,-12,-0.14,8492,-34,-0.4,8230,8690
273,فيروزه,صندوق شاخص30 شركت فيروزه- سهام,159,55752,6794963010,120430,123290,120550,120,0.1,121880,1450,1.2,120000,123290
274,حسينا,توسعه خدمات دريايي وبندري سينا,158,139038,7407618378,51486,52700,53040,1554,3.02,52402,916,1.78,52140,53750
275,فردا2,صندوق س آواي فرداي زاگرس-ثابت,158,15800000,15800000,10740,1,1,-10739,-99.99,1,-10739,-99.99,1,1
276,بساما,بيمه سامان,157,876276,15391084066,18488,17564,17564,-924,-5,17564,-924,-5,17564,17800
277,تسه9907,امتياز تسهيلات مسكن مهر99,157,1967,1043920800,542457,517000,525000,-17457,-3.22,530717,-11740,-2.16,515335,558999
278,لبوتان,گروه‌صنعتي‌بوتان‌,144,331683,16869287260,50790,53010,50360,-430,-0.85,50860,70,0.14,50360,55660
279,پتاير,ايران‌ تاير,141,5594746,17086354284,3214,3054,3054,-160,-4.98,3054,-160,-4.98,3054,3054
280,ونيكي,سرمايه‌گذاري‌ ملي‌ايران‌,135,695772,5698372680,8620,8190,8190,-430,-4.99,8580,-40,-0.46,8190,8190
281,سحرخيز,صندوق س. گروه زعفران سحرخيز,131,206689,1715970712,8159,8160,8301,142,1.74,8302,143,1.75,8160,8420
282,عيار,صندوق س. پشتوانه طلاي مفيد,127,104751,2731056485,26022,25820,26119,97,0.37,26072,50,0.19,25605,26300
283,تسه9904,امتياز تسهيلات مسكن تير99,125,1210,634555292,545866,531022,520000,-25866,-4.74,524426,-21440,-3.93,518573,538878
284,شلعابح,ح . لعابيران‌,125,1488417,7489684550,5220,5740,5000,-220,-4.21,5030,-190,-3.64,5000,5740
285,ارمغان,ص سرمايه گذاري ارمغان ايرانيان,124,1313169,13288150374,10112,10110,10139,27,0.27,10119,7,0.07,10110,10139
286,تسه9902,امتياز تسهيلات مسكن ارديبهشت99,123,1828,960836150,545718,525555,555000,9282,1.7,525621,-20097,-3.68,518433,555000
287,كخاك,صنايع‌خاك‌چيني‌ايران‌,113,185685,6093117190,33780,32100,33450,-330,-0.98,33480,-300,-0.89,32100,35000
288,وبازار,صندوق س شاخصي بازارآشنا,113,184675,1614607290,8800,8720,8720,-80,-0.91,8740,-60,-0.68,8700,8870
289,ثجوان,تامين مسكن جوانان,112,1197058,12869570558,11083,10751,10751,-332,-3,10751,-332,-3,10751,10751
290,شساخت,مهندسي و ساختمان صنايع نفت,112,539985,22449783441,42781,41498,41498,-1283,-3,42135,-646,-1.51,41498,42200
291,بكهنوج,توليد برق ماهتاب كهنوج,112,2844312,4289222496,1587,1508,1508,-79,-4.98,1563,-24,-1.51,1508,1508
292,تسه9810,امتياز تسهيلات مسكن دي98,111,1706,889120935,539311,522022,512346,-26965,-5,521173,-18138,-3.36,512346,530000
293,فاراك,ماشين‌ سازي‌ اراك‌,110,1616580,3383501940,2203,2093,2093,-110,-4.99,2177,-26,-1.18,2093,2093
294,پارتا,مجتمع‌صنعتي‌آرتاويل‌تاير,105,144937,4925394071,32994,33983,33983,989,3,33157,163,0.49,33983,33983
295,تسه9906,امتياز تسهيلات مسكن شهريور99,102,992,560584209,570871,599414,598998,28127,4.93,565105,-5766,-1.01,542328,599414
296,تسه9905,امتياز تسهيلات مسكن مرداد99,101,1553,866268167,564564,536336,589999,25435,4.51,557803,-6761,-1.2,536336,590000
297,سپاس,صندوق س. پاداش سهامداري توسعه1,99,1446917,14628857022,10105,10112,10113,8,0.08,10110,5,0.05,10109,10113
298,غنوش,نوش‌ مازندران‌,97,71451,3619707660,56280,50660,50660,-5620,-9.99,54770,-1510,-2.68,50660,50660
299,وسهمدا,شركت س استان همدان,92,4062928,3185335552,825,784,784,-41,-4.97,821,-4,-0.48,784,784
300,ضصاد3001,اختيارخ وبصادر-2000-1400/03/12,91,5895,81149000,11,10,10,-1,-9.09,14,3,27.27,8,40
301,دارو,كارخانجات‌داروپخش‌,90,100283,2981986140,31090,29540,30000,-1090,-3.51,30860,-230,-0.74,29540,31100
302,ضملت3001,اختيارخ وبملت-3500-1400/03/19,87,2875,1531568000,578,550,515,-63,-10.9,533,-45,-7.79,400,666
303,ضجار7039,اختيارخ وتجارت-2000-1400/07/21,84,3429,604053000,145,170,150,5,3.45,176,31,21.38,123,229
304,تسه9903,امتياز تسهيلات مسكن خرداد99,80,734,410307016,566591,538262,579889,13298,2.35,559001,-7590,-1.34,538262,594919
305,تسه9804,امتياز تسهيلات مسكن تير98,79,1126,608935774,555295,529450,539999,-15296,-2.75,540796,-14499,-2.61,529450,558998
306,اخزا902,اسنادخزانه-م2بودجه99-011019,78,189750,137107456068,722004,720000,722505,501,0.07,722569,565,0.08,720000,723499
307,زرين,صندوق س. سهام زرين كوروش-س,77,37776,342950601,9082,9082,9000,-82,-0.9,9079,-3,-0.03,8938,9200
308,ضملت3002,اختيارخ وبملت-4000-1400/03/19,77,1570,421194000,490,400,180,-310,-63.27,268,-222,-45.31,150,400
309,كوير,توليدي فولاد سپيد فراب كوير,76,1279098,17012003400,14000,13300,13300,-700,-5,13790,-210,-1.5,13300,13300
310,شصفها,پتروشيمي‌ اصفهان‌,76,39321,4669508535,117656,115410,116101,-1555,-1.32,118016,360,0.31,115410,119999
311,دلر,داروسازي‌ اكسير,76,43918,1272870070,29000,27560,28520,-480,-1.66,29000,0,0,27560,29990
312,ضشنا8001,اختيارخ شپنا-8000-1400/08/16,75,403,880107000,1747,2110,2200,453,25.93,2184,437,25.01,1915,2470
313,مارون,پتروشيمي مارون,75,20578,2960084884,144729,138001,141899,-2830,-1.96,144702,-27,-0.02,138001,145600
314,اتكام,شركت بيمه اتكايي امين,73,1133201,4794649670,4453,4231,4231,-222,-4.99,4378,-75,-1.68,4231,4234
315,وپويا,سرمايه گذاري پويا,73,724954,4134412662,6003,5703,5703,-300,-5,5914,-89,-1.48,5703,5703
316,تسه9806,امتياز تسهيلات مسكن شهريور98,72,875,475724545,551977,540020,550500,-1477,-0.27,543685,-8292,-1.5,536057,558965
317,شكبير,پتروشيمي اميركبير,71,165139,13045543676,81362,78922,79900,-1462,-1.8,81040,-322,-0.4,78922,80500
318,فيروزا,صندوق بادرآمد ثابت فيروزه آسيا,70,546774,12526193168,22901,25191,22977,76,0.33,22909,8,0.03,22890,23090
319,اخزا901,اسنادخزانه-م1بودجه99-010621,69,49993,38499540222,766440,766440,770500,4060,0.53,770099,3659,0.48,766440,771998
320,دارا,صندوق س. دارا الگوريتم-د,68,1183839,11816977268,9976,9982,9982,6,0.06,9982,6,0.06,9976,9988
321,اوصتا,صندوق انديشه ورزان صباتامين -د,67,2068365,38688773920,18703,18705,18712,9,0.05,18705,2,0.01,18701,18712
322,صايند,صندوق س. گنجينه آينده روشن-د,67,649970,6324223780,9736,9722,9744,8,0.08,9730,-6,-0.06,9700,9746
323,ضپاس7029,اختيارخ وپارس-2500-1400/07/28,66,1240,462693000,355,399,357,2,0.56,373,18,5.07,350,400
324,ونيرو,سرمايه‌گذاري‌نيرو,65,817688,1926472928,2480,2356,2356,-124,-5,2463,-17,-0.69,2356,2356
325,سغرب,سيمان‌غرب‌,63,227502,6317774680,27890,27880,26490,-1400,-5.02,27840,-50,-0.18,26490,27880
326,تسه9901,امتياز تسهيلات مسكن فروردين99,63,1225,644213782,545946,519284,518649,-27297,-5,525889,-20057,-3.67,518649,570000
327,فراز,صندوق س.سهام فراز داريك-س,62,74923,774255016,10334,10334,10334,0,0,10334,0,0,10333,10335
328,سبزوا,سيمان لار سبزوار,62,535576,1639933712,3223,3062,3062,-161,-5,3204,-19,-0.59,3062,3062
329,تسه9811,امتياز تسهيلات مسكن بهمن98,62,587,307890471,548057,525000,525000,-23057,-4.21,524515,-23542,-4.3,520655,552500
330,اخزا909,اسنادخزانه-م9بودجه99-020316,60,124517,82169519072,659428,659000,660000,572,0.09,659906,478,0.07,659000,661000
331,نمرينو,ايران‌ مرينوس‌,59,72894,6248473680,81640,85720,85720,4080,5,83050,1410,1.73,85720,85720
332,سكه0011پ02,سكه تمام بهارتحويلي 1روزه ملت,58,13600,13795216900,1019560,1005200,1014090,-5470,-0.54,1014354,-5206,-0.51,1005200,1019900
333,سبهان,سيمان‌ بهبهان‌,57,14969,1177461540,82800,78660,78660,-4140,-5,82220,-580,-0.7,78660,78660
334,ضشنا8002,اختيارخ شپنا-9000-1400/08/16,56,554,921852000,1316,1500,1770,454,34.5,1664,348,26.44,1500,1795
335,تسه9809,امتياز تسهيلات مسكن آذر98,53,439,228194845,545191,525200,530000,-15191,-2.79,519806,-25385,-4.66,517932,530000
336,اراد85,مرابحه عام دولت85-ش.خ010704,53,10500000,9933000000000,1000000,946000,946000,-54000,-5.4,946000,-54000,-5.4,946000,946000
337,وكادو,تكادو,53,725288,8866645800,12603,12225,12225,-378,-3,12225,-378,-3,12225,12225
338,اخزا903,اسنادخزانه-م3بودجه99-011110,53,112735,80520856089,714279,705099,715300,1021,0.14,714249,-30,0,705099,715700
339,انرژي3,سايراشخاص بورس انرژي,53,5741,1288108170,236170,224370,224370,-11800,-5,235890,-280,-0.12,224370,224370
340,افق ملت,صندوق س در سهام افق ملت,53,8452,983006870,116920,115150,116510,-410,-0.35,116300,-620,-0.53,115150,118000
341,تسه9812,امتياز تسهيلات مسكن اسفند98,52,567,313388238,555221,528001,582981,27760,5,552713,-2508,-0.45,527460,582981
342,زعف0008پ16,زعفران0008نگين بيرجند(پ),51,41620,4992723857,119342,120000,119500,158,0.13,119960,618,0.52,119000,120899
343,دانا,بيمه دانا,50,1256287,6947267110,5820,5530,5530,-290,-4.98,5680,-140,-2.41,5530,5530
344,وتوكا,سرمايه‌گذاري‌توكافولاد(هلدينگ,50,347217,2815929870,8530,8110,8110,-420,-4.92,8440,-90,-1.06,8110,8110
345,دمعيار,صندوق س. توازن معيار-د,48,1125799,11279642284,10015,10020,10020,5,0.05,10019,4,0.04,10016,10022
346,آساميد,صندوق س.مشترك آسمان اميد -د,47,1059744,12790059996,12065,12063,12070,5,0.04,12069,4,0.03,12063,12072
347,وآرين,شركت توسعه اقتصادي آرين,46,892136,2931558896,3458,3286,3286,-172,-4.97,3405,-53,-1.53,3286,3286
348,شفارا,پتروشيمي فارابي,46,1224992,3926099360,3304,3205,3205,-99,-3,3263,-41,-1.24,3205,3205
349,گنجين,صندوق س. گنجينه يكم آويد-د,46,83964,1082807186,12881,12887,12890,9,0.07,12896,15,0.12,12887,12903
350,تسه9805,امتياز تسهيلات مسكن مرداد98,45,517,284133993,555451,551045,542010,-13441,-2.42,549582,-5869,-1.06,537130,580022
351,ضصاد8030,اختيارخ وبصادر-1600-1400/08/12,44,1181,341259000,243,200,270,27,11.11,289,46,18.93,200,315
352,اخزا908,اسنادخزانه-م8بودجه99-020606,44,214717,135256122257,629130,629130,630000,870,0.14,629927,797,0.13,629130,630400
353,فمراد,آلومراد,43,28426,2224903020,82380,78270,78270,-4110,-4.99,81730,-650,-0.79,78270,78270
354,تايرا,تراكتورسازي‌ايران‌,43,659397,15199100850,24260,23050,23050,-1210,-4.99,23640,-620,-2.56,23050,23050
355,ضشنا8003,اختيارخ شپنا-10000-1400/08/16,43,534,673272000,1050,1143,1399,349,33.24,1261,211,20.1,1143,1399
356,تسه9808,امتياز تسهيلات مسكن آبان98,41,571,306800533,548316,548502,520901,-27415,-5,537304,-11012,-2.01,520901,550000
357,اخزا907,اسنادخزانه-م7بودجه99-020704,41,58112,35985641641,621665,620000,619011,-2654,-0.43,619246,-2419,-0.39,617012,622444
358,ستران,سيمان‌ تهران‌,41,235660,4901728000,21890,20800,20800,-1090,-4.98,21520,-370,-1.69,20800,20800
359,ضملي7002,اختيارخ فملي-10000-1400/07/11,41,212,571478000,2481,2750,2658,177,7.13,2696,215,8.67,2590,2793
360,وثوق,سرمايه گذاري وثوق امين,41,328675,4886739900,15327,14868,14868,-459,-2.99,15087,-240,-1.57,14868,14868
361,ثعتما,س. ساختماني اعتماد گستر,40,160416,3703684608,23802,23088,23088,-714,-3,23417,-385,-1.62,23088,23088
362,چكاپا,گروه صنايع كاغذ پارس,40,243702,1174643640,5070,4820,4820,-250,-4.93,5050,-20,-0.39,4820,4820
363,وبهمن,سرمايه‌گذاري‌بهمن‌,40,326564,3895908520,12550,11930,11930,-620,-4.94,12380,-170,-1.35,11930,11930
364,بورس,بورس اوراق بهادار تهران,38,73008,2019401280,29110,27660,27660,-1450,-4.98,29040,-70,-0.24,27660,27660
365,اخزا911,اسنادخزانه-م11بودجه99-020906,38,31644,18931003338,597803,597034,598610,807,0.13,598249,446,0.07,597034,598998
366,صنوين,صندوق سرمايه‌گذاري صنوين-مختلط,37,10444,1070219270,101760,101770,102400,640,0.63,102470,710,0.7,101770,103890
367,زعف0008پ20,زعفران0008نگين وحدت جام(پ),37,20196,2419773604,118558,119001,119010,452,0.38,119814,1256,1.06,117110,120500
368,غگيلا,شيرپاستوريزه پگاه گيلان,36,72495,1229152725,17847,16955,16955,-892,-5,17766,-81,-0.45,16955,16955
369,فزرين,زرين معدن آسيا,36,71693,1496232910,21968,20870,20870,-1098,-5,21829,-139,-0.63,20870,20870
370,سمايه,بانك سرمايه,36,1247678,5668201154,4782,4543,4543,-239,-5,4634,-148,-3.09,4543,4543
371,ثباغ,شهر سازي و خانه سازي باغميشه,35,661441,8177395083,13013,12363,12363,-650,-5,12640,-373,-2.87,12363,12363
372,سكه0112پ03,سكه تمام بهارتحويلي1روزه سامان,34,8600,8733729200,1020934,1016500,1015000,-5934,-0.58,1015550,-5384,-0.53,1013000,1017899
373,لسرما,سرما آفرين‌,34,217532,4476808560,21660,20580,20580,-1080,-4.99,21310,-350,-1.62,20580,20580
374,دسبحا,گروه دارويي سبحان,34,564169,9399055540,18510,16660,16660,-1850,-9.99,17700,-810,-4.38,16660,16660
375,معيار,سرمايه گذاري معيار صنعت پارس,33,134405,7398188820,56746,55044,55044,-1702,-3,55465,-1281,-2.26,55044,55044
376,سپر,صندوق س سپر سرمايه بيدار- ثابت,33,352495,4177825458,11848,11852,11852,4,0.03,11852,4,0.03,11852,11854
377,بكام,كارخانجات توليدي شهيد قندي,33,238026,877839888,3882,3688,3688,-194,-5,3870,-12,-0.31,3688,3688
378,اخزا713,اسنادخزانه-م13بودجه97-000518,33,63407,60714098814,959983,912056,959000,-983,-0.1,957530,-2453,-0.26,912056,960000
379,اخزا818,اسنادخزانه-م18بودجه98-010614,33,86150,66718034341,774242,774360,775000,758,0.1,774440,198,0.03,774360,775000
380,كيان2,صندوق س. با درآمد ثابت كيان,32,3200000,3200000,28549,1,1,-28548,-100,1,-28548,-100,1,1
381,كدما,معدني‌ دماوند,32,2994,234819420,82550,78430,78430,-4120,-4.99,82480,-70,-0.08,78430,78430
382,كفپارس,فرآورده‌هاي‌ نسوز پارس‌,31,168775,511388250,3189,3030,3030,-159,-4.99,3183,-6,-0.19,3030,3030
383,وهور,مديريت انرژي اميد  تابان هور,30,399808,756836544,1992,1893,1893,-99,-4.97,1991,-1,-0.05,1893,1893
384,اخزا808,اسنادخزانه-م8بودجه98-000817,30,8404,7672519135,912677,905501,911000,-1677,-0.18,912960,283,0.03,905501,914656
385,اخزا914,اسنادخزانه-م14بودجه99-021025,30,11015,6402613966,582410,581010,582000,-410,-0.07,581263,-1147,-0.2,580811,583000
386,گوهر2,صندوق سكه طلاي كيان,30,300000,300000,50929,1,1,-50928,-100,1,-50928,-100,1,1
387,اخزا811,اسنادخزانه-م11بودجه98-001013,30,46728,41335105169,884794,884000,884980,186,0.02,884590,-204,-0.02,880820,885935
388,وسهرمز,شركت س استان هرمزگان,29,1500000,1305000000,915,870,870,-45,-4.92,913,-2,-0.22,870,870
389,هاي وب,داده گسترعصرنوين-هاي وب,29,43589,429351650,10360,9850,9850,-510,-4.92,10350,-10,-0.1,9850,9850
390,تسه9807,امتياز تسهيلات مسكن مهر98,29,107,58181748,550368,543500,543500,-6868,-1.25,543755,-6613,-1.2,543500,545000
391,شصدف,صنعتي دوده فام,29,22133,668704329,31803,30213,30213,-1590,-5,31726,-77,-0.24,30213,30213
392,دماوند,توليد نيروي برق دماوند,28,32492,947206784,30686,29152,29152,-1534,-5,30663,-23,-0.07,29152,29152
393,فرابورس,فرابورس ايران,27,33214,976292316,30941,29394,29394,-1547,-5,30895,-46,-0.15,29394,29394
394,اخزا809,اسنادخزانه-م9بودجه98-000923,27,9009,8054871820,893301,892001,893000,-301,-0.03,894092,791,0.09,892001,895000
395,غشهداب,كشت و صنعت شهداب ناب خراسان,27,90341,335887838,3913,3718,3718,-195,-4.98,3908,-5,-0.13,3718,3718
396,اخزا815,اسنادخزانه-م15بودجه98-010406,27,40653,32676916571,803215,804000,804990,1775,0.22,803801,586,0.07,803215,804990
397,دلقما,دارويي‌ لقمان‌,26,172974,4030294200,24520,23300,23300,-1220,-4.98,24180,-340,-1.39,23300,23300
398,بذر,صندوق س بذر اميد آفرين-سهام,26,4121,346757400,83330,83060,83650,320,0.38,84140,810,0.97,83060,84990
399,آتيمس,صندوق س.آرمان آتيه درخشان مس-س,26,2816,468029736,164237,166049,165011,774,0.47,166204,1967,1.2,164001,167400
400,فرآور,فرآوري‌موادمعدني‌ايران‌,26,102847,3055584370,31270,29710,29710,-1560,-4.99,30930,-340,-1.09,29710,29710
401,سخاش,سيمان‌خاش‌,26,8230,1065373500,136260,129450,129450,-6810,-5,135750,-510,-0.37,129450,129450
402,ولانا,شركت ليزينگ آريا دانا,25,40460,1349786060,35116,33361,33361,-1755,-5,34858,-258,-0.73,33361,33361
403,اخزا812,اسنادخزانه-م12بودجه98-001111,24,51673,45095373661,872699,873010,870020,-2679,-0.31,872707,8,0,870001,878990
404,چخزر,صنايع چوب خزر كاسپين,24,15680,487773440,32745,31108,31108,-1637,-5,32688,-57,-0.17,31108,31108
405,كالا,بورس كالاي ايران,24,35287,1040260760,31030,29480,29480,-1550,-5,30980,-50,-0.16,29480,29480
406,اوصتا2,صندوق انديشه ورزان صباتامين -د,23,2300000,2300000,18703,1,1,-18702,-99.99,1,-18702,-99.99,1,1
407,توريل,توکاريل,23,55944,858852288,16160,15352,15352,-808,-5,16125,-35,-0.22,15352,15352
408,تمحركه,ماشين سازي نيرو محركه,23,52822,954176608,18622,18064,18064,-558,-3,18567,-55,-0.3,18064,18064
409,ثروتم,صندوق س. ثروت آفرين پارسيان-س,23,58320,4130518030,70870,70660,70858,-12,-0.02,70825,-45,-0.06,69810,71500
410,چكارن,كارتن‌ ايران‌,23,97034,294983360,3200,3040,3040,-160,-5,3197,-3,-0.09,3040,3040
411,ثشاهد,سرمايه‌ گذاري‌ شاهد,23,25703,408163640,16710,15880,15880,-830,-4.97,16700,-10,-0.06,15880,15880
412,ضملت3004,اختيارخ وبملت-5000-1400/03/19,22,844,15634000,2,10,11,9,450,19,17,850,10,89
413,نوين,بيمه نوين,22,128101,704299298,5787,5498,5498,-289,-4.99,5773,-14,-0.24,5498,5498
414,زعف0008پ05,زعفران0008نگين زرين(پ),22,4338,527269830,120516,120000,121900,1384,1.15,121547,1031,0.86,120000,122000
415,دسانكو,داروسازي سبحان انكولوژي,22,161393,2256919712,14720,13984,13984,-736,-5,14603,-117,-0.79,13984,13984
416,آسام,صندوق س.آرمان سپهر آشنا-م,21,7280,738692660,101299,100997,101517,218,0.22,101469,170,0.17,99141,101999
417,شپاس,نفت پاسارگاد,21,36539,711889337,20508,19483,19483,-1025,-5,20469,-39,-0.19,19483,19483
418,اراد33,مرابحه عام دولت3-ش.خ 0303,21,125000,108250000000,889798,865000,870000,-19798,-2.22,866000,-23798,-2.67,865000,870000
419,شاروم,پتروشيمي اروميه,21,17260,313683240,19130,18174,18174,-956,-5,19109,-21,-0.11,18174,18174
420,زنگان,صنعت روي زنگان,21,56823,5619567408,104101,98896,98896,-5205,-5,102046,-2055,-1.97,98896,98896
421,دپارس,پارس‌ دارو,21,212924,7978262280,39440,37470,37470,-1970,-4.99,38340,-1100,-2.79,37470,37470
422,كهمدا,شيشه‌ همدان‌,20,52656,497072640,9930,9440,9440,-490,-4.93,9910,-20,-0.2,9440,9440
423,اخزا813,اسنادخزانه-م13بودجه98-010219,20,12633,10442689416,824946,826000,827400,2454,0.3,826620,1674,0.2,826000,827400
424,اخزا814,اسنادخزانه-م14بودجه98-010318,20,38118,30979941257,812145,812010,812800,655,0.08,812738,593,0.07,812010,812811
425,وبرق,س.کارکنان صنعت برق زنجان وقزوي,20,122145,4885067130,41230,39994,39994,-1236,-3,40569,-661,-1.6,39994,39994
426,كلوند,كاشي‌ الوند,20,60116,1160238800,20310,19300,19300,-1010,-4.97,20230,-80,-0.39,19300,19300
427,ختور,رادياتور ايران‌,20,159178,2873162900,19000,18050,18050,-950,-5,18810,-190,-1,18050,18050
428,قثابت,قند ثابت‌ خراسان‌,19,4229,242279410,60300,57290,57290,-3010,-4.99,60250,-50,-0.08,57290,57290
429,اخزا821,اسنادخزانه-م21بودجه98-020906,19,17189,10257613039,600368,594112,597054,-3314,-0.55,596754,-3614,-0.6,594100,598555
430,غزر,صنعتي زر ماكارون,19,11587,267775570,24320,23110,23110,-1210,-4.98,24310,-10,-0.04,23110,23110
431,نگين,ص.س. زمين و ساختمان نگين شهرري,19,1500499,71348833370,47540,47550,47850,310,0.65,47550,10,0.02,47540,47980
432,بايكا,كارخانجات كابلسازي ‌ايران‌,19,131823,5026410990,39309,38130,38130,-1179,-3,38660,-649,-1.65,38130,38130
433,شاملا,معدني‌ املاح‌  ايران‌,19,60992,2182903680,37670,35790,35790,-1880,-4.99,37370,-300,-0.8,35790,35790
434,دتوزيعح,ح . توزيع دارو پخش,19,37171,1161758534,32667,34300,31034,-1633,-5,31254,-1413,-4.33,31034,34300
435,لخزر,پارس‌ خزر,18,860,149020800,182390,173280,173280,-9110,-4.99,182290,-100,-0.05,173280,173280
436,ضجار7037,اختيارخ وتجارت-1600-1400/07/21,18,187,76354000,386,440,380,-6,-1.55,408,22,5.7,342,440
437,وپخش,داروپخش‌ (هلدينگ‌,18,15359,1384153080,94860,90120,90120,-4740,-5,94640,-220,-0.23,90120,90120
438,مفاخر,توسعه فناوري اطلاعات خوارزمي,18,260768,14169090048,57195,54336,54336,-2859,-5,54336,-2859,-5,54336,54336
439,اراد50,مرابحه عام دولت5-ش.خ0302,18,335000,335000299500,1000000,1000000,1000001,1,0,1000001,1,0,1000000,1000001
440,الماس,صندوق س.امين تدبيرگران فردا-س,18,1305,128108119,99221,97011,98150,-1071,-1.08,98167,-1054,-1.06,97011,99997
441,سفانو,سيمان فارس نو,17,17143,462518140,28390,26980,26980,-1410,-4.97,28340,-50,-0.18,26980,26980
442,وسگلستا,شركت س استان گلستان,17,1434516,1689859848,1240,1178,1178,-62,-5,1238,-2,-0.16,1178,1178
443,غفارس,شير پاستوريزه پگاه فارس,17,62511,1082065410,18221,17310,17310,-911,-5,18152,-69,-0.38,17310,17310
444,سجام,مجتمع سيمان غرب آسيا,17,35628,137915988,3990,3871,3871,-119,-2.98,3988,-2,-0.05,3871,3871
445,طلا2,صندوق س.پشتوانه طلاي لوتوس,17,1700000,1700000,73765,1,1,-73764,-100,1,-73764,-100,1,1
446,فسرب,ملي‌ سرب‌وروي‌ ايران‌,16,3526,241672040,72140,68540,68540,-3600,-4.99,72080,-60,-0.08,68540,68540
447,اخزا806,اسنادخزانه-م6بودجه98-000519,16,4941,4734521568,959140,959200,957001,-2139,-0.22,958211,-929,-0.1,952587,959700
448,سيمرغ,سيمرغ,16,31736,543002960,18010,17110,17110,-900,-5,17980,-30,-0.17,17110,17110
449,تليسه,دامداري تليسه نمونه,16,50494,206116508,4296,4082,4082,-214,-4.98,4293,-3,-0.07,4082,4082
450,سمگا,گروه سرمايه گذاري ميراث فرهنگي,16,23484,637661052,28582,27153,27153,-1429,-5,28563,-19,-0.07,27153,27153
451,تملي703,تسهيلات مسكن ب. ملي-خرداد97,15,317,215127464,693427,728098,728000,34573,4.99,678636,-14791,-2.13,658800,728098
452,بالبر,كابل‌ البرز,15,2058,115392060,59020,56070,56070,-2950,-5,59000,-20,-0.03,56070,56070
453,اخزا817,اسنادخزانه-م17بودجه98-010512,15,14691,11577341983,786588,784304,788400,1812,0.23,788057,1469,0.19,784303,788500
454,ضفار3000,اختيارخ فارس-8000-1400/03/05,15,83,46588000,461,520,532,71,15.4,561,100,21.69,520,799
455,كاذر,فرآورده‌هاي‌نسوزآذر,14,14398,226912480,16580,15760,15760,-820,-4.95,16570,-10,-0.06,15760,15760
456,كلر,كلر پارس,14,7320,897651600,129084,122630,122630,-6454,-5,128723,-361,-0.28,122630,122630
457,كسرا,سراميك‌هاي‌صنعتي‌اردكان‌,14,23885,433990450,19120,18170,18170,-950,-4.97,19090,-30,-0.16,18170,18170
458,دسينا,داروسازي‌ سينا,14,28961,566187550,20570,19550,19550,-1020,-4.96,20530,-40,-0.19,19550,19550
459,زعف0008پ09,زعفران0008نگين نوين(پ),14,10989,1321680000,119178,120000,120000,822,0.69,120273,1095,0.92,120000,121000
460,وملت,سرمايه گذاري ملت,13,37067,158683827,4368,4281,4281,-87,-1.99,4365,-3,-0.07,4281,4281
461,خفولا,خدمات فني فولاد يزد,13,7355,307968560,43166,41872,41872,-1294,-3,43125,-41,-0.09,41872,41872
462,اخزا905,اسنادخزانه-م5بودجه99-020218,13,52971,35585627297,671875,671875,674602,2727,0.41,671794,-81,-0.01,670513,674602
463,وآيند,بانك  آينده,13,75826,1212154436,16312,15986,15986,-326,-2,16308,-4,-0.02,15986,15986
464,قصفها,قنداصفهان‌,13,6080,880992000,152520,144900,144900,-7620,-5,152040,-480,-0.31,144900,144900
465,سپيدما2,صندوق س. سپيد دماوند-د,13,130000000,130000000,10380,1,1,-10379,-99.99,1,-10379,-99.99,1,1
466,زعف0008پ08,زعفران0008نگين روستا(پ),13,21150,2554141004,118381,119000,119000,619,0.52,120763,2382,2.01,119000,121888
467,تملي807,تسهيلات مسكن ب. ملي-مهر98,12,223,117164597,513542,487865,539219,25677,5,525402,11860,2.31,487865,539219
468,شكف,كف,12,2097,201993525,100338,96325,96325,-4013,-4,100254,-84,-0.08,96325,96325
469,پلاسك,پلاسكوكار,12,504342,3500133480,7300,6940,6940,-360,-4.93,7210,-90,-1.23,6940,6940
470,شسم,توليد سموم‌ علف‌ كش,12,6916,665153216,92477,96176,96176,3699,4,92950,473,0.51,96176,96176
471,ضملت3000,اختيارخ وبملت-3000-1400/03/19,12,141,134201000,957,999,835,-122,-12.75,952,-5,-0.52,833,1000
472,كبافق,معادن‌ بافق‌,12,5195,230034600,46610,44280,44280,-2330,-5,46590,-20,-0.04,44280,44280
473,حخزر,كشتيراني درياي خزر,12,504031,12459142289,26019,24719,24719,-1300,-5,24779,-1240,-4.77,24719,24719
474,ثفارس,عمران‌وتوسعه‌فارس‌,12,20761,191208810,9690,9210,9210,-480,-4.95,9680,-10,-0.1,9210,9210
475,بخاور,بيمه زندگي خاورميانه,12,51959,310455025,6289,5975,5975,-314,-4.99,6282,-7,-0.11,5975,5975
476,گدنا,تهيه توزيع غذاي دنا آفرين فدك,11,3377,108185572,33722,32036,32036,-1686,-5,33709,-13,-0.04,32036,32036
477,بهپاك,صنعتي بهپاك,11,24341,155855423,6740,6403,6403,-337,-5,6736,-4,-0.06,6403,6403
478,بميلا,توسعه بازرگاني آهن وفولادميلاد,11,52934,620862886,12346,11729,11729,-617,-5,12306,-40,-0.32,11729,11729
479,ضترا8056,اختيارخ شتران-6000-1400/08/09,11,55,114991000,1953,2500,2000,47,2.41,2091,138,7.07,1999,2500
480,صنفت0312,صكوك منفعت نفت0312-6ماهه 18/5%,11,51707,51823130000,1000000,1000000,1002370,2370,0.24,1002246,2246,0.22,1000000,1002370
481,ضمخا7075,اختيارخ اخابر-9000-1400/07/28,11,135,64075000,490,590,555,65,13.27,475,-15,-3.06,450,600
482,زعف0008پ19,زعفران0008نگين تروند قاينات(پ),11,7123,850128500,118018,119001,119500,1482,1.26,119350,1332,1.13,119000,121500
483,شكربن,كربن‌ ايران‌,11,7525,513731750,71860,68270,68270,-3590,-5,71720,-140,-0.19,68270,68270
484,وگستر,گسترش سرمايه گذاري ايرانيان,11,12438,223485984,18913,17968,17968,-945,-5,18898,-15,-0.08,17968,17968
485,ضخود4002,اختيارخ خودرو-1800-1400/04/02,11,348,46980000,117,135,135,18,15.38,135,18,15.38,135,135
486,ضملي7004,اختيارخ فملي-14000-1400/07/11,11,85,67630000,726,810,750,24,3.31,796,70,9.64,750,810
487,آكورد2,صندوق س. آرمان آتي كوثر-د,10,1000000,1000000,32233,1,1,-32232,-100,1,-32232,-100,1,1
488,لابسا,آبسال‌,10,5574,261197640,49320,46860,46860,-2460,-4.99,49270,-50,-0.1,46860,46860
489,حبندر,دريايي و کشتيراني خط دريابندر,10,100814,3164249018,32357,31387,31387,-970,-3,32034,-323,-1,31387,31387
490,تپمپي,پمپ‌ سازي‌ ايران‌,10,17317,312052340,18960,18020,18020,-940,-4.96,18940,-20,-0.11,18020,18020
491,زكوثر,سرمايه گذاري كشاورزي كوثر,10,15920,318081600,21030,19980,19980,-1050,-4.99,21010,-20,-0.1,19980,19980
492,اراد35,مرابحه عام دولت3-ش.خ 0103,10,23000,22699060000,996479,949850,1000000,3521,0.35,986916,-9563,-0.96,949850,1000000
493,شلعاب,لعابيران‌,10,17212,215322120,13160,12510,12510,-650,-4.94,13150,-10,-0.08,12510,12510
494,كمنگنز,معادن‌منگنزايران‌,10,3177,238020840,78860,74920,74920,-3940,-5,78790,-70,-0.09,74920,74920
495,باران,بيمه زندگي باران50%تاديه,10,35320,140361680,3859,3974,3974,115,2.98,3861,2,0.05,3974,3974
496,غگلپا,شير پاستوريزه پگاه گلپايگان,10,23171,1184756401,53822,51131,51131,-2691,-5,53558,-264,-0.49,51131,51131
497,هنوري102,اختيارف ت نوري73761-01/02/15,9,17392,80229296,4553,4613,4613,60,1.32,4613,60,1.32,4613,4613
498,ضخود7072,اختيارخ خودرو-1400-1400/07/07,9,164,80360000,400,490,490,90,22.5,490,90,22.5,490,490
499,اميد,تامين سرمايه اميد,9,9160,66410000,7630,7250,7250,-380,-4.98,7630,0,0,7250,7250
500,خبازرس,بازرسي مهندسي و صنعتي ايران,9,26714,654706712,25265,24508,24508,-757,-3,25214,-51,-0.2,24508,24508
501,بنيرو,نيروترانس‌,9,6663,94881120,14980,14240,14240,-740,-4.94,14980,0,0,14240,14240
502,اخزا904,اسنادخزانه-م4بودجه99-011215,9,9032,6333761920,702404,700000,701210,-1194,-0.17,701258,-1146,-0.16,700000,702999
503,وآوا,سرمايه گذاري آوا نوين,9,29862,251766522,8874,8431,8431,-443,-4.99,8866,-8,-0.09,8431,8431
504,ضصاد3000,اختيارخ وبصادر-1800-1400/03/12,9,162,28634000,90,31,85,-5,-5.56,177,87,96.67,31,478
505,پكوير,كوير تاير,9,23014,276168000,12630,12000,12000,-630,-4.99,12620,-10,-0.08,12000,12000
506,لپارس,پارس‌ الكتريك‌,9,2957,246643370,87800,83410,83410,-4390,-5,87720,-80,-0.09,83410,83410
507,اخزا804,اسنادخزانه-م4بودجه98-000421,9,5199,5060075882,974000,975500,973000,-1000,-0.1,973279,-721,-0.07,973000,975500
508,رنيك,جنرال مكانيك,9,61729,1303469564,22227,21116,21116,-1111,-5,22125,-102,-0.46,21116,21116
509,ساربيل,سيمان آرتا اردبيل,9,1998,101458440,53450,50780,50780,-2670,-5,53430,-20,-0.04,50780,50780
510,اخزا721,اسنادخزانه-م21بودجه97-000728,9,462,425462948,921022,924500,920162,-860,-0.09,920915,-107,-0.01,920000,924500
511,آپ,آسان پرداخت پرشين,9,20481,319093980,16400,15580,15580,-820,-5,16380,-20,-0.12,15580,15580
512,كرازي,كارخانجات‌توليدي‌شيشه‌رازي‌,9,4979,102666980,21700,20620,20620,-1080,-4.98,21690,-10,-0.05,20620,20620
513,ديران,ايران‌دارو,9,12734,208964940,17270,16410,16410,-860,-4.98,17260,-10,-0.06,16410,16410
514,داريك,صندوق س.اعتماد داريك-د,9,103900,1100593112,10415,10400,10599,184,1.77,10593,178,1.71,10400,10599
515,افاد84,منفعت دولت8-ش.خاص ساير0205,8,200000,192000000000,980000,960000,960000,-20000,-2.04,960000,-20000,-2.04,960000,960000
516,تپكو,توليدتجهيزات‌سنگين‌هپكو,8,17563,93083900,5408,5300,5300,-108,-2,5408,0,0,5300,5300
517,دامين,داروسازي‌ امين‌,8,23246,110883420,5020,4770,4770,-250,-4.98,5020,0,0,4770,4770
518,ساذري,آذريت‌,8,279004,1786183608,6098,6402,6402,304,4.99,6148,50,0.82,6402,6402
519,غشصفا,شيرپاستوريزه‌پگاه‌اصفهان‌,8,62580,1624576800,27320,25960,25960,-1360,-4.98,27160,-160,-0.59,25960,25960
520,لكما,كارخانجات‌مخابراتي‌ايران‌,8,31060,183595660,6093,5911,5911,-182,-2.99,6090,-3,-0.05,5911,5911
521,ودي,بيمه  دي,8,14279,273357176,20151,19144,19144,-1007,-5,20137,-14,-0.07,19144,19144
522,غاذر,كشت‌وصنعت‌پياذر,8,4500,238320000,55740,52960,52960,-2780,-4.99,55690,-50,-0.09,52960,52960
523,دتماد,توليدمواداوليه‌داروپخش‌,8,6985,275418550,41500,39430,39430,-2070,-4.99,41460,-40,-0.1,39430,39430
524,خچرخش,چرخشگر,8,151390,1963528300,13650,12970,12970,-680,-4.98,13560,-90,-0.66,12970,12970
525,اخزا722,اسنادخزانه-م22بودجه97-000428,8,11793,11158085560,971600,971000,969999,-1601,-0.16,946162,-25438,-2.62,941399,971001
526,ريشمك,توليد و صادرات ريشمك,8,31402,1641319736,55018,52268,52268,-2750,-5,54694,-324,-0.59,52268,52268
527,مرقام,ايران‌ارقام‌,8,7759,142843190,19370,18410,18410,-960,-4.96,19360,-10,-0.05,18410,18410
528,خمهر,مهركام‌پارس‌,8,133707,286534101,2255,2143,2143,-112,-4.97,2253,-2,-0.09,2143,2143
529,دتوليد,داروسازي توليد دارو,7,111351,2773308006,26216,24906,24906,-1310,-5,25960,-256,-0.98,24906,24906
530,كپشيرح,ح . پشم‌شيشه‌ايران‌,7,300183,8210005050,13175,27350,27350,14175,107.59,27350,14175,107.59,27350,27350
531,قيستو,شركت قند بيستون,7,152164,2453644500,16454,16125,16125,-329,-2,16282,-172,-1.05,16125,16125
532,حفارس,حمل و نقل بين المللي خليج فارس,7,17465,78417850,4726,4490,4490,-236,-4.99,4725,-1,-0.02,4490,4490
533,بزاگرس,نيروگاه زاگرس كوثر,7,42560,288684480,7139,6783,6783,-356,-4.99,7133,-6,-0.08,6783,6783
534,بمپنا,توليد برق عسلويه  مپنا,7,9083,569767507,66030,62729,62729,-3301,-5,65927,-103,-0.16,62729,62729
535,اخزا816,اسنادخزانه-م16بودجه98-010503,7,5140,4072634500,791866,792300,792300,434,0.05,792341,475,0.06,792300,794000
536,كگاز,شيشه‌ و گاز,7,3172,55573440,18440,17520,17520,-920,-4.99,18440,0,0,17520,17520
537,زبينا,كشاورزي و دامپروري بينالود,7,29581,109568024,3898,3704,3704,-194,-4.98,3897,-1,-0.03,3704,3704
538,ددام,داروسازي زاگرس فارمد پارس,7,6206,100040720,16960,16120,16120,-840,-4.95,16950,-10,-0.06,16120,16120
539,رافزا,رايان هم افزا,6,309,31084164,105890,100596,100596,-5294,-5,105878,-12,-0.01,100596,100596
540,ضخود7074,اختيارخ خودرو-1800-1400/07/07,6,216,39528000,167,183,183,16,9.58,183,16,9.58,183,183
541,سخند,صندوق س.سپهرخبرگان نفت-د,6,3000,29938000,10003,9900,9906,-97,-0.97,9979,-24,-0.24,9900,10055
542,خرينگ,رينگ‌سازي‌مشهد,6,5924,281212280,49960,47470,47470,-2490,-4.98,49910,-50,-0.1,47470,47470
543,وسديد,گروه ‌صنعتي‌سديد,6,14691,41604912,2889,2832,2832,-57,-1.97,2889,0,0,2832,2832
544,هفجر102,اختيارف ت بفجر26401-01/02/11,6,18944,12881920,639,680,680,41,6.42,680,41,6.42,680,680
545,ضملي7003,اختيارخ فملي-12000-1400/07/11,6,99,141210000,1316,1575,1400,84,6.38,1426,110,8.36,1400,1575
546,كيميا,معدني كيمياي زنجان گستران,6,7796,129959320,17547,16670,16670,-877,-5,17539,-8,-0.05,16670,16670
547,اعتلا,شركت سرمايه گذاري اعتلاء البرز,6,31015,211770420,7187,6828,6828,-359,-5,7182,-5,-0.07,6828,6828
548,حريل,ريل پردازسير,6,15372,80149608,5488,5214,5214,-274,-4.99,5486,-2,-0.04,5214,5214
549,زمگسا,كشاورزي‌ ودامپروي‌ مگسال‌,6,2481,76588470,32490,30870,30870,-1620,-4.99,32480,-10,-0.03,30870,30870
550,بالاس,مهندسي ساختمان تاسيسات راه آهن,6,140000,7451500000,56026,53225,53225,-2801,-5,54561,-1465,-2.61,53225,53225
551,زملارد,كشاورزي و دامپروري ملارد شير,6,1179,40905405,36521,34695,34695,-1826,-5,36516,-5,-0.01,34695,34695
552,ضسپا3002,اختيارخ خساپا-1800-1400/03/26,5,500,25000000,50,50,50,0,0,50,0,0,50,50
553,سنير,سيمان‌ سفيد ني‌ريز,5,1750,408992500,246010,233710,233710,-12300,-5,245660,-350,-0.14,233710,233710
554,اخزا716,اسنادخزانه-م16بودجه97-000407,5,1404,1374952461,983032,985000,982999,-33,0,979311,-3721,-0.38,976000,985000
555,خنصير,مهندسي‌نصيرماشين‌,5,1379,141857730,108280,102870,102870,-5410,-5,108230,-50,-0.05,102870,102870
556,زدشت,كشت و صنعت دشت خرم دره,5,2405,64321725,28152,26745,26745,-1407,-5,28145,-7,-0.02,26745,26745
557,حتوكا,حمل‌ونقل‌توكا,5,1850,37610500,21400,20330,20330,-1070,-5,21400,0,0,20330,20330
558,ومهان4,گروه توسعه مالي مهر آيندگان,5,1110694000,12899600116000,11540,11614,11614,74,0.64,11614,74,0.64,11614,11614
559,غشهد,شهد ايران ‌,5,21604,142370360,6930,6590,6590,-340,-4.91,6930,0,0,6590,6590
560,خمحور,توليدمحورخودرو,5,1652,87143000,55520,52750,52750,-2770,-4.99,55500,-20,-0.04,52750,52750
561,ومعلم,بيمه معلم,5,5788,27325148,4969,4721,4721,-248,-4.99,4969,0,0,4721,4721
562,اخزا820,اسنادخزانه-م20بودجه98-020806,5,107,65018225,609158,607195,608001,-1157,-0.19,607647,-1511,-0.25,607195,608001
563,ضپاس7028,اختيارخ وپارس-2000-1400/07/28,5,79,59104000,702,750,799,97,13.82,748,46,6.55,743,799
564,قشكر,شكرشاهرود,5,16921,59815735,3721,3535,3535,-186,-5,3720,-1,-0.03,3535,3535
565,ضغدر3001,اختيارخ وغدير-7200-1400/03/26,5,20,48000000,2650,2400,2400,-250,-9.43,2400,-250,-9.43,2400,2400
566,فماك,ماداكتو استيل كرد,5,200000,4060000000,20500,20300,20300,-200,-0.98,20300,-200,-0.98,20300,20300
567,اخزا805,اسنادخزانه-م5بودجه98-000422,5,306,297692595,971535,974000,979998,8463,0.87,972852,1317,0.14,972633,979998
568,ضفار3001,اختيارخ فارس-9000-1400/03/05,5,107,947000,10,40,1,-9,-90,9,-1,-10,1,40
569,كحافظ,كاشي‌ وسراميك‌ حافظ‌,5,7639,85556800,11780,11200,11200,-580,-4.92,11780,0,0,11200,11200
570,ثنوسا,نوسازي‌وساختمان‌تهران‌,5,2870,34669600,12710,12080,12080,-630,-4.96,12710,0,0,12080,12080
571,كشرق,صنعتي و معدني شمال شرق شاهرود,5,10160,849111840,87972,83574,83574,-4398,-5,87703,-269,-0.31,83574,83574
572,اراد36,مرابحه عام دولت3-ش.خ 0104,5,101000,95506000000,950000,945600,946000,-4000,-0.42,945604,-4396,-0.46,945600,946000
573,ساروج,بين المللي ساروج بوشهر,5,19363,328662792,16962,16962,17460,498,2.94,16962,0,0,16962,17460
574,سفار,سيمان‌فارس‌,5,580,82499200,149720,142240,142240,-7480,-5,149680,-40,-0.03,142240,142240
575,ضمخا7078,اختيارخ اخابر-8000-1400/07/28,5,135,81000000,715,600,600,-115,-16.08,600,-115,-16.08,600,600
576,كيسون,شركت كيسون,5,14287,157114139,11455,10997,10997,-458,-4,11452,-3,-0.03,10997,10997
577,شكلر,نيروكلر,5,1160,45309600,41110,39060,39060,-2050,-4.99,41100,-10,-0.02,39060,39060
578,خشرق,الكتريك‌ خودرو شرق‌,5,24455,336011700,14460,13740,13740,-720,-4.98,14440,-20,-0.14,13740,13740
579,ساينا,صنايع بهداشتي ساينا,5,357,49515186,145997,138698,138698,-7299,-5,145972,-25,-0.02,138698,138698
580,خكاوه,سايپا ديزل,5,11868,41229432,3581,3474,3474,-107,-2.99,3581,0,0,3474,3474
581,سكرد,سيمان كردستان,5,4519,42071890,9790,9310,9310,-480,-4.9,9790,0,0,9310,9310
582,شپارس,بين‌ المللي‌ محصولات‌  پارس‌,4,15396,324085800,22150,21050,21050,-1100,-4.97,22120,-30,-0.14,21050,21050
583,غشوكو,شوكو پارس,4,899,24810602,28451,27598,27598,-853,-3,28449,-2,-0.01,27598,27598
584,تبرك,گروه كارخانجات صنعتي تبرك,4,2361,44349024,19772,18784,18784,-988,-5,19769,-3,-0.02,18784,18784
585,ضبدر3002,اختيارخ شبندر-18000-1400/03/30,4,19,76900000,4358,3500,4800,442,10.14,4047,-311,-7.14,3500,4800
586,تملي701,تسهيلات مسكن ب. ملي-فروردين97,4,51,30063888,561418,589488,589488,28070,5,589488,28070,5,589488,589488
587,فوكا,فولاد كاويان,4,6594,72652692,11358,11018,11018,-340,-2.99,11357,-1,-0.01,11018,11018
588,ضپنا8000,اختيارخ رمپنا-10000-1400/08/05,4,23,69200000,3100,3200,2900,-200,-6.45,3009,-91,-2.94,2900,3200
589,كتوكا,توليدي و خدمات صنايع نسوز توكا,4,2115,68896125,34289,32575,32575,-1714,-5,34281,-8,-0.02,32575,32575
590,فلوله,لوله‌وماشين‌سازي‌ايران‌,4,12918,266239980,21690,20610,20610,-1080,-4.98,21670,-20,-0.09,20610,20610
591,تملي709,تسهيلات مسكن ب. ملي-آذر97,4,76,65817216,911595,866016,866016,-45579,-5,866016,-45579,-5,866016,866016
592,خزر,فنرسازي‌زر,4,1517,64927600,45050,42800,42800,-2250,-4.99,45040,-10,-0.02,42800,42800
593,ضملت3003,اختيارخ وبملت-4500-1400/03/19,4,113,10410000,200,95,77,-123,-61.5,92,-108,-54,13,140
594,ولشرق,ليزينگ ايران و شرق,4,250629,1994756211,8377,7959,7959,-418,-4.99,8317,-60,-0.72,7959,7959
595,ضترا8057,اختيارخ شتران-7000-1400/08/09,4,30,40151000,1103,1600,1320,217,19.67,1338,235,21.31,1320,1600
596,ولتجار,واسپاري تجارت وسرمايه ايرانيان,4,9100,66056900,7483,7259,7259,-224,-2.99,7481,-2,-0.03,7259,7259
597,ضترا3002,اختيارخ شتران-8000-1400/03/09,4,12,1260000,220,110,50,-170,-77.27,105,-115,-52.27,50,110
598,سنوين,سرمايه گذاري اقتصاد نوين,4,4578,39750774,9139,8683,8683,-456,-4.99,9137,-2,-0.02,8683,8683
599,غويتا,ويتانا,4,5610,95656110,17948,17051,17051,-897,-5,17944,-4,-0.02,17051,17051
600,سپرمي,پرميت‌,4,3483,31427109,8934,9023,9023,89,1,8935,1,0.01,9023,9023
601,سدشت,صنايع سيمان دشتستان,4,605,38211800,66480,63160,63160,-3320,-4.99,66480,0,0,63160,63160
602,زير0003پ01,زيره سبز0003كيميابذر(پ),4,49,25677019,540000,567000,513000,-27000,-5,524021,-15979,-2.96,513000,567000
603,پلوله,گازلوله‌,4,2142,58116744,27971,27132,27132,-839,-3,27966,-5,-0.02,27132,27132
604,شسينا,صنايع‌شيميايي‌سينا,4,641,78919920,129600,123120,123120,-6480,-5,129560,-40,-0.03,123120,123120
605,تكمبا,كمباين‌ سازي‌ ايران‌,4,17529,129013440,7740,7360,7360,-380,-4.91,7740,0,0,7360,7360
606,فسا,پتروشيمي فسا,4,18500,31043000,1766,1678,1678,-88,-4.98,1766,0,0,1678,1678
607,ضملي7000,اختيارخ فملي-8000-1400/07/11,4,25,117500000,4300,4700,4500,200,4.65,4700,400,9.3,4500,4900
608,ختراك,ريخته‌گري‌ تراكتورسازي‌ ايران‌,4,34300,474026000,14540,13820,13820,-720,-4.95,14520,-20,-0.14,13820,13820
609,غالبر,لبنيات‌ كالبر,4,4676,87721760,19740,18760,18760,-980,-4.96,19730,-10,-0.05,18760,18760
610,آ س پ,آ.س.پ,4,1522,23327694,16133,15327,15327,-806,-5,16132,-1,-0.01,15327,15327
611,ضپيك7042,اختيارخ تاپيكو-10000-00/07/18,4,212,214304000,1900,1200,1001,-899,-47.32,1011,-889,-46.79,1001,1200
612,غبهنوش,بهنوش‌ ايران‌,4,961,62868620,68860,65420,65420,-3440,-5,68840,-20,-0.03,65420,65420
613,برن0003پ01,برنج طارم0003تجارت مازندران(پ),4,850,235350000,276197,275000,277000,803,0.29,276882,685,0.25,275000,277000
614,زعف0008پ12,زعفران0008پوشالمعمول سحرخيز(پ),4,400,35816100,88888,89000,90957,2069,2.33,89540,652,0.73,89000,90957
615,ثالوند,سرمايه گذاري مسكن الوند,3,2470,75648690,32238,30627,30627,-1611,-5,32229,-9,-0.03,30627,30627
616,دفرا,فرآورده‌هاي‌ تزريقي‌ ايران‌,3,4500,103185000,24130,22930,22930,-1200,-4.97,24120,-10,-0.04,22930,22930
617,اراد41,مرابحه عام دولت4-ش.خ 0006,3,70000,70000000000,1019087,1000000,1000000,-19087,-1.87,1000000,-19087,-1.87,1000000,1000000
618,كوثر,بيمه كوثر,3,4184,58019528,14596,13867,13867,-729,-4.99,14595,-1,-0.01,13867,13867
619,زير0003پ04,زيره سبز0003شركت مينوبذر(پ),3,46,24498000,536191,567000,523000,-13191,-2.46,532565,-3626,-0.68,523000,567000
620,تاپيكو2,س. نفت و گاز و پتروشيمي تأمين,3,814000000,7863240000000,9660,9660,9660,0,0,9660,0,0,9660,9660
621,زير0003پ02,زيره سبز0003 دانش(پ),3,30,15930000,555659,567000,513000,-42659,-7.68,531000,-24659,-4.44,513000,567000
622,پسهند,صنايع‌ لاستيكي‌  سهند,3,1541,55630100,37990,36100,36100,-1890,-4.97,37980,-10,-0.03,36100,36100
623,كپارس,كاشي‌ پارس‌,3,713,100098070,147770,140390,140390,-7380,-4.99,147720,-50,-0.03,140390,140390
624,زگلدشت,كشت و دام گلدشت نمونه اصفهان,3,2083,27260221,13775,13087,13087,-688,-4.99,13774,-1,-0.01,13087,13087
625,همبين102,اختيارف ت مبين19752-01/02/10,3,113000,140459000,1164,1243,1243,79,6.79,1243,79,6.79,1243,1243
626,ضجار7041,اختيارخ وتجارت-3000-1400/07/21,3,12,361000,51,49,21,-30,-58.82,30,-21,-41.18,21,49
627,ثاصفا,شركت‌ ساختمان‌ اصفهان‌,3,61616,1659811808,27771,26938,26938,-833,-3,27628,-143,-0.51,26938,26938
628,كطبس,ذغال‌سنگ‌ نگين‌ ط‌بس‌,3,11336,751236720,69750,66270,66270,-3480,-4.99,69560,-190,-0.27,66270,66270
629,تملي612,تسهيلات مسكن بانك ملي-اسفند96,3,34,21253978,595350,625117,625117,29767,5,625117,29767,5,625117,625117
630,ضترا3001,اختيارخ شتران-7000-1400/03/09,3,10,3000000,615,300,300,-315,-51.22,300,-315,-51.22,300,300
631,ضپيك7041,اختيارخ تاپيكو-9000-00/07/18,3,28,44640000,1530,1600,1580,50,3.27,1594,64,4.18,1580,1600
632,وايران,ليزينگ ايرانيان,3,3371,39845220,12440,11820,11820,-620,-4.98,12440,0,0,11820,11820
633,ومهان2,گروه توسعه مالي مهر آيندگان,3,180806000,2099880884000,11540,11614,11614,74,0.64,11614,74,0.64,11614,11614
634,زماهان,مجتمع توليد گوشت مرغ ماهان,3,2257,44160462,20595,19566,19566,-1029,-5,20592,-3,-0.01,19566,19566
635,كسعدي,كاشي‌ سعدي‌,3,844,17074120,21290,20230,20230,-1060,-4.98,21290,0,0,20230,20230
636,زعف0008پ10,زعفران0008نگين طلاي سرخ(پ),3,2400,291799930,119663,121500,122000,2337,1.95,121583,1920,1.6,121500,122000
637,زشريف,كشت وصنعت شريف آباد,3,4239,20944899,5201,4941,4941,-260,-5,5201,0,0,4941,4941
638,كاسپين,داروسازي كاسپين تامين,3,10767,264092976,25818,24528,24528,-1290,-5,25794,-24,-0.09,24528,24528
639,شفا,سرمايه گذاري شفادارو,3,259,10489500,42630,40500,40500,-2130,-5,42630,0,0,40500,40500
640,ضسپا8041,اختيارخ خساپا-1600-1400/08/26,3,110,23100000,192,210,210,18,9.38,210,18,9.38,210,210
641,ولبهمن,شركت بهمن ليزينگ,3,110770,734737410,6982,6633,6633,-349,-5,6964,-18,-0.26,6633,6633
642,بسويچ,پارس‌سويچ‌,3,1774,46319140,27480,26110,26110,-1370,-4.99,27480,0,0,26110,26110
643,ضفار3002,اختيارخ فارس-10000-1400/03/05,3,15,15000,5,1,1,-4,-80,1,-4,-80,1,1
644,نيرو,نيرو سرمايه,3,2130,109000620,53867,51174,51174,-2693,-5,53836,-31,-0.06,51174,51174
645,ضپاس7027,اختيارخ وپارس-1800-1400/07/28,3,17,17000000,914,1000,1000,86,9.41,1000,86,9.41,1000,1000
646,ضغدر3003,اختيارخ وغدير-9200-1400/03/26,3,60,33200000,381,560,600,219,57.48,553,172,45.14,500,600
647,فافزا,فولاد افزا سپاهان,3,559,25370774,47774,45386,45386,-2388,-5,47768,-6,-0.01,45386,45386
648,ضجار7040,اختيارخ وتجارت-2500-1400/07/21,3,26,3245000,95,120,125,30,31.58,125,30,31.58,120,125
649,دبالك,مواد اوليه دارويي البرز بالك,3,12786,250950822,20659,19627,19627,-1032,-5,20641,-18,-0.09,19627,19627
650,خفناور,مهندسي صنعتي روان فن آور,3,610,28017300,48347,45930,45930,-2417,-5,48340,-7,-0.01,45930,45930
651,خكار,ايركا پارت صنعت,3,1870,38503300,21670,20590,20590,-1080,-4.98,21670,0,0,20590,20590
652,افرا,افرانت,3,478,15551730,34247,32535,32535,-1712,-5,34245,-2,-0.01,32535,32535
653,هپارس102,اختيارف ت پارس-177010-01/02/05,3,15000,50745000,2789,3383,3383,594,21.3,3383,594,21.3,3383,3383
654,وهنر,گروه توسعه هنر ايران,3,80648,631796432,8076,7834,7834,-242,-3,8060,-16,-0.2,7834,7834
655,ثاباد,توريستي ورفاهي آبادگران ايران,3,711,36474300,54000,51300,51300,-2700,-5,53990,-10,-0.02,51300,51300
656,كي بي سي,شركت كي بي سي,3,3600,88531200,25886,24592,24592,-1294,-5,25878,-8,-0.03,24592,24592
657,نطرين,عطرين نخ قم,3,1940,22119880,12002,11402,11402,-600,-5,12001,-1,-0.01,11402,11402
658,افران2,صندوق س افرا نماد پايدار-ثابت,2,3900000,3900000,13376,1,1,-13375,-99.99,1,-13375,-99.99,1,1
659,قنيشا,قند  نيشابور,2,166,10104420,64070,60870,60870,-3200,-4.99,64070,0,0,60870,60870
660,ضسپا3004,اختيارخ خساپا-2500-1400/03/26,2,100,700000,5,7,7,2,40,7,2,40,7,7
661,كپشير,پشم‌شيشه‌ايران‌,2,277,10512150,39940,37950,37950,-1990,-4.98,39940,0,0,37950,37950
662,دارا4,صندوق س. دارا الگوريتم-د,2,13000000,130260000000,9976,10020,10020,44,0.44,10020,44,0.44,10020,10020
663,سخواف,سيمان مجد خواف,2,680,11056120,16761,16259,16259,-502,-3,16760,-1,-0.01,16259,16259
664,قشير,قند شيروان قوچان و بجنورد,2,9000,219492000,25671,24388,24388,-1283,-5,25651,-20,-0.08,24388,24388
665,اوان,مبين وان كيش,2,194,10052110,54542,51815,51815,-2727,-5,54540,-2,0,51815,51815
666,ضپال2006,اختيارخ اپال-28000-1401/02/12,2,105,47250000,496,450,450,-46,-9.27,450,-46,-9.27,450,450
667,شدوص,دوده‌ صنعتي‌ پارس‌,2,1745,35632900,21490,20420,20420,-1070,-4.98,21490,0,0,20420,20420
668,وثخوز,سرمايه گذاري و توسعه خوزستان,2,1075,72095950,70595,67066,67066,-3529,-5,70568,-27,-0.04,67066,67066
669,غچين,كشت‌ و صنعت‌ چين‌ چين,2,623,11650100,19680,18700,18700,-980,-4.98,19680,0,0,18700,18700
670,شگل,گلتاش‌,2,1440,13766400,10060,9560,9560,-500,-4.97,10060,0,0,9560,9560
671,ضترا3004,اختيارخ شتران-10000-1400/03/09,2,28,28000,4,1,1,-3,-75,1,-3,-75,1,1
672,اخزا720,اسنادخزانه-م20بودجه97-000324,2,20,19790000,989868,989500,989500,-368,-0.04,989500,-368,-0.04,989500,989500
673,وسرمد,بيمه  سرمد,2,1940,11686560,6210,6024,6024,-186,-3,6210,0,0,6024,6024
674,ضمخا7071,اختيارخ اخابر-24000-1400/07/28,2,73,7227000,89,99,99,10,11.24,99,10,11.24,99,99
675,تفيرو,مهندسي فيروزا,2,623,12156599,19131,19513,19513,382,2,19132,1,0.01,19513,19513
676,دشيمي,شيمي‌ داروئي‌ داروپخش‌,2,335,9688200,30440,28920,28920,-1520,-4.99,30440,0,0,28920,28920
677,تملي704,تسهيلات مسكن ب. ملي-تير97,2,48,28639488,568244,596656,596656,28412,5,596656,28412,5,596656,596656
678,وسزنجان,شركت س استان زنجان,2,4350,5868150,1420,1349,1349,-71,-5,1420,0,0,1349,1349
679,ضبدر3001,اختيارخ شبندر-16000-1400/03/30,2,6,25444000,3500,4444,4200,700,20,4241,741,21.17,4200,4444
680,ضصاد8031,اختيارخ وبصادر-1800-1400/08/12,2,15,2925000,180,195,195,15,8.33,195,15,8.33,195,195
681,اراد55,مرابحه عام دولت5-ش.خ 0209,2,1900,1839996500,962501,940001,969998,7497,0.78,968419,5918,0.61,940001,969998
682,وتعاون,بيمه  تعاون,2,6300,37308600,6105,5922,5922,-183,-3,6104,-1,-0.02,5922,5922
683,داراب,پتروشيمي داراب,2,9940,23637320,2451,2378,2378,-73,-2.98,2451,0,0,2378,2378
684,تملي804,تسهيلات مسكن ب. ملي-تير98,2,21,10767169,513946,539643,488249,-25697,-5,512722,-1224,-0.24,488249,539643
685,زشگزا,شير و گوشت زاگرس شهركرد,2,1800,14022000,8199,7790,7790,-409,-4.99,8199,0,0,7790,7790
686,ضغدر8056,اختيارخ وغدير-8000-1400/08/26,2,52,140400000,2273,2700,2700,427,18.79,2700,427,18.79,2700,2700
687,اخزا807,اسنادخزانه-م7بودجه98-000719,2,84,77868000,926204,927000,927000,796,0.09,927000,796,0.09,927000,927000
688,زفكا,كشت و دامداري فكا,2,15151,180584769,12546,11919,11919,-627,-5,12538,-8,-0.06,11919,11919
689,ضخود4001,اختيارخ خودرو-1600-1400/04/02,2,10,2790000,131,279,279,148,112.98,279,148,112.98,279,279
690,ضمخا7077,اختيارخ اخابر-7000-1400/07/28,2,10,10000000,580,1000,1000,420,72.41,1000,420,72.41,1000,1000
691,ثشرق,سرمايه گذاري مسكن شمال شرق,2,3433,22486150,6890,6550,6550,-340,-4.93,6890,0,0,6550,6550
692,وليز,ليزينگ‌ايران‌,2,3200,29024000,9540,9070,9070,-470,-4.93,9540,0,0,9070,9070
693,ضشنا8000,اختيارخ شپنا-7000-1400/08/16,2,21,69400000,2847,3300,3400,553,19.42,3305,458,16.09,3300,3400
694,كسرام,پارس‌ سرام‌,2,3700,28897000,8220,7810,7810,-410,-4.99,8220,0,0,7810,7810
695,سنفت001,سلف موازي استاندارد سنفت001,2,17200,20049438000,1165665,1165665,1165665,0,0,1165665,0,0,1165665,1165665
696,خكمك,كمك‌فنرايندامين‌,2,1910,48380300,26660,25330,25330,-1330,-4.99,26660,0,0,25330,25330
697,كپرور,فرآوري زغال سنگ پروده طبس,2,460,14573720,33349,31682,31682,-1667,-5,33347,-2,-0.01,31682,31682
698,چكاوه,صنايع‌كاغذسازي‌كاوه‌,2,1300,22672000,18350,17440,17440,-910,-4.96,18350,0,0,17440,17440
699,چافست,افست‌,2,3346,52766420,16590,15770,15770,-820,-4.94,16590,0,0,15770,15770
700,كساوه,صنايع‌ كاشي‌ و سراميك‌ سينا,2,942,62737200,70100,66600,66600,-3500,-4.99,70080,-20,-0.03,66600,66600
701,اراد364,مرابحه عام دولت3-ش.خ 0104,2,1297700,1226975350000,950000,945500,945500,-4500,-0.47,945500,-4500,-0.47,945500,945500
702,آينده,بازرگاني آينده سازان بهشت پارس,2,560,10781680,19848,19253,19253,-595,-3,19847,-1,-0.01,19253,19253
703,گواهي ظرفيت,گواهي ظرفيت نقدي,2,2700000,49110300000,18189,18189,18189,0,0,18189,0,0,18189,18189
704,سكارون,سيمان كارون,2,100,17257700,177914,172577,172577,-5337,-3,177908,-6,0,172577,172577
705,خلنت,لنت‌ ترمزايران‌,2,321,18701460,61320,58260,58260,-3060,-4.99,61320,0,0,58260,58260
706,قهكمت,قندهكمتان‌,2,1638,71662500,46050,43750,43750,-2300,-4.99,46040,-10,-0.02,43750,43750
707,ضصاد8032,اختيارخ وبصادر-2000-1400/08/12,1,1,269000,429,269,269,-160,-37.3,269,-160,-37.3,269,269
708,ضغدر8057,اختيارخ وغدير-9000-1400/08/26,1,17,35700000,1444,2100,2100,656,45.43,2100,656,45.43,2100,2100
709,وسنا,سرمايه گذاري نيروگاهي ايران,1,817,12424936,15678,15208,15208,-470,-3,15678,0,0,15208,15208
710,ولغدر,ليزينگ‌خودروغدير,1,5000,115650000,24340,23130,23130,-1210,-4.97,24330,-10,-0.04,23130,23130
711,ضپيك7040,اختيارخ تاپيكو-8000-00/07/18,1,5,11650000,1610,2330,2330,720,44.72,2330,720,44.72,2330,2330
712,وآفري,بيمه كارآفرين,1,3125,10059375,3318,3219,3219,-99,-2.98,3318,0,0,3219,3219
713,دكيمي,كيميدارو,1,400,11184000,29430,27960,27960,-1470,-4.99,29430,0,0,27960,27960
714,غمهرا,توليدي‌مهرام‌,1,42,4862760,121870,115780,115780,-6090,-5,121870,0,0,115780,115780
715,خعمرا,توسعه و عمران شهرستان نائين,1,490,11823700,23428,24130,24130,702,3,23429,1,0,24130,24130
716,زكشت,كشاورزي مكانيزه اصفهان كشت,1,132,5061672,40364,38346,38346,-2018,-5,40363,-1,0,38346,38346
717,فنوال2,نورد آلومينيوم‌,1,14748451,352487978900,23050,23900,23900,850,3.69,23900,850,3.69,23900,23900
718,ضپاس7030,اختيارخ وپارس-3000-1400/07/28,1,5,1000000,1,200,200,199,19900,200,199,19900,200,200
719,زنجان,صنايع كشاورزي وكود زنجان,1,659,5975153,9347,9067,9067,-280,-3,9347,0,0,9067,9067
720,وسصفا,شركت س استان اصفهان,1,5000,5085000,1070,1017,1017,-53,-4.95,1070,0,0,1017,1017
721,سصفها,سيمان‌اصفهان‌,1,50,5978500,125860,119570,119570,-6290,-5,125860,0,0,119570,119570
722,ضبدر3000,اختيارخ شبندر-14000-1400/03/30,1,1,6000000,4900,6000,6000,1100,22.45,6000,1100,22.45,6000,6000
723,دمعيار2,صندوق س. توازن معيار-د,1,4400000,4400000,10015,1,1,-10014,-99.99,1,-10014,-99.99,1,1
724,غديس,پاكديس,1,1300,16575000,13421,12750,12750,-671,-5,13420,-1,-0.01,12750,12750
725,تكنو,تكنوتار,1,500,10095000,21250,20190,20190,-1060,-4.99,21250,0,0,20190,20190
726,شستان,پتروشيمي گلستان,1,50000,187250000,3821,3745,3745,-76,-1.99,3818,-3,-0.08,3745,3745
727,قنقش,قند نقش جهان,1,72,5066712,71807,70371,70371,-1436,-2,71806,-1,0,70371,70371
728,وآذر,سرمايه‌گذاري‌توسعه‌آذربايجان‌,1,1276,99566280,82130,78030,78030,-4100,-4.99,82100,-30,-0.04,78030,78030
729,حپارسا,توسعه حمل و نقل ريلي پارسيان,1,193,6458745,35226,33465,33465,-1761,-5,35225,-1,0,33465,33465
730,مشهد0112,مشاركت ش مشهد0112-3ماهه18%,1,100,92400000,880000,924000,924000,44000,5,924000,44000,5,924000,924000
731,داوه,داروسازي آوه سينا,1,350,6705650,20167,19159,19159,-1008,-5,20167,0,0,19159,19159
732,ومعادن2,توسعه‌معادن‌وفلزات‌,1,7000000,53060000000,7530,7580,7580,50,0.66,7580,50,0.66,7580,7580
733,اراد854,مرابحه عام دولت85-ش.خ010704,1,500000,473000000000,1000000,946000,946000,-54000,-5.4,946000,-54000,-5.4,946000,946000
734,رتكو,كنترل‌خوردگي‌تكين‌كو,1,1200,19644000,17230,16370,16370,-860,-4.99,17230,0,0,16370,16370
735,تملي706,تسهيلات مسكن ب. ملي-شهريور97,1,22,10397882,450125,472631,472631,22506,5,472631,22506,5,472631,472631
736,تملي809,تسهيلات مسكن ب. ملي-آذر98,1,22,12166022,526668,553001,553001,26333,5,553001,26333,5,553001,553001
737,خپويش,سازه‌ پويش‌,1,348,19895160,60170,57170,57170,-3000,-4.99,60170,0,0,57170,57170
738,خوساز,محورسازان‌ايران‌خودرو,1,739,5076930,7230,6870,6870,-360,-4.98,7230,0,0,6870,6870
739,فجام,جام‌دارو,1,1000,9250000,9730,9250,9250,-480,-4.93,9730,0,0,9250,9250
740,فلامي,لاميران‌,1,120,5106000,44780,42550,42550,-2230,-4.98,44780,0,0,42550,42550
741,اراد77,مرابحه عام دولت77-ش.خ000812,1,6000,5901324000,972045,983554,983554,11509,1.18,983554,11509,1.18,983554,983554
742,كساپا,سايپاشيشه‌,1,241,8924230,38970,37030,37030,-1940,-4.98,38970,0,0,37030,37030
743,ضغدر8055,اختيارخ وغدير-7000-1400/08/26,1,6,21000000,2993,3500,3500,507,16.94,3500,507,16.94,3500,3500
744,قشهد,شهد,1,260,5044000,20420,19400,19400,-1020,-5,20420,0,0,19400,19400
745,ضغدر3004,اختيارخ وغدير-11200-1400/03/26,1,8,80000,671,10,10,-661,-98.51,10,-661,-98.51,10,10
746,سنفت009,سلف موازي استاندارد سنفت009,1,46000,70730520000,1536830,1537620,1537620,790,0.05,1537620,790,0.05,1537620,1537620
747,غپونه,نوش پونه مشهد,1,332,5976996,18559,18003,18003,-556,-3,18559,0,0,18003,18003
748,ثنظام,س. ساختماني نظام مهندسي ايران,1,112,5046272,47427,45056,45056,-2371,-5,47426,-1,0,45056,45056
749,غپآذر,شير پگاه آذربايجان شرقي,1,98,5103448,54816,52076,52076,-2740,-5,54815,-1,0,52076,52076
750,ضسپا8039,اختيارخ خساپا-1200-1400/08/26,1,10,4300000,373,430,430,57,15.28,430,57,15.28,430,430
751,آگاس2,صندوق س.هستي بخش آگاه-س,1,100000,100000,59742,1,1,-59741,-100,1,-59741,-100,1,1
752,جهرم,پتروشيمي جهرم,1,15000,25785000,1772,1719,1719,-53,-2.99,1772,0,0,1719,1719
753,كفرآور,فرآورده هاي سيمان شرق,1,300,6727200,23604,22424,22424,-1180,-5,23603,-1,0,22424,22424
754,اكالا,كارگزاران بورس كالاي ايران,1,100000,2948000000,31030,29480,29480,-1550,-5,30870,-160,-0.52,29480,29480
755,ضترا8055,اختيارخ شتران-5000-1400/08/09,1,12,36000000,2424,3000,3000,576,23.76,3000,576,23.76,3000,3000
756,اخزا8122,اسنادخزانه-م12بودجه98-001111,1,100000,87269900000,872699,872699,872699,0,0,872699,0,0,872699,872699
757,شبندر2,پالايش نفت بندرعباس,1,160000000,3043200000000,19020,19020,19020,0,0,19020,0,0,19020,19020
758,لازما,كارخانه هاي صنعتي آزمايش,1,200,6636400,34208,33182,33182,-1026,-3,34207,-1,0,33182,33182
759,كمرجان,بازرگاني و توليدي مرجان كار,1,36,5023980,146900,139555,139555,-7345,-5,146897,-3,0,139555,139555
760,اراد61,مرابحه عام دولت61-ش.خ0309,1,6000,6000000000,1000000,1000000,1000000,0,0,1000000,0,0,1000000,1000000
761,مصفها112,مشاركت ش اصفهان112-3ماهه18%,1,6,5760000,960000,960000,960000,0,0,960000,0,0,960000,960000
762,حآسا,آسيا سير ارس,1,138,5251038,40053,38051,38051,-2002,-5,40052,-1,0,38051,38051
763,ضمخا7070,اختيارخ اخابر-20000-1400/07/28,1,2,400000,140,200,200,60,42.86,200,60,42.86,200,200
764,دروز,داروسازي‌ روزدارو,1,200,5548000,29200,27740,27740,-1460,-5,29200,0,0,27740,27740
765,سپيدما4,صندوق س. سپيد دماوند-د,1,120000000,1246320000000,10380,10386,10386,6,0.06,10386,6,0.06,10386,10386
766,ضغدر3002,اختيارخ وغدير-8200-1400/03/26,1,1,1400000,1280,1400,1400,120,9.38,1400,120,9.38,1400,1400
767,آوا2,صندوق س.سهام آواي معيار-س,1,1100000,1100000,6215,1,1,-6214,-99.98,1,-6214,-99.98,1,1
768,دتوزيع,توزيع دارو پخش,1,112,5072816,47676,45293,45293,-2383,-5,47675,-1,0,45293,45293
769,تشتاد,صنايع توليدي اشتاد ايران‌,1,400,6082000,15675,15205,15205,-470,-3,15675,0,0,15205,15205
770,شتولي,تولي‌پرس‌,1,284,9955336,35769,35054,35054,-715,-2,35768,-1,0,35054,35054
771,سميعا002,سلف موازي استاندارد سميعا002,1,126980,166167170820,1307479,1308609,1308609,1130,0.09,1308609,1130,0.09,1308609,1308609
772,اخزا718,اسنادخزانه-م18بودجه97-000525,1,6,5763000,961469,960500,960500,-969,-0.1,960500,-969,-0.1,960500,960500
773,دفارا,داروسازي‌ فارابي‌,1,883,50322170,59980,56990,56990,-2990,-4.98,59970,-10,-0.02,56990,56990
774,فنفت,صنايع تجهيزات نفت,1,160,5128640,33045,32054,32054,-991,-3,33044,-1,0,32054,32054
775,فايرا2,آلومينيوم‌ايران‌,1,9894322,166224609600,16870,16800,16800,-70,-0.41,16800,-70,-0.41,16800,16800
776,تابا,تابان نيرو سپاهان,1,87,4719141,55920,54243,54243,-1677,-3,55919,-1,0,54243,54243
777,صخود412,ص مرابحه خودرو412- 3ماهه 18%,1,70,69999300,995001,999990,999990,4989,0.5,999990,4989,0.5,999990,999990
778,بنو,بيمه تجارت نو,1,1041,29887110,30221,28710,28710,-1511,-5,30220,-1,0,28710,28710
779,ثپرديس,سرمايه گذاري مسكن پرديس,1,10332,99631476,10150,9643,9643,-507,-5,10146,-4,-0.04,9643,9643
780,كمينا,شيشه سازي مينا,1,1000,24277000,25027,24277,24277,-750,-3,25025,-2,-0.01,24277,24277
781,ضسپا3003,اختيارخ خساپا-2000-1400/03/26,1,1,24000,18,24,24,6,33.33,24,6,33.33,24,24
782,ضمخا7066,اختيارخ اخابر-12000-1400/07/28,1,10,5990000,599,599,599,0,0,599,0,0,599,599
783,ثنور,سرمايه گذاري كوه نور,1,541,5006955,9541,9255,9255,-286,-3,9541,0,0,9255,9255
784,تكشا,گسترش‌صنايع‌وخدمات‌كشاورزي‌,1,170,6650400,41170,39120,39120,-2050,-4.98,41170,0,0,39120,39120
785,پارسا306,صكوك اجاره پارسيان-6ماهه16%,1,70,69300000,990000,990000,990000,0,0,990000,0,0,990000,990000
786,كيش1402,اجاره س. و توسعه كيش14020820,1,25,25000000,1000000,1000000,1000000,0,0,1000000,0,0,1000000,1000000
787,اپرداز,آتيه داده پرداز,1,271,5470948,21250,20188,20188,-1062,-5,21250,0,0,20188,20188
788,كقزوي,شيشه‌ قزوين‌,1,520,5124080,10158,9854,9854,-304,-2.99,10158,0,0,9854,9854
789,وسيزد,شركت س استان يزد,1,819,995904,1280,1216,1216,-64,-5,1280,0,0,1216,1216
790,پاسا,ايران‌ياساتايرورابر,1,500,12675000,26680,25350,25350,-1330,-4.99,26680,0,0,25350,25350
791,سدبير,س. تدبيرگران فارس وخوزستان,1,61,5024265,86699,82365,82365,-4334,-5,86697,-2,0,82365,82365
792,وسكرمان,س.سهام عدالت استان كرمان,1,5190,5081010,1030,979,979,-51,-4.95,1030,0,0,979,979
793,دقاضي,داروسازي شهيد قاضي,1,114,4781616,43241,41944,41944,-1297,-3,43241,0,0,41944,41944
794,اخزا810,اسنادخزانه-م10بودجه98-001006,1,416,368832672,886611,886617,886617,6,0,886617,6,0,886617,886617
