,نماد,نام,تعداد,حجم,ارزش,دیروز,اولین,آخرین معامله - مقدار,آخرین معامله - تغییر,آخرین معامله - درصد,قیمت پایانی - مقدار,قیمت پایانی - تغییر,قیمت پایانی - درصد,کمترین,بیشترین
2,پالايش,صندوق پالايشي يکم-سهام,25785,29207003,1869262629260,65930,64800,63300,-2630,-3.99,64000,-1930,-2.93,62700,65830
3,فگستر,گسترش صنايع روي ايرانيان,25014,888646,7585482256,8130,8536,8536,406,4.99,8320,190,2.34,8536,8536
4,دارا يكم,صندوق واسطه گري مالي يكم-سهام,17841,15047314,1700937204020,116980,114230,110850,-6130,-5.24,113040,-3940,-3.37,109900,116300
5,فملي,ملي‌ صنايع‌ مس‌ ايران‌,13192,101972855,1167885768770,11860,11420,11290,-570,-4.81,11450,-410,-3.46,11270,11970
6,فتوسا,توليد و توسعه سرب روي ايرانيان,12410,1837017,15879174948,8233,8644,8644,411,4.99,8628,395,4.8,8644,8644
7,كزغال,زغال سنگ پروده طبس,11147,11677700,353305232022,31642,30060,30065,-1577,-4.98,30255,-1387,-4.38,30060,31090
8,خودرو,ايران‌ خودرو,10537,413418982,692159589662,1749,1700,1662,-87,-4.97,1674,-75,-4.29,1662,1740
9,شپنا,پالايش نفت اصفهان,9494,126993152,1144902120950,9470,9000,9000,-470,-4.96,9020,-450,-4.75,9000,9220
10,شستا,سرمايه گذاري تامين اجتماعي,8929,37668810,357760949570,9840,9510,9410,-430,-4.37,9500,-340,-3.46,9380,9770
11,خساپا,سايپا,8861,360190643,568654887525,1653,1600,1571,-82,-4.96,1579,-74,-4.48,1571,1650
12,ولپارس,ليزينگ پارسيان,6487,12871572,47314908725,3862,3669,3669,-193,-5,3676,-186,-4.82,3669,3795
13,كمند,صندوق س. با درآمد ثابت كمند,6472,393256578,3971779107012,10094,10100,10100,6,0.06,10100,6,0.06,10098,10102
14,كرمان,س. توسعه و عمران استان كرمان,6412,227288914,217318535252,986,990,937,-49,-4.97,956,-30,-3.04,937,1004
15,شتران,پالايش نفت تهران,6268,77081218,531046561950,7230,6870,6870,-360,-4.98,6890,-340,-4.7,6870,7060
16,امينح,ح . تامين سرمايه امين,5577,4112636,20549244108,5085,4911,4969,-116,-2.28,4997,-88,-1.73,4890,5060
17,اپال,فرآوري معدني اپال كاني پارس,5549,22057935,399860773870,18590,18390,18080,-510,-2.74,18130,-460,-2.47,17950,18480
18,امين يكم,صندوق درآمد ثابت امين يكم فردا,5312,132685832,1330484754860,10024,10030,10026,2,0.02,10027,3,0.03,10025,10030
19,شگويا,پتروشيمي تندگويان,5143,24833401,203099733319,8101,8000,8100,-1,-0.01,8178,77,0.95,8000,8395
20,آريا,پليمر آريا ساسول,5010,2567067,188330425131,76668,72970,72964,-3704,-4.83,73364,-3304,-4.31,72900,75300
21,بوعلي,پتروشيمي بوعلي سينا,4882,1974408,88543493150,44400,44000,44480,80,0.18,44850,450,1.01,42570,46100
22,بركت,گروه دارويي بركت,4826,19155164,462893977380,25190,25000,23940,-1250,-4.96,24170,-1020,-4.05,23940,25000
23,ذوب,سهامي ذوب آهن  اصفهان,4706,132093495,369056920472,2937,2791,2810,-127,-4.32,2794,-143,-4.87,2791,2869
24,ثاميد,توسعه و عمران اميد,4251,95652476,128654963005,1394,1369,1370,-24,-1.72,1345,-49,-3.52,1325,1400
25,وسپهر,سرمايه گذاري مالي سپهرصادرات,4048,14262368,129702339390,9094,9094,9094,0,0,9094,0,0,9094,9095
26,پترول,گروه پتروشيمي س. ايرانيان,4003,29551116,237111650360,8210,8000,7900,-310,-3.78,8020,-190,-2.31,7850,8250
27,وپارس,بانك‌پارسيان‌,3686,135935676,366656857370,2683,2686,2695,12,0.45,2697,14,0.52,2658,2790
28,آبادا,توليد نيروي برق آبادان,3645,2685470,24176194860,9370,8910,8910,-460,-4.91,9000,-370,-3.95,8910,9290
29,وكبهمن,مديريت سرمايه گذاري كوثربهمن,3558,2974811,29961978666,10117,9973,10100,-17,-0.17,10072,-45,-0.44,9728,10117
30,امين,تامين سرمايه امين,3427,5854670,41513570810,7150,7090,7090,-60,-0.84,7090,-60,-0.84,7090,7100
31,افران,صندوق س افرا نماد پايدار-ثابت,3336,85588149,1143987243504,13355,13366,13366,11,0.08,13366,11,0.08,13365,13371
32,سيتا,سرمايه گذاري سيمان تامين,3297,8298217,124476851900,15000,15000,15000,0,0,15000,0,0,15000,15010
33,شبندر,پالايش نفت بندرعباس,3291,27052934,514976753630,20020,19020,19020,-1000,-5,19040,-980,-4.9,19020,19550
34,ولساپا,ليزينگ رايان‌ سايپا,3084,55519722,143364381782,2493,2461,2617,124,4.97,2582,89,3.57,2440,2617
35,خبهمن,گروه‌بهمن‌,3052,159960795,171411993154,1125,1069,1069,-56,-4.98,1072,-53,-4.71,1069,1114
36,وبصادر,بانك صادرات ايران,3043,119001893,214997605315,1900,1805,1805,-95,-5,1807,-93,-4.89,1805,1860
37,وخارزم,سرمايه گذاري خوارزمي,2851,39636739,135950982854,3587,3423,3408,-179,-4.99,3430,-157,-4.38,3408,3578
38,پارند,صندوق س. پارند پايدار سپهر,2705,119575206,1346905861082,11258,11270,11265,7,0.06,11264,6,0.05,11263,11273
39,شتوكا,توكا رنگ فولاد سپاهان,2619,9265521,229454178718,48230,25000,26250,-21980,-45.57,24764,-23466,-48.65,23750,26250
40,تسه0002,امتيازتسهيلاتمسكن ارديبهشت1400,2596,57572,31317439557,569275,542000,540812,-28463,-5,543970,-25305,-4.45,540812,565000
41,كيان,صندوق س. با درآمد ثابت كيان,2461,49643449,1416462592082,28517,28532,28533,16,0.06,28533,16,0.06,28531,28537
42,غگل,گلوكوزان‌,2450,35922704,78734413597,2276,2163,2187,-89,-3.91,2192,-84,-3.69,2163,2250
43,فجر,فولاد اميركبيركاشان,2446,7770524,504881397310,64080,63010,65680,1600,2.5,64970,890,1.39,63010,66000
44,وتجارت,بانك تجارت,2418,137789290,277920997930,2123,2017,2017,-106,-4.99,2017,-106,-4.99,2017,2017
45,سفارس,سيمان فارس و خوزستان,2415,17311850,243980264920,13650,13330,14330,680,4.98,14090,440,3.22,13330,14330
46,بپيوند,برق و انرژي پيوندگستر پارس,2391,4628093,44408336061,10074,9730,9571,-503,-4.99,9595,-479,-4.75,9571,9900
47,وغدير,سرمايه‌گذاري‌غدير(هلدينگ‌,2292,21567795,193688978690,9070,8710,9000,-70,-0.77,8980,-90,-0.99,8710,9300
48,اعتماد,صندوق س.اعتماد آفرين پارسيان-د,2287,54696440,2000312622790,36553,36570,36571,18,0.05,36571,18,0.05,36568,36573
49,وسبحان,سرمايه گذاري سبحان,2188,50816289,111644091566,2119,2040,2224,105,4.96,2197,78,3.68,2040,2224
50,صبا,سرمايه گذاري صبا تامين,2090,9352139,64187624098,7208,6855,6851,-357,-4.95,7009,-199,-2.76,6848,7026
51,سرو,صندوق س سروسودمند مدبران-سهام,1852,2158322,120937099790,58210,57810,55300,-2910,-5,56030,-2180,-3.75,54000,57810
52,فخوز,فولاد  خوزستان,1797,11412917,159700084900,14090,14000,14190,100,0.71,13990,-100,-0.71,13740,14250
53,بجهرم,توسعه مولد نيروگاهي جهرم,1783,27708861,51356058487,1942,1880,1845,-97,-4.99,1853,-89,-4.58,1845,1908
54,فارس,صنايع پتروشيمي خليج فارس,1782,18464972,157153459140,8900,8760,8460,-440,-4.94,8510,-390,-4.38,8460,8800
55,فباهنرح,ح . مس‌ شهيدباهنر,1682,8745900,105930886310,13170,13300,12070,-1100,-8.35,12110,-1060,-8.05,11860,13300
56,ساوه,سيمان ساوه,1675,1562554,65791459746,40327,40362,42380,2053,5.09,42105,1778,4.41,40362,42380
57,وبانك,سرمايه گذاري گروه توسعه ملي,1656,12214452,78866973960,6490,6240,6500,10,0.15,6460,-30,-0.46,6240,6610
58,نوري,پتروشيمي نوري,1560,1349944,76073005410,57000,55000,56650,-350,-0.61,56480,-520,-0.91,55000,57680
59,وتوس,توسعه‌شهري‌توس‌گستر,1541,4417250,63245768830,14060,14760,13930,-130,-0.92,14320,260,1.85,13360,14760
60,سشرق,سيمان‌ شرق‌,1480,22619586,113118285740,4840,4670,5080,240,4.96,5000,160,3.31,4670,5080
61,ساراب,سيمان‌ داراب‌,1398,5910704,114475231650,19710,18730,19860,150,0.76,19370,-340,-1.73,18730,20500
62,ومعادن,توسعه‌معادن‌وفلزات‌,1392,10637737,79939512790,7770,7550,7400,-370,-4.76,7590,-180,-2.32,7390,7750
63,ونوين,بانك‌اقتصادنوين‌,1279,22859500,84134716203,3775,3780,3677,-98,-2.6,3681,-94,-2.49,3610,3780
64,غسالم,سالمين‌,1229,20840643,61358850617,3098,2944,2945,-153,-4.94,2944,-154,-4.97,2944,2950
65,تنوين,تامين سرمايه نوين,1206,30354997,224449116140,7370,7380,7420,50,0.68,7390,20,0.27,7150,7590
66,كاوه,فولاد كاوه جنوب كيش,1154,10281519,179009231700,18200,17510,17340,-860,-4.73,17410,-790,-4.34,17290,18010
67,شيران,س. صنايع‌شيميايي‌ايران,1127,8205599,151517870810,19320,18390,18360,-960,-4.97,18470,-850,-4.4,18360,20000
68,سپاها,سيمان‌سپاهان‌,1121,10777506,68365750800,6220,6020,6530,310,4.98,6340,120,1.93,5910,6530
69,وساپا,سرمايه‌گذاري‌ سايپا,1115,18918050,76220765670,4209,4030,4022,-187,-4.44,4029,-180,-4.28,3999,4140
70,ومعادنح,ح . توسعه‌معادن‌وفلزات‌,1108,5788650,31575419190,5510,5450,5360,-150,-2.72,5450,-60,-1.09,5220,5720
71,آگاس,صندوق س.هستي بخش آگاه-س,1084,670790,40222528373,61241,61974,59850,-1391,-2.27,59963,-1278,-2.09,58965,61974
72,ما,بيمه  ما,1075,5640019,51302996060,9120,9190,9000,-120,-1.32,9100,-20,-0.22,8670,9320
73,سشمال,سيمان‌ شمال‌,1063,5814407,49853837700,8820,8380,8390,-430,-4.88,8570,-250,-2.83,8380,9080
74,ولملت,واسپاري ملت,1018,9137974,45959010890,7710,5120,5010,-2700,-35.02,5030,-2680,-34.76,4870,5370
75,وپاسار,بانك  پاسارگاد,1016,8337062,137326459510,17240,16500,16380,-860,-4.99,16470,-770,-4.47,16380,17220
76,آسيا,بيمه آسيا,1009,32620635,53984428072,1714,1680,1640,-74,-4.32,1655,-59,-3.44,1629,1714
77,شبصير,توليدات پتروشيمي قائد بصير,997,896988,61518230350,68690,69326,67610,-1080,-1.57,68583,-107,-0.16,65259,71000
78,شاراك,پتروشيمي شازند,989,2717034,68128227640,24420,25100,24940,520,2.13,24970,550,2.25,24810,25600
79,فاسمين,كالسيمين‌,974,9173736,112202394190,12860,12220,12230,-630,-4.9,12230,-630,-4.9,12220,12520
80,كچاد,معدني‌وصنعتي‌چادرملو,947,3665342,79763036000,21760,21510,21790,30,0.14,21760,0,0,21500,22150
81,خگستر,گسترش‌سرمايه‌گذاري‌ايران‌خودرو,946,50247870,93461038200,1957,1860,1860,-97,-4.96,1860,-97,-4.96,1860,1860
82,سمازن,سيمان‌مازندران‌,939,6717606,68228686380,10130,9630,10630,500,4.94,10160,30,0.3,9630,10630
83,وخارزمح,ح.سرمايه گذاري خوارزمي,914,9231320,20402350782,2414,2379,2190,-224,-9.28,2210,-204,-8.45,2173,2379
84,ثمسكن,سرمايه‌گذاري‌ مسكن‌,909,8928096,33889185078,3763,3575,3818,55,1.46,3796,33,0.88,3575,3949
85,شبريز,پالايش نفت تبريز,885,4464175,103101835540,24300,23090,23090,-1210,-4.98,23100,-1200,-4.94,23090,23400
86,تسه0001,امتيازتسهيلات مسكن فروردين1400,857,12478,7124413915,588074,609000,558671,-29403,-5,570958,-17116,-2.91,558671,610000
87,پيزد,مجتمع صنايع لاستيك يزد,856,125683,6581738803,55086,52334,52332,-2754,-5,53790,-1296,-2.35,52332,52520
88,كگل,معدني و صنعتي گل گهر,856,4339826,57266156310,13490,13230,12950,-540,-4,13340,-150,-1.11,12900,13900
89,اخابر,مخابرات ايران,853,12203137,85311672820,7340,6980,6980,-360,-4.9,7070,-270,-3.68,6980,7250
90,وملل,اعتباري ملل,824,44804453,560014302894,12499,12499,12501,2,0.02,12499,0,0,11885,12539
91,تاپيكو,س. نفت و گاز و پتروشيمي تأمين,821,7274727,69920343360,10020,9700,9540,-480,-4.79,9760,-260,-2.59,9530,9900
92,افق,فروشگاههاي زنجيره اي افق كوروش,814,849176,54662456150,65770,62810,63090,-2680,-4.07,64780,-990,-1.51,62810,65840
93,ومهان,گروه توسعه مالي مهر آيندگان,808,6951856,80738147972,12107,11733,11590,-517,-4.27,11614,-493,-4.07,11502,12090
94,ورنا,سرمايه‌گذاري‌ رنا(هلدينگ‌,786,19162883,77684892801,4266,4065,4053,-213,-4.99,4054,-212,-4.97,4053,4110
95,سهگمت,سيمان‌هگمتان‌,772,2950720,55925891790,22100,18700,19040,-3060,-13.85,18950,-3150,-14.25,18700,19490
96,شفن,پتروشيمي فناوران,759,239243,66634675670,292150,285820,277550,-14600,-5,282330,-9820,-3.36,277550,285820
97,تسه9912,امتياز تسهيلات مسكن اسفند99,741,10877,6220734402,580656,572000,578000,-2656,-0.46,571916,-8740,-1.51,551624,609688
98,شغدير,پتروشيمي غدير,723,1189704,74060961920,64940,64000,61710,-3230,-4.97,62250,-2690,-4.14,61700,64900
99,زاگرس,پتروشيمي زاگرس,690,197526,38001864988,196273,190300,191000,-5273,-2.69,194710,-1563,-0.8,189510,196100
100,وصنعت,سرمايه گذاري توسعه صنعت وتجارت,683,7931823,39745575210,5160,5060,5000,-160,-3.1,5010,-150,-2.91,4910,5150
101,البرز,بيمه البرز,652,8237158,27624623683,3390,3271,3350,-40,-1.18,3354,-36,-1.06,3271,3445
102,وسينا,بانك سينا,650,35825140,78360030988,2298,2185,2184,-114,-4.96,2187,-111,-4.83,2184,2240
103,درازك,دارويي‌ رازك‌,648,1874136,48780278260,25770,24520,25990,220,0.85,26030,260,1.01,24520,26510
104,سرچشمه,سرمايه گذاري مس سرچشمه,641,5933599,36769669520,6349,6300,6299,-50,-0.79,6197,-152,-2.39,6050,6370
105,ضسپا3003,اختيارخ خساپا-2000-1400/03/26,633,33050,712912000,31,31,19,-12,-38.71,22,-9,-29.03,18,31
106,هرمز,فولاد هرمزگان جنوب,613,7632458,111447800846,15352,14585,14585,-767,-5,14602,-750,-4.89,14585,15000
107,رانفور,خدمات‌انفورماتيك‌,595,6432750,37925003510,6150,5950,5850,-300,-4.88,6000,-150,-2.44,5850,6140
108,سيدكو,سرمايه گذاري توسعه صنايع سيمان,586,7176781,41636885690,5560,5770,5830,270,4.86,5800,240,4.32,5540,5830
109,فنورد,نوردوقطعات‌ فولادي‌,583,170204,25711884410,151060,146000,152100,1040,0.69,151070,10,0.01,144420,156840
110,سپ,پرداخت الكترونيك سامان كيش,580,1175839,27525137780,23650,22600,23700,50,0.21,23510,-140,-0.59,22470,24100
111,والبر,سرمايه‌ گذاري‌ البرز(هلدينگ‌,576,2879595,33908840250,12370,11800,11760,-610,-4.93,11780,-590,-4.77,11760,11940
112,فباهنر,مس‌ شهيدباهنر,569,1616937,32601459370,21170,20210,20120,-1050,-4.96,20160,-1010,-4.77,20120,21000
113,آوا,صندوق س.سهام آواي معيار-س,569,4456735,27747049124,6503,6400,6180,-323,-4.97,6226,-277,-4.26,6123,6400
114,وپست,پست بانك ايران,552,6036127,112663702210,19640,18660,18660,-980,-4.99,18660,-980,-4.99,18660,19560
115,حفاري,حفاري شمال,551,3704378,19592307290,5530,5300,5260,-270,-4.88,5290,-240,-4.34,5260,5440
116,ورازي,بيمه رازي,550,4280127,30990289509,7230,7230,7160,-70,-0.97,7241,11,0.15,7119,7402
117,سكرما,سيمان‌ كرمان‌,545,1892303,23834428780,12820,12180,12590,-230,-1.79,12600,-220,-1.72,12180,13210
118,ارزش,صندوق س ارزش آفرين بيدار-سهام,535,6928204,56245103030,8400,8170,7990,-410,-4.88,8120,-280,-3.33,7990,8300
119,وگردش,بانك گردشگري,530,2346531,35149740048,15093,14644,15080,-13,-0.09,15049,-44,-0.29,14644,15129
120,وسكاب,س.ص.بازنشستگي كاركنان بانكها,530,4787276,20845446793,4454,4420,4400,-54,-1.21,4354,-100,-2.25,4261,4454
121,وشهر,بانك شهر,520,16218891,80961299734,5058,5000,5001,-57,-1.13,4992,-66,-1.3,4856,5030
122,آكورد,صندوق س. آرمان آتي كوثر-د,520,9989132,321811320336,32200,32220,32216,16,0.05,32216,16,0.05,32215,32220
123,كگلح,ح . معدني و صنعتي گل گهر,513,3024612,30765070530,10410,10010,10090,-320,-3.07,10170,-240,-2.31,10010,10500
124,شبهرن,نفت‌ بهران‌,506,3702716,38454907390,10920,10380,10380,-540,-4.95,10510,-410,-3.75,10380,10500
125,دابور,داروسازي‌ ابوريحان‌,503,1764936,41987076040,24980,23740,24000,-980,-3.92,23790,-1190,-4.76,23740,24700
126,شسپا,نفت سپاهان,500,3540043,50018683440,14850,14110,14110,-740,-4.98,14180,-670,-4.51,14110,14390
127,جوين,كشت و صنعت جوين,499,4928011,23539799353,4769,4860,4779,10,0.21,4777,8,0.17,4769,4860
128,ضخود7074,اختيارخ خودرو-1800-1400/07/07,499,17090,3014011000,195,200,160,-35,-17.95,176,-19,-9.74,154,210
129,غبشهر,صنعتي‌ بهشهر,490,3165605,58938263880,19580,18610,18610,-970,-4.95,18620,-960,-4.9,18610,19170
130,فسپا,گروه‌صنعتي‌سپاهان‌,481,1816572,56152874010,32430,30810,30810,-1620,-5,30910,-1520,-4.69,30810,31870
131,تسه9911,امتياز تسهيلات مسكن بهمن99,471,6289,3610028015,578166,607074,552000,-26166,-4.53,574023,-4143,-0.72,549258,607074
132,ياقوت,صندوق س ياقوت آگاه-ثابت,463,2304996,28512494294,12368,12390,12361,-7,-0.06,12370,2,0.02,12361,12390
133,گوهران,سرمايه گذاري توسعه گوهران اميد,460,1076038,7432687168,6989,6760,6950,-39,-0.56,6948,-41,-0.59,6760,7089
134,تسه9908,امتياز تسهيلات مسكن آبان99,450,9420,5319762895,575746,562222,546959,-28787,-5,564731,-11015,-1.91,546959,600000
135,مدير,ص.س.مديريت ثروت ص.بازنشستگي-س,448,1947260,14282463695,7450,7440,7194,-256,-3.44,7335,-115,-1.54,7188,7458
136,پرديس,سرمايه گذاري پرديس,437,3829358,16088009410,4401,4193,4181,-220,-5,4201,-200,-4.54,4181,4369
137,تصميم,صندوق س با درآمد ثابت تصميم,436,7948035,130262243190,16388,16393,16389,1,0.01,16389,1,0.01,16365,16394
138,ضسپا3004,اختيارخ خساپا-2500-1400/03/26,426,23840,128835000,7,17,6,-1,-14.29,5,-2,-28.57,4,17
139,بموتو,موتوژن‌,421,612751,25922557080,44070,42440,41900,-2170,-4.92,42310,-1760,-3.99,41870,43900
140,خكرمان,گروه اقتصادي كرمان خودرو,419,12740341,38707914194,3131,3038,3038,-93,-2.97,3038,-93,-2.97,3038,3068
141,كارين,صندوق س نگين سامان-ثابت,418,12360495,123802282714,10007,10011,10026,19,0.19,10016,9,0.09,10011,10026
142,پارسان,گسترش نفت و گاز پارسيان,408,3087615,52807668130,17840,17300,17050,-790,-4.43,17500,-340,-1.91,16990,17490
143,وتوسم,سرمايه‌گذاري‌توسعه‌ملي‌,400,1718042,10747528780,6220,5930,6350,130,2.09,6250,30,0.48,5930,6430
144,كيان2,صندوق س. با درآمد ثابت كيان,396,39600000,39600000,28517,1,1,-28516,-100,1,-28516,-100,1,1
145,كاردان,صندوق س تجارت شاخصي كاردان,393,347584,47131800330,139890,137200,133460,-6430,-4.6,135600,-4290,-3.07,125920,138490
146,فايرا,آلومينيوم‌ايران‌,392,1769066,30114419390,17880,17840,16990,-890,-4.98,17490,-390,-2.18,16990,17840
147,معيار,سرمايه گذاري معيار صنعت پارس,390,991002,56816101601,57667,59397,55937,-1730,-3,57332,-335,-0.58,55937,59397
148,ضخود7077,اختيارخ خودرو-3000-1400/07/07,389,24083,684843000,31,29,28,-3,-9.68,28,-3,-9.68,26,34
149,طلا,صندوق س.پشتوانه طلاي لوتوس,384,472078,34124435057,70760,71117,72100,1340,1.89,72286,1526,2.16,71117,72990
150,قشرين,قند شيرين خراسان,384,3028455,31935784692,10814,10492,10820,6,0.06,10545,-269,-2.49,10490,10999
151,جم پيلن,پلي پروپيلن جم - جم پيلن,370,565264,36013426920,65890,62650,63450,-2440,-3.7,64350,-1540,-2.34,62650,67740
152,وسلرستا,شركت س استان لرستان,370,25106323,17725064038,743,706,706,-37,-4.98,718,-25,-3.36,706,706
153,تسه9910,امتياز تسهيلات مسكن دي99,370,4073,2340132210,578304,558000,563900,-14404,-2.49,574548,-3756,-0.65,549389,607219
154,لوتوس,تامين سرمايه لوتوس پارسيان,361,4768432,30120489950,6540,6260,6270,-270,-4.13,6320,-220,-3.36,6250,6490
155,فپنتا,سپنتا,358,57359,18177013900,331900,331890,315330,-16570,-4.99,316900,-15000,-4.52,315310,331900
156,شپديس,پتروشيمي پرديس,358,487332,44858832060,93100,91100,91550,-1550,-1.66,92620,-480,-0.52,91100,93500
157,بگيلان,توسعه مسير برق گيلان,346,61871,1118191317,19010,18100,18060,-950,-5,18976,-34,-0.18,18060,18277
158,تيپيكو,سرمايه گذاري دارويي تامين,319,1312263,44023746050,33560,32040,33600,40,0.12,33550,-10,-0.03,32040,33800
159,واعتبار,سرمايه گذاري اعتبار ايران,319,4848748,42098457670,9130,8680,8680,-450,-4.93,8680,-450,-4.93,8680,8930
160,تاصيكو,سرمايه گذاري صدرتامين,313,3040650,28288407800,9780,9300,9300,-480,-4.91,9660,-120,-1.23,9300,9450
161,بپاس,بيمه پاسارگاد,312,284493,27235945703,100236,99997,95225,-5011,-5,99011,-1225,-1.22,95225,99997
162,بترانس,ايران‌ ترانسفو,308,5189375,11338784375,2300,2185,2185,-115,-5,2259,-41,-1.78,2185,2185
163,تسه9909,امتياز تسهيلات مسكن آذر99,306,4317,2475799820,581034,600000,580000,-1034,-0.18,573500,-7534,-1.3,551983,610085
164,دعبيد,لابراتوارداروسازي‌  دكترعبيدي‌,301,379286,9232654210,25050,25660,24500,-550,-2.2,24900,-150,-0.6,24000,25660
165,خراسان,پتروشيمي خراسان,300,155404,9753290360,65550,62320,62310,-3240,-4.94,64940,-610,-0.93,62280,64980
166,ضخود7075,اختيارخ خودرو-2000-1400/07/07,298,8831,1120293000,132,140,119,-13,-9.85,127,-5,-3.79,116,140
167,سكه0012پ01,سكه تمام بهارتحويلي 1روزه رفاه,295,224700,226633017000,996009,1000111,1010105,14096,1.42,1008603,12594,1.26,1000111,1013900
168,پارتا,مجتمع‌صنعتي‌آرتاويل‌تاير,285,709945,23132483698,31635,32584,32584,949,3,32400,765,2.42,32250,32584
169,پاكشو,گروه صنعتي پاكشو,283,3572471,20961809580,6140,5840,5840,-300,-4.89,6090,-50,-0.81,5840,6000
170,فنوال,نورد آلومينيوم‌,281,1187301,28746037600,25460,24190,24190,-1270,-4.99,24210,-1250,-4.91,24190,25130
171,پارسيان,بيمه پارسيان,277,4628865,33756273650,7660,7280,7280,-380,-4.96,7290,-370,-4.83,7280,7490
172,شنفت,نفت‌ پارس‌,275,859279,38726055540,47250,44890,44890,-2360,-4.99,45380,-1870,-3.96,44890,48000
173,كرماشا,صنايع پتروشيمي كرمانشاه,271,734357,21660774050,30920,29420,29380,-1540,-4.98,30180,-740,-2.39,29380,30300
174,كروي,توسعه‌ معادن‌ روي‌ ايران‌,267,1740528,34325652560,20750,19720,19720,-1030,-4.96,19720,-1030,-4.96,19720,19960
175,كنور,توسعه معدني و صنعتي صبانور,266,510525,24223888360,48970,48840,46870,-2100,-4.29,48310,-660,-1.35,46650,48840
176,وصنا,گروه‌صنايع‌بهشهرايران‌,266,2109645,8950770940,4452,4251,4240,-212,-4.76,4317,-135,-3.03,4230,4439
177,پرداخت,به پرداخت ملت,266,1038639,22109004310,21980,20970,20890,-1090,-4.96,21380,-600,-2.73,20890,21700
178,پارس,پتروشيمي پارس,264,201128,28574572110,145380,142600,141900,-3480,-2.39,144410,-970,-0.67,141200,145300
179,جم,پتروشيمي جم,263,1010918,33762460440,33980,32500,32700,-1280,-3.77,33780,-200,-0.59,32500,34000
180,زگلدشتح,ح.كشت و دام گلدشت نمونه اصفهان,261,1209696,6462577158,5564,5310,5286,-278,-5,5342,-222,-3.99,5286,5546
181,وبشهر,توسعه‌ صنايع‌ بهشهر(هلدينگ,258,2144115,19234685760,9290,8840,9050,-240,-2.58,9080,-210,-2.26,8830,9150
182,ضملي3003,اختيارخ فملي-12000-1400/03/02,258,12087,37306000,32,7,1,-31,-96.88,3,-29,-90.63,1,29
183,پكرمان,گروه‌ صنعتي‌ بارز,257,710260,14753370310,21510,20440,20440,-1070,-4.97,20990,-520,-2.42,20440,22000
184,حكشتي,كشتيراني جمهوري اسلامي ايران,251,1061981,14315503880,14180,13480,13480,-700,-4.94,14090,-90,-0.63,13480,13480
185,رمپنا,گروه مپنا (سهامي عام),249,4323910,53746201300,13080,12430,12430,-650,-4.97,12770,-310,-2.37,12430,12430
186,كاريس,صندوق س.سپهر كاريزما-س,247,1846140,18673452954,10281,10290,10099,-182,-1.77,10115,-166,-1.61,10099,10310
187,شخارك,پتروشيمي‌ خارك‌,243,302386,12096541660,42090,39990,39990,-2100,-4.99,41820,-270,-0.64,39990,40300
188,مبين,مبين انرژي خليج فارس,239,1665822,24407809060,15380,14620,14620,-760,-4.94,15220,-160,-1.04,14620,15320
189,آريان,سرمايه گذاري پارس آريان,238,3337433,34344360780,10592,10401,10275,-317,-2.99,10465,-127,-1.2,10275,10500
190,ونفت,سرمايه‌گذاري‌ صنعت‌ نفت‌,230,1228977,15930334970,13640,12960,12960,-680,-4.99,12960,-680,-4.99,12960,13140
191,وثنو,سرمايه گذاري ساختماني نوين,230,3614716,14121230603,4021,4047,3901,-120,-2.98,3907,-114,-2.84,3901,4100
192,نمرينو,ايران‌ مرينوس‌,229,237070,18434778550,74500,77800,78220,3720,4.99,77760,3260,4.38,74550,78220
193,شرانل,نفت ايرانول,224,384541,15118706193,38839,37970,38980,141,0.36,39068,229,0.59,37970,40000
194,اطلس,صندوق س.توسعه اندوخته آينده-س,222,141423,26595166050,191964,191000,187850,-4114,-2.14,188054,-3910,-2.04,187000,191000
195,واحيا,م .صنايع و معادن احياء سپاهان,220,226163,32211333566,144632,141000,142500,-2132,-1.47,143384,-1248,-0.86,141000,144000
196,تسه9803,امتياز تسهيلات مسكن خرداد98,219,3501,1877997886,549339,576805,526000,-23339,-4.25,536418,-12921,-2.35,522000,576805
197,واتي,سرمايه‌ گذاري‌ آتيه‌ دماوند,216,2261476,19637030480,9070,8990,8620,-450,-4.96,8680,-390,-4.3,8620,8990
198,شوينده,مديريت صنعت شوينده ت.ص.بهشهر,214,712443,13485219250,19860,19000,19200,-660,-3.32,18940,-920,-4.63,18870,19650
199,آساميد,صندوق س.مشترك آسمان اميد -د,213,10823137,130517317425,12055,12063,12057,2,0.02,12059,4,0.03,12057,12064
200,تسه9907,امتياز تسهيلات مسكن مهر99,209,2246,1273816587,577094,589999,555604,-21490,-3.72,567149,-9945,-1.72,548240,605948
201,پاسار04,اجاره انرژي پاسارگاد14040302,209,13500000,13500000000000,1000000,1000000,1000000,0,0,1000000,0,0,1000000,1000000
202,عيار,صندوق س. پشتوانه طلاي مفيد,208,319756,8136786117,25142,25580,25555,413,1.64,25447,305,1.21,25142,25900
203,ضسپا3002,اختيارخ خساپا-1800-1400/03/26,207,9391,496095000,64,51,48,-16,-25,53,-11,-17.19,45,89
204,وسپه,سرمايه‌گذاري‌ سپه‌,206,1103289,6483422770,6010,5790,5880,-130,-2.16,5980,-30,-0.5,5790,5970
205,سباقر,سيمان باقران,203,2769670,36394929983,13537,13131,13131,-406,-3,13141,-396,-2.93,13131,13437
206,سمتاز,سيمان ممتازان كرمان,200,642181,14231662235,22735,22053,22084,-651,-2.86,22161,-574,-2.52,22053,22400
207,آساس,صندوق س.آسمان آرماني سهام-س,199,141263,20828644934,152742,151190,146200,-6542,-4.28,147446,-5296,-3.47,146000,151190
208,خصدرا,صنعتي‌ دريايي‌ ايران‌,198,7831783,16611211743,2186,2121,2121,-65,-2.97,2137,-49,-2.24,2121,2121
209,حتايد,تايدواترخاورميانه,198,768445,16660097560,22670,22200,21540,-1130,-4.98,21690,-980,-4.32,21540,22500
210,فولاژ,فولاد آلياژي ايران,198,1516191,20923546850,14520,13800,13800,-720,-4.96,14290,-230,-1.58,13800,13810
211,سخزر,سيمان‌ خزر,197,705643,11409983190,17010,16160,16160,-850,-5,16310,-700,-4.12,16160,16840
212,ضملي3002,اختيارخ فملي-10000-1400/03/02,195,3557,3505601000,1431,1388,930,-501,-35.01,986,-445,-31.1,801,1402
213,فيروزه,صندوق شاخص30 شركت فيروزه- سهام,190,150223,18327356740,125760,123510,121500,-4260,-3.39,122000,-3760,-2.99,120110,123600
214,بفجر,فجر انرژي خليج فارس,189,1108241,22867935240,21700,20620,20770,-930,-4.29,21250,-450,-2.07,20620,21000
215,كاما,باما,179,452236,4074646360,9480,9010,9010,-470,-4.96,9430,-50,-0.53,9010,9010
216,ثبهساز,بهساز كاشانه تهران,178,8052462,15380202420,2010,1910,1910,-100,-4.98,1910,-100,-4.98,1910,1910
217,حسينا,توسعه خدمات دريايي وبندري سينا,173,296776,15030958395,52590,50007,50450,-2140,-4.07,50647,-1943,-3.69,50003,52000
218,وخاور,بانك خاورميانه,173,2471903,20322209340,8300,8340,8270,-30,-0.36,8270,-30,-0.36,8180,8340
219,تسه9904,امتياز تسهيلات مسكن تير99,173,2028,1160000730,574124,555630,551510,-22614,-3.94,571992,-2132,-0.37,545422,602830
220,شرنگي,شيميايي رنگين,172,129891,33507160376,253213,253212,260809,7596,3,257964,4751,1.88,253212,260809
221,زپارس,ملي كشت و صنعت و دامپروري پارس,171,219586,25801275790,118200,112390,112290,-5910,-5,117500,-700,-0.59,112290,123790
222,وسگيلا,شركت س استان گيلان,171,10321923,6585386874,671,638,638,-33,-4.92,665,-6,-0.89,638,638
223,تسه9902,امتياز تسهيلات مسكن ارديبهشت99,171,3462,1969532130,575033,555000,560500,-14533,-2.53,568900,-6133,-1.07,546299,603784
224,دارا,صندوق س. دارا الگوريتم-د,171,6820874,68040984210,9979,9973,9966,-13,-0.13,9975,-4,-0.04,9965,9978
225,سحرخيز,صندوق س. گروه زعفران سحرخيز,170,282663,2297791126,8261,8298,8084,-177,-2.14,8129,-132,-1.6,8044,8298
226,سيستم,همكاران سيستم,166,826355,17109734560,21010,19960,20100,-910,-4.33,20710,-300,-1.43,19960,21250
227,وصندوق,سرمايه‌گذاري‌صندوق‌بازنشستگي‌,166,3728000,48505025090,13690,13500,13010,-680,-4.97,13400,-290,-2.12,13010,13550
228,ضخود7076,اختيارخ خودرو-2500-1400/07/07,166,6447,459189000,73,65,72,-1,-1.37,71,-2,-2.74,65,80
229,وبوعلي,سرمايه‌گذاري‌بوعلي‌,165,1998973,6856867784,3610,3431,3430,-180,-4.99,3519,-91,-2.52,3430,3431
230,رتاپ,تجارت الكترونيك  پارسيان,163,1174473,6672942900,6040,5970,5680,-360,-5.96,5860,-180,-2.98,5680,5970
231,شپاكسا,پاكسان‌,161,531252,10146573380,20040,19320,19040,-1000,-4.99,19340,-700,-3.49,19040,20900
232,ضجار7039,اختيارخ وتجارت-2000-1400/07/21,155,9686,2085811000,285,220,202,-83,-29.12,215,-70,-24.56,200,230
233,تسه9810,امتياز تسهيلات مسكن دي98,155,3149,1770750323,571771,562010,543183,-28588,-5,562321,-9450,-1.65,543183,598000
234,زر,صندوق س.پشتوانه سكه طلاي زر,153,120743,5115526160,41791,42190,42750,959,2.29,42367,576,1.38,41839,42999
235,گوهر,صندوق سكه طلاي كيان,147,348888,17269542465,48316,49188,50200,1884,3.9,49499,1183,2.45,48658,50200
236,شپترو,پتروشيمي آبادان,147,6156000,25338096000,4243,4116,4116,-127,-2.99,4116,-127,-2.99,4116,4116
237,وكار,بانك‌ كارآفرين‌,145,2035742,5378007460,2779,2642,2645,-134,-4.82,2761,-18,-0.65,2641,2685
238,شيراز,پتروشيمي‌شيراز,144,386985,18754454300,50420,48000,49840,-580,-1.15,50040,-380,-0.75,47900,50000
239,اخزا910,اسنادخزانه-م10بودجه99-020807,141,586310,355278394832,605747,605001,605603,-144,-0.02,605957,210,0.03,604095,606496
240,تسه9906,امتياز تسهيلات مسكن شهريور99,141,1425,835423207,584846,614088,614087,29241,5,586262,1416,0.24,555604,614088
241,تماوند,تامين سرمايه دماوند,138,1112590,5405632462,4972,4998,4900,-72,-1.45,4927,-45,-0.91,4823,4998
242,تماوندح,ح . تامين سرمايه دماوند,134,2228406,6899820817,3191,3100,3096,-95,-2.98,3096,-95,-2.98,3096,3100
243,وتوصا,گروه س توسعه صنعتي ايران,127,1691029,13291487940,8270,7860,7860,-410,-4.96,7870,-400,-4.84,7860,7860
244,سپاس,صندوق س. پاداش سهامداري توسعه1,123,2263409,22860818138,10097,10102,10102,5,0.05,10100,3,0.03,10098,10102
245,تسه9905,امتياز تسهيلات مسكن مرداد99,123,1310,759617810,576436,560059,604999,28563,4.96,579861,3425,0.59,547615,605257
246,اوصتا2,صندوق انديشه ورزان صباتامين -د,118,11800000,11800000,18690,1,1,-18689,-99.99,1,-18689,-99.99,1,1
247,ضپاس7029,اختيارخ وپارس-2500-1400/07/28,118,4757,1692608000,364,350,355,-9,-2.47,356,-8,-2.2,320,400
248,خزاميا,زامياد,112,2538650,17135887500,7100,6750,6750,-350,-4.93,6750,-350,-4.93,6750,6750
249,تسه9903,امتياز تسهيلات مسكن خرداد99,111,1070,617654158,579560,551111,550582,-28978,-5,577247,-2313,-0.4,550582,608538
250,صايند,صندوق س. گنجينه آينده روشن-د,107,446130,4335409090,9647,9688,9730,83,0.86,9718,71,0.74,9666,9746
251,شاوان,پالايش نفت لاوان,107,345633,24657657064,75094,71340,71340,-3754,-5,72258,-2836,-3.78,71340,72000
252,ضخود7073,اختيارخ خودرو-1600-1400/07/07,105,4328,1094748000,302,250,244,-58,-19.21,253,-49,-16.23,235,300
253,ماديرا,صنايع ماشين هاي اداري ايران,105,1465926,9527053074,6841,6499,6499,-342,-5,6688,-153,-2.24,6499,6499
254,نهال,صندوق س. طلاي سرخ نوويرا,104,107309,918400655,8478,8256,8557,79,0.93,8558,80,0.94,8256,8690
255,ضملي7002,اختيارخ فملي-10000-1400/07/11,104,3994,9671779000,2987,2500,2329,-658,-22.03,2422,-565,-18.92,2216,2753
256,ارمغان,ص سرمايه گذاري ارمغان ايرانيان,103,2074801,20963036224,10098,10104,10104,6,0.06,10104,6,0.06,10100,10104
257,سپيدما,صندوق س. سپيد دماوند-د,102,3194169,33136209143,10366,10373,10373,7,0.07,10374,8,0.08,10373,10378
258,شپلي,پلي اكريل ايران,97,2350045,20891900050,8403,8890,8890,487,5.8,8890,487,5.8,8890,8890
259,مارون,پتروشيمي مارون,86,43993,6163920199,145628,139680,140010,-5618,-3.86,145273,-355,-0.24,139000,143000
260,فروس,فروسيليس‌ ايران‌,86,2989849,13334726540,4694,4460,4460,-234,-4.99,4464,-230,-4.9,4460,4460
261,خاور,ايران خودرو ديزل,86,3414846,14082824904,4341,4124,4124,-217,-5,4124,-217,-5,4124,4124
262,كخاك,صنايع‌خاك‌چيني‌ايران‌,84,223624,7443242160,35020,33320,33270,-1750,-5,34370,-650,-1.86,33270,33700
263,دلر,داروسازي‌ اكسير,83,99754,2947146960,30580,29060,29060,-1520,-4.97,30370,-210,-0.69,29060,30700
264,بكهنوج,توليد برق ماهتاب كهنوج,82,1785622,2723073550,1605,1525,1525,-80,-4.98,1590,-15,-0.93,1525,1525
265,سدشت,صنايع سيمان دشتستان,81,420045,27764974500,69570,66100,66100,-3470,-4.99,66480,-3090,-4.44,66100,66100
266,ضخود4002,اختيارخ خودرو-1800-1400/04/02,81,3466,383692000,110,111,86,-24,-21.82,111,1,0.91,86,147
267,تسه9901,امتياز تسهيلات مسكن فروردين99,79,543,309908072,581232,552381,560300,-20932,-3.6,570733,-10499,-1.81,552271,600000
268,تسه9804,امتياز تسهيلات مسكن تير98,78,1970,1123243236,576799,562055,559838,-16961,-2.94,570174,-6625,-1.15,548023,590000
269,اخزا908,اسنادخزانه-م8بودجه99-020606,78,345041,216861088823,626871,624199,627672,801,0.13,628508,1637,0.26,624199,629999
270,تسه9811,امتياز تسهيلات مسكن بهمن98,78,590,340372181,568261,596674,540000,-28261,-4.97,576902,8641,1.52,540000,596674
271,لبوتان,گروه‌صنعتي‌بوتان‌,77,119600,6018297130,52960,50400,50320,-2640,-4.98,51830,-1130,-2.13,50320,50400
272,تسه9806,امتياز تسهيلات مسكن شهريور98,76,1156,652067162,581487,560180,555000,-26487,-4.56,564072,-17415,-2.99,552413,584000
273,قصفها,قنداصفهان‌,75,19328,2709978880,155780,140210,140210,-15570,-9.99,152650,-3130,-2.01,140210,140210
274,ضشنا8001,اختيارخ شپنا-8000-1400/08/16,73,1645,2735330000,2048,1127,1650,-398,-19.43,1663,-385,-18.8,1127,1800
275,شصفها,پتروشيمي‌ اصفهان‌,73,140728,16639295934,120606,118846,118194,-2412,-2,118237,-2369,-1.96,118194,119400
276,گشان,توسعه بين المللي پديده شانديز,73,124427,2787538081,22860,22403,22403,-457,-2,22764,-96,-0.42,22403,22403
277,سكه0112پ03,سكه تمام بهارتحويلي1روزه سامان,72,30400,30603030200,994616,1000750,1009000,14384,1.45,1006679,12063,1.21,1000750,1011000
278,وسهمدا,شركت س استان همدان,72,4030000,3191760000,833,792,792,-41,-4.92,829,-4,-0.48,792,792
279,كوير,توليدي فولاد سپيد فراب كوير,72,1488238,20552566780,14530,13810,13810,-720,-4.96,14280,-250,-1.72,13810,13810
280,فردا,صندوق س آواي فرداي زاگرس-ثابت,71,1138925,12225460776,10728,10734,10735,7,0.07,10734,6,0.06,10733,10735
281,كماسه,تامين‌ ماسه‌ ريخته‌گري‌,70,227928,6509623680,30060,28560,28560,-1500,-4.99,29370,-690,-2.3,28560,28560
282,دمعيار,صندوق س. توازن معيار-د,70,1834828,18363955241,10005,10011,10015,10,0.1,10009,4,0.04,10006,10015
283,دپارس,پارس‌ دارو,69,415409,16497724980,41790,39710,39710,-2080,-4.98,39710,-2080,-4.98,39710,42990
284,غگرجي,بيسكويت‌  گرجي‌,68,1057993,13701009350,13630,12950,12950,-680,-4.99,12950,-680,-4.99,12950,12950
285,خاتم,صندوق س خاتم ايساتيس پويا-ثابت,67,1046402,11664390090,11135,11148,11147,12,0.11,11147,12,0.11,11145,11149
286,آكورد2,صندوق س. آرمان آتي كوثر-د,66,6600000,6600000,32200,1,1,-32199,-100,1,-32199,-100,1,1
287,اخزا911,اسنادخزانه-م11بودجه99-020906,65,385910,230389266523,597027,596000,597500,473,0.08,597003,-24,0,595550,597800
288,كمنگنز,معادن‌منگنزايران‌,65,155019,12094582380,86680,78020,78020,-8660,-9.99,78920,-7760,-8.95,78020,78020
289,تسه9809,امتياز تسهيلات مسكن آذر98,64,772,431376919,573578,545915,565000,-8578,-1.5,558778,-14800,-2.58,544900,580000
290,شلرد,كود شيميايي اوره لردگان,64,421375,2410265000,5896,5720,5720,-176,-2.99,5875,-21,-0.36,5720,5720
291,شلعابح,ح . لعابيران‌,61,694404,3782236430,5730,6100,5430,-300,-5.24,5450,-280,-4.89,5430,6100
292,ضخود7072,اختيارخ خودرو-1400-1400/07/07,61,794,332084000,468,435,380,-88,-18.8,418,-50,-10.68,380,480
293,ثعتما,س. ساختماني اعتماد گستر,60,467041,11208984000,33585,24000,24000,-9585,-28.54,24000,-9585,-28.54,24000,24000
294,دارو,كارخانجات‌داروپخش‌,59,78926,2375027360,31400,29830,30000,-1400,-4.46,31230,-170,-0.54,29830,32000
295,تسه9812,امتياز تسهيلات مسكن اسفند98,58,507,296312674,579893,556929,550899,-28994,-5,584443,4550,0.78,550899,608887
296,وبازار,صندوق س شاخصي بازارآشنا,57,243874,2166154790,8990,8440,8900,-90,-1,8880,-110,-1.22,8440,9040
297,اخزا909,اسنادخزانه-م9بودجه99-020316,56,146658,96662002864,658113,658000,660200,2087,0.32,659098,985,0.15,657661,660200
298,آتيمس,صندوق س.آرمان آتيه درخشان مس-س,56,20303,3391040641,169148,168000,165000,-4148,-2.45,167022,-2126,-1.26,165000,168800
299,شصدف,صنعتي دوده فام,55,30661,932554315,32015,30415,30415,-1600,-5,31908,-107,-0.33,30415,30415
300,تسه9805,امتياز تسهيلات مسكن مرداد98,55,972,552839872,578957,560020,570000,-8957,-1.55,568765,-10192,-1.76,550300,578990
301,وحكمت,بيمه حكمت صبا,55,435745,1218866677,2883,2799,2797,-86,-2.98,2872,-11,-0.38,2797,2799
302,سكه0012پ04,سكه تمام بهارتحويلي1روز صادرات,55,14800,14919691100,995633,1010000,1010009,14376,1.44,1008087,12454,1.25,1003609,1013800
303,سپيدار,سپيدار سيستم آسيا,55,36830,1888531910,53975,51277,51277,-2698,-5,53617,-358,-0.66,51277,51277
304,ضملي3000,اختيارخ فملي-8000-1400/03/02,53,560,1812534000,3424,2701,3200,-224,-6.54,3237,-187,-5.46,2701,3650
305,وساخت,سرمايه‌ گذاري‌ ساختمان‌ايران‌,53,76928,2851720960,39020,37070,37070,-1950,-5,38680,-340,-0.87,37070,37070
306,تسه9808,امتياز تسهيلات مسكن آبان98,52,267,148236017,571041,555000,542553,-28488,-4.99,555191,-15850,-2.78,542489,579000
307,اخزا903,اسنادخزانه-م3بودجه99-011110,51,88584,62917577484,711096,709001,712800,1704,0.24,710259,-837,-0.12,709001,712800
308,سكه0011پ02,سكه تمام بهارتحويلي 1روزه ملت,51,7700,7760925500,994892,999000,1009898,15006,1.51,1007912,13020,1.31,999000,1010899
309,نتوس,پشم‌ بافي‌ توس,50,2991208,63075603096,21739,21087,21087,-652,-3,21087,-652,-3,21087,21087
310,بورس,بورس اوراق بهادار تهران,48,392457,11126155950,29840,28350,28350,-1490,-4.99,29470,-370,-1.24,28350,28350
311,ختوقا,قطعات‌ اتومبيل‌ ايران‌,48,454713,878960229,2034,1933,1933,-101,-4.97,2028,-6,-0.29,1933,1933
312,وبيمه,سرمايه‌ گذاري‌ صنعت‌ بيمه‌,47,4247248,9879098848,2448,2326,2326,-122,-4.98,2360,-88,-3.59,2326,2326
313,زعف0008پ05,زعفران0008نگين زرين(پ),47,14894,1775772177,121236,120800,119700,-1536,-1.27,119227,-2009,-1.66,118500,123389
314,اخزا902,اسنادخزانه-م2بودجه99-011019,47,71825,51574348538,716967,717000,719700,2733,0.38,718056,1089,0.15,717000,719700
315,شراز,پالايش نفت شيراز,46,31328,3037209388,101943,96846,96846,-5097,-5,101562,-381,-0.37,96846,98499
316,اخزا901,اسنادخزانه-م1بودجه99-010621,46,78917,60508721271,766011,766000,767008,997,0.13,766739,728,0.1,766000,768000
317,ضملي3001,اختيارخ فملي-9000-1400/03/02,46,448,928458000,2251,2498,1910,-341,-15.15,2072,-179,-7.95,1861,2500
318,مداران,داده‌پردازي‌ايران‌,45,685558,13697448840,21030,19980,19980,-1050,-4.99,19980,-1050,-4.99,19980,19980
319,تسه9807,امتياز تسهيلات مسكن مهر98,45,236,131866730,573019,560010,552003,-21016,-3.67,558757,-14262,-2.49,545111,579998
320,كفرا,فراورده‌ هاي‌ نسوزايران‌,45,395863,8420006010,22380,21270,21270,-1110,-4.96,21690,-690,-3.08,21270,21270
321,ونيكي,سرمايه‌گذاري‌ ملي‌ايران‌,45,80445,660453450,8640,8210,8210,-430,-4.98,8640,0,0,8210,8210
322,دسينا,داروسازي‌ سينا,44,208826,4143107840,20880,19840,19840,-1040,-4.98,20580,-300,-1.44,19840,19840
323,سبزوا,سيمان لار سبزوار,44,254021,782638701,3243,3081,3081,-162,-5,3234,-9,-0.28,3081,3081
324,هفجر102,اختيارف ت بفجر26401-01/02/11,44,717553,127724434,1,178,178,177,17700,178,177,17700,178,178
325,غگلپا,شير پاستوريزه پگاه گلپايگان,43,304215,16424567850,63469,53990,53990,-9479,-14.93,53990,-9479,-14.93,53990,53990
326,ضخود4001,اختيارخ خودرو-1600-1400/04/02,42,2825,370690000,203,130,130,-73,-35.96,131,-72,-35.47,128,150
327,اخزا914,اسنادخزانه-م14بودجه99-021025,42,112380,65163402667,579670,575019,579000,-670,-0.12,579849,179,0.03,575011,581689
328,دكپسول,توليد ژلاتين كپسول ايران,41,440278,12371371522,29577,28099,28099,-1478,-5,28276,-1301,-4.4,28099,28099
329,وثوق,سرمايه گذاري وثوق امين,41,175686,2595760650,15552,14775,14775,-777,-5,15335,-217,-1.4,14775,14775
330,غگيلا,شيرپاستوريزه پگاه گيلان,40,49941,857786616,18079,17176,17176,-903,-4.99,18022,-57,-0.32,17176,17176
331,زعف0008پ08,زعفران0008نگين روستا(پ),40,17741,2109937217,118629,118888,122890,4261,3.59,118930,301,0.25,118000,122890
332,وارس,سرمايه گذاري ارس صبا,40,802451,10931789973,14044,13623,13623,-421,-3,13623,-421,-3,13623,13623
333,زعف0008پ20,زعفران0008نگين وحدت جام(پ),39,2507,297294696,118005,117000,117600,-405,-0.34,118586,581,0.49,117000,119000
334,اتكاي,بيمه اتكايي ايرانيان,39,77232,1093708256,14902,14157,14157,-745,-5,14866,-36,-0.24,14157,14200
335,فاراك,ماشين‌ سازي‌ اراك‌,37,405302,853160710,2215,2105,2105,-110,-4.97,2208,-7,-0.32,2105,2105
336,شكبير,پتروشيمي اميركبير,37,251752,20081659307,82233,79767,79767,-2466,-3,81721,-512,-0.62,79767,80000
337,وكادو,تكادو,37,720910,9333621770,13628,12947,12947,-681,-5,12949,-679,-4.98,12947,12947
338,دشيري,شيرين دارو,36,50030,11437658480,235686,228616,228616,-7070,-3,228616,-7070,-3,228616,228616
339,فيروزا,صندوق بادرآمد ثابت فيروزه آسيا,36,66306,1518507190,22894,22870,22915,21,0.09,22902,8,0.03,22870,22915
340,وبهمن,سرمايه‌گذاري‌بهمن‌,34,120919,1464329090,12740,12110,12110,-630,-4.95,12670,-70,-0.55,12110,12110
341,وپويا,سرمايه گذاري پويا,34,300564,1736057664,6079,5776,5776,-303,-4.98,6042,-37,-0.61,5776,5776
342,ضملي7003,اختيارخ فملي-12000-1400/07/11,34,423,580676000,1494,1900,1210,-284,-19.01,1373,-121,-8.1,1210,1900
343,اوصتا,صندوق انديشه ورزان صباتامين -د,34,690291,12907894241,18690,18700,18700,10,0.05,18699,9,0.05,18691,18700
344,وپترو,سرمايه‌گذاري صنايع پتروشيمي‌,34,182725,1882067500,10840,10300,10300,-540,-4.98,10770,-70,-0.65,10300,10300
345,ضشنا8002,اختيارخ شپنا-9000-1400/08/16,33,582,711272000,1258,1200,1200,-58,-4.61,1222,-36,-2.86,1200,1400
346,سمايه,بانك سرمايه,33,1266623,6098789745,4963,4815,4815,-148,-2.98,4870,-93,-1.87,4815,4815
347,اخزا723,اسنادخزانه-م23بودجه97-000824,33,8210,7474849067,906644,907999,911999,5355,0.59,910457,3813,0.42,907866,911999
348,ساروج,بين المللي ساروج بوشهر,32,338436,5676062397,17288,16775,16770,-518,-3,16984,-304,-1.76,16770,17287
349,همبين102,اختيارف ت مبين19752-01/02/10,32,332850,331518600,608,996,996,388,63.82,996,388,63.82,996,996
350,ضجار7038,اختيارخ وتجارت-1800-1400/07/21,31,1606,520451000,404,330,290,-114,-28.22,324,-80,-19.8,290,340
351,ضجار7040,اختيارخ وتجارت-2500-1400/07/21,30,784,77366000,159,103,92,-67,-42.14,99,-60,-37.74,88,107
352,وتوكا,سرمايه‌گذاري‌توكافولاد(هلدينگ,30,251624,2058284320,8610,8180,8180,-430,-4.99,8550,-60,-0.7,8180,8180
353,غمارگ,مارگارين‌,30,77209,1364283030,18590,17670,17670,-920,-4.95,18500,-90,-0.48,17670,17670
354,زرين,صندوق س. سهام زرين كوروش-س,30,45074,408791868,9175,9300,9040,-135,-1.47,9069,-106,-1.16,8949,9300
355,خمحركه,نيرو محركه‌,30,357516,1346405256,3964,3766,3766,-198,-4.99,3945,-19,-0.48,3766,3766
356,اخزا821,اسنادخزانه-م21بودجه98-020906,29,107375,64120006736,595856,597000,599000,3144,0.53,597160,1304,0.22,594892,599995
357,اخزا815,اسنادخزانه-م15بودجه98-010406,29,21512,17258475950,803407,804000,803039,-368,-0.05,802272,-1135,-0.14,800009,805000
358,ضسپا3001,اختيارخ خساپا-1600-1400/03/26,28,1441,148038000,129,121,90,-39,-30.23,103,-26,-20.16,90,121
359,افق ملت,صندوق س در سهام افق ملت,28,12430,1492214450,121760,120100,119500,-2260,-1.86,120050,-1710,-1.4,119500,121200
360,سپر,صندوق س سپر سرمايه بيدار- ثابت,28,255915,3031172990,11840,11844,11844,4,0.03,11844,4,0.03,11844,11847
361,گكوثر,هتل پارسيان كوثر اصفهان,28,224679,441943593,2070,1967,1967,-103,-4.98,2067,-3,-0.14,1967,1967
362,قنيشا,قند  نيشابور,28,7399,428032150,64270,57850,57850,-6420,-9.99,64070,-200,-0.31,57850,57850
363,ضسپا8040,اختيارخ خساپا-1400-1400/08/26,28,592,172753000,325,310,270,-55,-16.92,292,-33,-10.15,270,310
364,اخزا814,اسنادخزانه-م14بودجه98-010318,27,21647,17514212717,807603,808000,815000,7397,0.92,809083,1480,0.18,808000,815000
365,خودكفا,اقتصادي و خودكفايي آزادگان,26,55223,912836190,17399,16530,16530,-869,-4.99,17377,-22,-0.13,16530,16530
366,اخزا808,اسنادخزانه-م8بودجه98-000817,26,22763,20759194168,908736,909000,911003,2267,0.25,911971,3235,0.36,908004,913999
367,انرژي3,سايراشخاص بورس انرژي,25,3767,846708590,236590,224770,224770,-11820,-5,236400,-190,-0.08,224770,224770
368,دزهراوي,داروسازي‌زهراوي‌,25,45707,288868240,6650,6320,6320,-330,-4.96,6640,-10,-0.15,6320,6320
369,بايكا,كارخانجات كابلسازي ‌ايران‌,24,240000,9725760000,41777,40524,40524,-1253,-3,40524,-1253,-3,40524,40524
370,شفارا,پتروشيمي فارابي,24,1282212,4204373148,3380,3279,3279,-101,-2.99,3336,-44,-1.3,3279,3279
371,پتاير,ايران‌ تاير,24,95469,292230609,3222,3061,3061,-161,-5,3219,-3,-0.09,3061,3061
372,وبرق,س.کارکنان صنعت برق زنجان وقزوي,24,58741,2457488476,43129,41836,41836,-1293,-3,42797,-332,-0.77,41836,41836
373,وسهرمز,شركت س استان هرمزگان,23,1000000,871000000,916,871,871,-45,-4.91,915,-1,-0.11,871,871
374,چخزر,صنايع چوب خزر كاسپين,23,22722,710062500,32894,31250,31250,-1644,-5,32812,-82,-0.25,31250,31250
375,خديزل,بهمن  ديزل,23,78778,2784093298,37201,35341,35341,-1860,-5,36835,-366,-0.98,35341,35341
376,كگهر,سنگ آهن گهرزمين,23,179651,7119748781,41716,39631,39631,-2085,-5,41586,-130,-0.31,39631,39631
377,درهآور,دارويي ره آورد تامين,23,381643,10180708668,28080,26676,26676,-1404,-5,27077,-1003,-3.57,26676,26676
378,ضشنا8003,اختيارخ شپنا-10000-1400/08/16,22,335,309672000,861,2000,895,34,3.95,924,63,7.32,800,2000
379,وپخش,داروپخش‌ (هلدينگ‌,22,2780,250867200,94980,90240,90240,-4740,-4.99,94940,-40,-0.04,90240,90240
380,زعف0008پ19,زعفران0008نگين تروند قاينات(پ),22,4084,485996000,117989,119000,119000,1011,0.86,119000,1011,0.86,119000,119000
381,آسام,صندوق س.آرمان سپهر آشنا-م,22,71850,7100716300,100216,96750,99000,-1216,-1.21,98827,-1389,-1.39,96500,101010
382,هپارس102,اختيارف ت پارس-177010-01/02/05,22,32267,56305915,992,1745,1745,753,75.91,1745,753,75.91,1745,1745
383,لخزر,پارس‌ خزر,22,1798,312150780,182740,173610,173610,-9130,-5,182540,-200,-0.11,173610,173610
384,صنوين,صندوق سرمايه‌گذاري صنوين-مختلط,22,12304,1254976760,102860,102450,101700,-1160,-1.13,102000,-860,-0.84,101700,102810
385,گنجين,صندوق س. گنجينه يكم آويد-د,21,348744,4489653002,12867,12873,12884,17,0.13,12874,7,0.05,12873,12885
386,اخزا907,اسنادخزانه-م7بودجه99-020704,21,56883,35211067638,617049,617049,617189,140,0.02,619009,1960,0.32,617049,619500
387,پخش,پخش البرز,21,310842,9084046608,30762,29224,29224,-1538,-5,29777,-985,-3.2,29224,29224
388,اخزا812,اسنادخزانه-م12بودجه98-001111,20,13758,12005446658,872058,872501,872000,-58,-0.01,872616,558,0.06,872000,873100
389,فراز,صندوق س.سهام فراز داريك-س,20,16833,173936859,10333,10338,10333,0,0,10333,0,0,10333,10338
390,ستران,سيمان‌ تهران‌,20,40807,863068050,22260,21150,21150,-1110,-4.99,22200,-60,-0.27,21150,21150
391,اخزا817,اسنادخزانه-م17بودجه98-010512,20,9993,7851170394,782104,783000,785551,3447,0.44,785667,3563,0.46,783000,786900
392,اخزا818,اسنادخزانه-م18بودجه98-010614,20,13097,10112114445,770946,769000,771020,74,0.01,772094,1148,0.15,769000,773344
393,كلوند,كاشي‌ الوند,19,107855,2108565250,20570,19550,19550,-1020,-4.96,20420,-150,-0.73,19550,19550
394,بذر,صندوق س بذر اميد آفرين-سهام,19,7503,631973540,86700,85660,83980,-2720,-3.14,84230,-2470,-2.85,83980,85660
395,وآيند,بانك  آينده,19,23599,369654736,16316,15664,15664,-652,-4,16313,-3,-0.02,15664,15664
396,شساخت,مهندسي و ساختمان صنايع نفت,19,7033,292215482,42799,42300,41516,-1283,-3,42790,-9,-0.02,41516,42300
397,ثاخت,بين‌المللي‌توسعه‌ساختمان,18,73125,165701250,2385,2266,2266,-119,-4.99,2384,-1,-0.04,2266,2266
398,قثابت,قند ثابت‌ خراسان‌,18,8897,510776770,60430,57410,57410,-3020,-5,60320,-110,-0.18,57410,57410
399,لسرما,سرما آفرين‌,18,200493,4256466390,22340,21230,21230,-1110,-4.97,22010,-330,-1.48,21230,21230
400,چكارن,كارتن‌ ايران‌,17,69325,211163950,3206,3046,3046,-160,-4.99,3204,-2,-0.06,3046,3046
401,قاسم,قاسم ايران,17,50533,522309088,10880,10336,10336,-544,-5,10857,-23,-0.21,10336,10336
402,سامان,بانك سامان,17,411435,3697977780,9265,8988,8988,-277,-2.99,9240,-25,-0.27,8988,8988
403,زعف0008پ16,زعفران0008نگين بيرجند(پ),17,531,62733563,117977,117040,117601,-376,-0.32,118142,165,0.14,117040,118898
404,خريخت,صنايع‌ريخته‌گري‌ايران‌,17,795099,1787382552,2366,2248,2248,-118,-4.99,2351,-15,-0.63,2248,2248
405,اخزا810,اسنادخزانه-م10بودجه98-001006,17,13146,11629004338,868521,884000,886200,17679,2.04,884604,16083,1.85,882001,886200
406,فخاس,فولاد خراسان,16,592492,13662865520,24270,23060,23060,-1210,-4.99,24100,-170,-0.7,23060,23060
407,كفپارس,فرآورده‌هاي‌ نسوز پارس‌,16,435011,1324608495,3205,3045,3045,-160,-4.99,3190,-15,-0.47,3045,3045
408,ولتجار,واسپاري تجارت وسرمايه ايرانيان,16,623458,4540644614,7666,7283,7283,-383,-5,7483,-183,-2.39,7283,7283
409,كالا,بورس كالاي ايران,16,27956,825820240,31090,29540,29540,-1550,-4.99,31050,-40,-0.13,29540,29540
410,آپ,آسان پرداخت پرشين,15,15401,240409610,16430,15610,15610,-820,-4.99,16420,-10,-0.06,15610,15610
411,گوهر2,صندوق سكه طلاي كيان,15,150000,150000,48316,1,1,-48315,-100,1,-48315,-100,1,1
412,شاملا,معدني‌ املاح‌  ايران‌,15,108850,3989352500,38570,36650,36650,-1920,-4.98,38020,-550,-1.43,36650,36650
413,قيستو,شركت قند بيستون,15,291100,4789468300,17138,16453,16453,-685,-4,16454,-684,-3.99,16453,16453
414,اخزا820,اسنادخزانه-م20بودجه98-020806,15,15857,9630206584,605724,607010,608889,3165,0.52,607316,1592,0.26,607000,608940
415,فردا2,صندوق س آواي فرداي زاگرس-ثابت,14,1400000,1400000,10728,1,1,-10727,-99.99,1,-10727,-99.99,1,1
416,اخزا904,اسنادخزانه-م4بودجه99-011215,14,29478,20496160300,694500,696000,698000,3500,0.5,695304,804,0.12,695000,698000
417,بكام,كارخانجات توليدي شهيد قندي,14,48624,179519808,3886,3692,3692,-194,-4.99,3884,-2,-0.05,3692,3692
418,ضسپا8041,اختيارخ خساپا-1600-1400/08/26,14,801,168004000,222,222,180,-42,-18.92,210,-12,-5.41,175,225
419,الماس,صندوق س.امين تدبيرگران فردا-س,14,2452,245362860,102943,100021,100000,-2943,-2.86,100066,-2877,-2.79,100000,101000
420,وسديد,گروه ‌صنعتي‌سديد,14,173524,481702624,2891,2776,2776,-115,-3.98,2889,-2,-0.07,2776,2776
421,دماوند,توليد نيروي برق دماوند,14,5554,161943532,30692,29158,29158,-1534,-5,30688,-4,-0.01,29158,29158
422,اخزا811,اسنادخزانه-م11بودجه98-001013,13,30321,26743697747,880365,882052,882000,1635,0.19,882019,1654,0.19,882000,882171
423,سپيدما2,صندوق س. سپيد دماوند-د,13,130000000,130000000,10366,1,1,-10365,-99.99,1,-10365,-99.99,1,1
424,فسرب,ملي‌ سرب‌وروي‌ ايران‌,13,14012,966687880,72620,68990,68990,-3630,-5,72370,-250,-0.34,68990,68990
425,لپارس,پارس‌ الكتريك‌,13,32976,2784163680,88870,84430,84430,-4440,-5,88000,-870,-0.98,84430,84430
426,كدما,معدني‌ دماوند,13,2224,174739680,82700,78570,78570,-4130,-4.99,82650,-50,-0.06,78570,78570
427,كترام,توليدي‌ كاشي‌ تكسرام‌,12,3630,158413200,48480,43640,43640,-4840,-9.98,48420,-60,-0.12,43640,43640
428,وهور,مديريت انرژي اميد  تابان هور,12,100423,190201162,1993,1894,1894,-99,-4.97,1993,0,0,1894,1894
429,زملارد,كشاورزي و دامپروري ملارد شير,12,14375,499689375,36590,34761,34761,-1829,-5,36526,-64,-0.17,34761,34761
430,دانا,بيمه دانا,12,133522,742382320,5850,5560,5560,-290,-4.96,5830,-20,-0.34,5560,5560
431,هاي وب,داده گسترعصرنوين-هاي وب,12,53032,522895520,10370,9860,9860,-510,-4.92,10360,-10,-0.1,9860,9860
432,چكاپا,گروه صنايع كاغذ پارس,12,38520,185666400,5070,4820,4820,-250,-4.93,5070,0,0,4820,4820
433,ضصاد3001,اختيارخ وبصادر-2000-1400/03/12,12,398,13229000,68,38,40,-28,-41.18,33,-35,-51.47,18,40
434,اطلس2,صندوق س.توسعه اندوخته آينده-س,12,120000,120000,191964,1,1,-191963,-100,1,-191963,-100,1,1
435,نوين,بيمه نوين,12,101443,560878347,5820,5529,5529,-291,-5,5809,-11,-0.19,5529,5529
436,طملي3008,اختيارف فملي-24000-1400/03/02,11,1100,13639000000,1,12300,12530,12529,1252900,12399,12398,1239800,12300,12530
437,ساذري,آذريت‌,11,213901,1338164656,6074,6256,6256,182,3,6097,23,0.38,6256,6256
438,حخزر,كشتيراني درياي خزر,11,400466,10799366622,28386,26967,26967,-1419,-5,27311,-1075,-3.79,26967,26967
439,اخزا721,اسنادخزانه-م21بودجه97-000728,11,24725,22729361130,917511,919701,924699,7188,0.78,919287,1776,0.19,918001,924699
440,اتكام,شركت بيمه اتكايي امين,10,35257,149278138,4456,4234,4234,-222,-4.98,4454,-2,-0.04,4234,4234
441,عيار2,صندوق س. پشتوانه طلاي مفيد,10,100000,100000,25142,1,1,-25141,-100,1,-25141,-100,1,1
442,دتماد,توليدمواداوليه‌داروپخش‌,10,6415,253649100,41620,39540,39540,-2080,-5,41580,-40,-0.1,39540,39540
443,دروز,داروسازي‌ روزدارو,10,50000,1429000000,30080,28580,28580,-1500,-4.99,29930,-150,-0.5,28580,28580
444,تايرا,تراكتورسازي‌ايران‌,10,13641,314834280,24290,23080,23080,-1210,-4.98,24280,-10,-0.04,23080,23080
445,اخزا809,اسنادخزانه-م9بودجه98-000923,10,2608,2326617535,892180,892002,892610,430,0.05,892108,-72,-0.01,892002,892615
446,تملي710,تسهيلات مسكن ب. ملي-دي97,10,164,140259520,896800,851960,941640,44840,5,855241,-41559,-4.63,851960,941640
447,فسازان,غلتك سازان سپاهان,10,109653,3213929430,30850,29310,29310,-1540,-4.99,30500,-350,-1.13,29310,29310
448,اخزا806,اسنادخزانه-م6بودجه98-000519,10,3481,3339580500,957199,958500,959000,1801,0.19,959374,2175,0.23,958500,960000
449,فرابورس,فرابورس ايران,9,12453,366703491,30996,29447,29447,-1549,-5,30979,-17,-0.05,29447,29447
450,تملي801,تسهيلات مسكن ب. ملي-فروردين98,9,202,137557350,699561,664583,734539,34978,5,680977,-18584,-2.66,664583,734539
451,ثشاهد,سرمايه‌ گذاري‌ شاهد,9,13767,223713750,17100,16250,16250,-850,-4.97,17090,-10,-0.06,16250,16250
452,افران2,صندوق س افرا نماد پايدار-ثابت,9,90000000,90000000,13355,1,1,-13354,-99.99,1,-13354,-99.99,1,1
453,رافزا,رايان هم افزا,9,556,55948056,105922,100626,100626,-5296,-5,105901,-21,-0.02,100626,100626
454,ولانا,شركت ليزينگ آريا دانا,9,8225,289051175,36229,35143,35143,-1086,-3,36197,-32,-0.09,35143,35143
455,اخزا807,اسنادخزانه-م7بودجه98-000719,9,1626,1501651126,923096,927239,928997,5901,0.64,923525,429,0.05,923000,929849
456,فمراد,آلومراد,9,2284,179590920,82760,78630,78630,-4130,-4.99,82710,-50,-0.06,78630,78630
457,باران,بيمه زندگي باران50%تاديه,9,76052,305957196,3832,4023,4023,191,4.98,3838,6,0.16,4023,4023
458,خفولا,خدمات فني فولاد يزد,9,12150,500081850,43325,41159,41159,-2166,-5,43211,-114,-0.26,41159,41159
459,ضغدر3003,اختيارخ وغدير-9200-1400/03/26,9,200,61000000,452,300,310,-142,-31.42,305,-147,-32.52,300,310
460,غشهداب,كشت و صنعت شهداب ناب خراسان,9,19921,74145962,3917,3722,3722,-195,-4.98,3916,-1,-0.03,3722,3722
461,اخزا804,اسنادخزانه-م4بودجه98-000421,8,5208,5067395000,971968,973000,975200,3232,0.33,973002,1034,0.11,973000,975200
462,توريل,توکاريل,8,15702,241245528,16172,15364,15364,-808,-5,16162,-10,-0.06,15364,15364
463,اراد35,مرابحه عام دولت3-ش.خ 0103,8,5900,5640744900,950000,997400,949000,-1000,-0.11,956058,6058,0.64,945000,997499
464,ضسپا8039,اختيارخ خساپا-1200-1400/08/26,8,164,71010000,805,490,420,-385,-47.83,433,-372,-46.21,420,490
465,وآرين,شركت توسعه اقتصادي آرين,8,17541,58902678,3461,3358,3358,-103,-2.98,3460,-1,-0.03,3358,3358
466,ضخوز7037,اختيارخ فخوز-12000-1400/07/14,8,24,80400000,3722,3500,3000,-722,-19.4,3350,-372,-9.99,3000,3500
467,ضملي7005,اختيارخ فملي-16000-1400/07/11,8,15,3707000,500,300,300,-200,-40,247,-253,-50.6,210,300
468,هنوري102,اختيارف ت نوري73761-01/02/15,8,9010,36058020,1262,4002,4002,2740,217.12,4002,2740,217.12,4002,4002
469,تملي703,تسهيلات مسكن ب. ملي-خرداد97,8,379,252898509,645561,677839,613283,-32278,-5,667278,21717,3.36,613283,677839
470,كرازي,كارخانجات‌توليدي‌شيشه‌رازي‌,8,16793,346775450,21730,20650,20650,-1080,-4.97,21700,-30,-0.14,20650,20650
471,ثروتم,صندوق س. ثروت آفرين پارسيان-س,8,16720,1178177920,72128,71152,70208,-1920,-2.66,70465,-1663,-2.31,70010,71510
472,سخند,صندوق س.سپهرخبرگان نفت-د,7,34410,344504100,10002,10000,10040,38,0.38,10012,10,0.1,10000,10040
473,سيلام,سيمان‌ ايلام‌,7,8600,90214000,11040,10490,10490,-550,-4.98,11040,0,0,10490,10490
474,ضپيك7041,اختيارخ تاپيكو-9000-00/07/18,7,164,282020000,1850,1660,2000,150,8.11,1720,-130,-7.03,1550,2000
475,اراد33,مرابحه عام دولت3-ش.خ 0303,7,5500,4901893300,889979,897000,898000,8021,0.9,891253,1274,0.14,875000,898999
476,دفرا,فرآورده‌هاي‌ تزريقي‌ ايران‌,7,26500,609500000,24210,23000,23000,-1210,-5,24160,-50,-0.21,23000,23000
477,اميد,تامين سرمايه اميد,7,10050,72862500,7630,7250,7250,-380,-4.98,7630,0,0,7250,7250
478,تليسه,دامداري تليسه نمونه,7,12758,52116430,4299,4085,4085,-214,-4.98,4298,-1,-0.02,4085,4085
479,وملي,گروه‌ صنعتي‌ ملي‌ (هلدينگ‌,7,704,111288320,166390,158080,158080,-8310,-4.99,166330,-60,-0.04,158080,158080
480,بساما,بيمه سامان,7,9274,170140804,19311,18346,18346,-965,-5,19300,-11,-0.06,18346,18346
481,كاذر,فرآورده‌هاي‌نسوزآذر,7,15744,248282880,16590,15770,15770,-820,-4.94,16580,-10,-0.06,15770,15770
482,ضملي7004,اختيارخ فملي-14000-1400/07/11,7,53,46809000,1509,880,899,-610,-40.42,883,-626,-41.48,860,899
483,زبينا,كشاورزي و دامپروري بينالود,7,43988,162975540,3900,3705,3705,-195,-5,3898,-2,-0.05,3705,3705
484,زعف0008پ10,زعفران0008نگين طلاي سرخ(پ),7,1420,170003600,121553,119105,120000,-1553,-1.28,119721,-1832,-1.51,119005,120000
485,ثفارس,عمران‌وتوسعه‌فارس‌,7,26918,248453140,9710,9230,9230,-480,-4.94,9700,-10,-0.1,9230,9230
486,تملي704,تسهيلات مسكن ب. ملي-تير97,7,237,134673855,596826,566985,596826,0,0,568244,-28582,-4.79,566985,596826
487,ولشرق,ليزينگ ايران و شرق,7,251856,2030463072,8486,8062,8062,-424,-5,8425,-61,-0.72,8062,8062
488,پلوله,گازلوله‌,6,13229,360172754,28068,27226,27226,-842,-3,28037,-31,-0.11,27226,27226
489,بزاگرس,نيروگاه زاگرس كوثر,6,6261,42474624,7141,6784,6784,-357,-5,7140,-1,-0.01,6784,6784
490,ضسپا3000,اختيارخ خساپا-1400-1400/03/26,6,126,30832000,333,297,230,-103,-30.93,245,-88,-26.43,230,297
491,حفارس,حمل و نقل بين المللي خليج فارس,6,148207,667376121,4739,4503,4503,-236,-4.98,4728,-11,-0.23,4503,4503
492,دسانكو,داروسازي سبحان انكولوژي,6,22900,320783200,14745,14008,14008,-737,-5,14728,-17,-0.12,14008,14008
493,خاذين,سايپاآذين‌,6,86770,376234720,4564,4336,4336,-228,-5,4558,-6,-0.13,4336,4336
494,اخزا720,اسنادخزانه-م20بودجه97-000324,6,50,49395023,989454,988500,987500,-1954,-0.2,987900,-1554,-0.16,987500,988500
495,تملي802,تسهيلات مسكن ب. ملي-ارديبهشت98,6,175,129748040,771621,733040,810200,38579,5,741417,-30204,-3.91,733040,810200
496,دتوليد,داروسازي توليد دارو,6,12139,303074413,26281,24967,24967,-1314,-5,26253,-28,-0.11,24967,24967
497,اخزا905,اسنادخزانه-م5بودجه99-020218,6,11990,8022359310,669153,669173,669010,-143,-0.02,669087,-66,-0.01,669010,669173
498,تملي612,تسهيلات مسكن بانك ملي-اسفند96,6,57,32319000,540000,567000,567000,27000,5,567000,27000,5,567000,567000
499,فرآور,فرآوري‌موادمعدني‌ايران‌,6,1951,58061760,31320,29760,29760,-1560,-4.98,31310,-10,-0.03,29760,29760
500,تملي803,تسهيلات مسكن ب. ملي-خرداد98,6,93,79781445,817015,857865,857865,40850,5,857865,40850,5,857865,857865
501,غزر,صنعتي زر ماكارون,6,2117,48945040,24330,23120,23120,-1210,-4.97,24330,0,0,23120,23120
502,برن0003پ01,برنج طارم0003تجارت مازندران(پ),6,823,227201000,275778,275000,276000,222,0.08,276064,286,0.1,275000,277000
503,كطبس,ذغال‌سنگ‌ نگين‌ ط‌بس‌,6,86205,5835216450,71250,67690,67690,-3560,-5,69790,-1460,-2.05,67690,67690
504,تصميم2,صندوق س با درآمد ثابت تصميم,6,6000000,6000000,16388,1,1,-16387,-99.99,1,-16387,-99.99,1,1
505,گدنا,تهيه توزيع غذاي دنا آفرين فدك,6,4641,148776537,33744,32057,32057,-1687,-5,33726,-18,-0.05,32057,32057
506,شكلر,نيروكلر,6,2372,92697760,41130,39080,39080,-2050,-4.98,41120,-10,-0.02,39080,39080
507,زنگان,صنعت روي زنگان,6,3690,365405940,104237,99026,99026,-5211,-5,104103,-134,-0.13,99026,99026
508,فوكا,فولاد كاويان,6,8393,90577256,11360,10792,10792,-568,-5,11358,-2,-0.02,10792,10792
509,ضملي7001,اختيارخ فملي-9000-1400/07/11,6,61,223251000,3800,4500,3000,-800,-21.05,3660,-140,-3.68,3000,4500
510,دبالك,مواد اوليه دارويي البرز بالك,6,12225,240306825,20691,19657,19657,-1034,-5,20674,-17,-0.08,19657,19657
511,خكاوه,سايپا ديزل,5,10453,35571559,3582,3403,3403,-179,-5,3581,-1,-0.03,3403,3403
512,بخاور,بيمه زندگي خاورميانه,5,13846,82785234,6293,5979,5979,-314,-4.99,6291,-2,-0.03,5979,5979
513,داسوه,داروسازي‌ اسوه‌,5,4662,162097740,36590,34770,34770,-1820,-4.97,36570,-20,-0.05,34770,34770
514,خعمرا,توسعه و عمران شهرستان نائين,5,10001,245724570,23400,24570,24570,1170,5,23427,27,0.12,24570,24570
515,رتكو,كنترل‌خوردگي‌تكين‌كو,5,60000,985800000,17290,16430,16430,-860,-4.97,17230,-60,-0.35,16430,16430
516,خمهر,مهركام‌پارس‌,5,111543,239259735,2257,2145,2145,-112,-4.96,2255,-2,-0.09,2145,2145
517,خبازرس,بازرسي مهندسي و صنعتي ايران,5,22900,563202600,25354,24594,24594,-760,-3,25310,-44,-0.17,24594,24594
518,سجام,مجتمع سيمان غرب آسيا,5,9594,37138374,3990,3871,3871,-119,-2.98,3990,0,0,3871,3871
519,كبافق,معادن‌ بافق‌,5,815,36096350,46620,44290,44290,-2330,-5,46620,0,0,44290,44290
520,زكوثر,سرمايه گذاري كشاورزي كوثر,5,1617,32307660,21030,19980,19980,-1050,-4.99,21030,0,0,19980,19980
521,فاما,صنعتي‌ آما,5,8828,127034920,15140,14390,14390,-750,-4.95,15130,-10,-0.07,14390,14390
522,غاذر,كشت‌وصنعت‌پياذر,5,852,45224160,55870,53080,53080,-2790,-4.99,55860,-10,-0.02,53080,53080
523,بمپنا,توليد برق عسلويه  مپنا,5,1418,89020622,66083,62779,62779,-3304,-5,66067,-16,-0.02,62779,62779
524,قجام,فرآوردههاي غذايي وقندتربت‌جام‌,5,688,9257728,13730,13456,13456,-274,-2,13729,-1,-0.01,13456,13456
525,سيمرغ,سيمرغ,5,3455,59149600,18020,17120,17120,-900,-4.99,18020,0,0,17120,17120
526,رنيك,جنرال مكانيك,5,18650,394391550,22259,21147,21147,-1112,-5,22228,-31,-0.14,21147,21147
527,اشاد10,مشاركت دولتي10-شرايط خاص001226,5,62500,60000000000,959999,960000,960000,1,0,960000,1,0,960000,960000
528,ضترا8057,اختيارخ شتران-7000-1400/08/09,4,106,127000000,1216,1200,1000,-216,-17.76,1198,-18,-1.48,1000,1200
529,كحافظ,كاشي‌ وسراميك‌ حافظ‌,4,4015,44968000,11780,11200,11200,-580,-4.92,11780,0,0,11200,11200
530,ضفار3002,اختيارخ فارس-10000-1400/03/05,4,30,160000,571,5,6,-565,-98.95,5,-566,-99.12,5,6
531,شلعاب,لعابيران‌,4,2333,29325810,13230,12570,12570,-660,-4.99,13230,0,0,12570,12570
532,ودي,بيمه  دي,4,5000,95790000,20166,19158,19158,-1008,-5,20161,-5,-0.02,19158,19158
533,بسويچ,پارس‌سويچ‌,4,3826,99935120,27490,26120,26120,-1370,-4.98,27480,-10,-0.04,26120,26120
534,ختور,رادياتور ايران‌,4,5188,94006560,19070,18120,18120,-950,-4.98,19060,-10,-0.05,18120,18120
535,تملي807,تسهيلات مسكن ب. ملي-مهر98,4,61,31326123,489089,513543,513543,24454,5,513543,24454,5,513543,513543
536,بميلا,توسعه بازرگاني آهن وفولادميلاد,4,18709,224246074,12356,11986,11986,-370,-2.99,12347,-9,-0.07,11986,11986
537,زعف0008پ12,زعفران0008پوشالمعمول سحرخيز(پ),4,353,30333290,89400,85930,85930,-3470,-3.88,85930,-3470,-3.88,85930,85930
538,شكربن,كربن‌ ايران‌,4,100320,7036444800,73830,70140,70140,-3690,-5,71980,-1850,-2.51,70140,70140
539,غمينو,شركت صنايع غذايي مينو شرق,4,15996,150570348,9908,9413,9413,-495,-5,9903,-5,-0.05,9413,9413
540,حريل,ريل پردازسير,4,8004,41756868,5491,5217,5217,-274,-4.99,5490,-1,-0.02,5217,5217
541,ضپاس7028,اختيارخ وپارس-2000-1400/07/28,4,33,24860000,702,600,700,-2,-0.28,753,51,7.26,600,808
542,نگين,ص.س. زمين و ساختمان نگين شهرري,4,919,43923880,47540,47540,47560,20,0.04,47800,260,0.55,47540,48000
543,حبندر,دريايي و کشتيراني خط دريابندر,4,106035,3399163995,33048,32057,32057,-991,-3,32701,-347,-1.05,32057,32057
544,اخزا813,اسنادخزانه-م13بودجه98-010219,4,1196,985691153,821988,823001,825001,3013,0.37,824156,2168,0.26,823001,825001
545,كهمدا,شيشه‌ همدان‌,4,18424,174106800,9940,9450,9450,-490,-4.93,9930,-10,-0.1,9450,9450
546,افاد82,منفعت دولت8-ش.خاص لوتوس0205,4,2000,1961676800,960000,979900,988888,28888,3.01,980838,20838,2.17,979900,988888
547,داريك,صندوق س.اعتماد داريك-د,4,20480,216912240,10586,10588,10592,6,0.06,10591,5,0.05,10588,10592
548,اخزا718,اسنادخزانه-م18بودجه97-000525,4,404,388433658,952096,961977,960000,7904,0.83,961469,9373,0.98,960000,961979
549,تملي701,تسهيلات مسكن ب. ملي-فروردين97,4,234,132750072,597166,567308,567308,-29858,-5,567308,-29858,-5,567308,567308
550,ديران,ايران‌دارو,3,10850,178265500,17290,16430,16430,-860,-4.97,17280,-10,-0.06,16430,16430
551,ولصنم,ليزينگ‌صنعت‌ومعدن‌,3,8295,87180450,11060,10510,10510,-550,-4.97,11060,0,0,10510,10510
552,خكار,ايركا پارت صنعت,3,1546,31832140,21670,20590,20590,-1080,-4.98,21670,0,0,20590,20590
553,كباده,توليد خاك نسوزاستقلال آباده,3,77949,703645623,8765,9027,9027,262,2.99,8783,18,0.21,9027,9027
554,نطرين,عطرين نخ قم,3,3200,36496000,12005,11405,11405,-600,-5,12003,-2,-0.02,11405,11405
555,ساينا,صنايع بهداشتي ساينا,3,720,99900000,146052,138750,138750,-7302,-5,146001,-51,-0.03,138750,138750
556,كپارس,كاشي‌ پارس‌,3,752,106242560,148710,141280,141280,-7430,-5,148650,-60,-0.04,141280,141280
557,پكوير,كوير تاير,3,13354,160381540,12640,12010,12010,-630,-4.98,12630,-10,-0.08,12010,12010
558,بهپاك,صنعتي بهپاك,3,3478,22311370,6752,6415,6415,-337,-4.99,6751,-1,-0.01,6415,6415
559,زعف0008پ11,زعفران0008نگين سحرخيز(پ),3,937,113914948,122539,120005,122000,-539,-0.44,121574,-965,-0.79,120005,122000
560,تكنو,تكنوتار,3,49000,997150000,21420,20350,20350,-1070,-5,21340,-80,-0.37,20350,20350
561,شاروم,پتروشيمي اروميه,3,6175,112354125,19152,18195,18195,-957,-5,19144,-8,-0.04,18195,18195
562,غدام,خوراك‌  دام‌ پارس‌,3,526,196797640,393830,374140,374140,-19690,-5,393560,-270,-0.07,374140,374140
563,فسا,پتروشيمي فسا,3,22877,39211178,1766,1714,1714,-52,-2.94,1766,0,0,1714,1714
564,ريشمك,توليد و صادرات ريشمك,3,51617,2734875128,55772,52984,52984,-2788,-5,55232,-540,-0.97,52984,52984
565,مفاخر,توسعه فناوري اطلاعات خوارزمي,3,80000,4651520000,61204,58144,58144,-3060,-5,60205,-999,-1.63,58144,58144
566,ضصاد8030,اختيارخ وبصادر-1600-1400/08/12,3,42,16380000,850,390,390,-460,-54.12,390,-460,-54.12,390,390
567,زدشت,كشت و صنعت دشت خرم دره,3,1500,40576500,28474,27051,27051,-1423,-5,28470,-4,-0.01,27051,27051
568,مرقام,ايران‌ارقام‌,3,6373,117581850,19420,18450,18450,-970,-4.99,19410,-10,-0.05,18450,18450
569,غفارس,شير پاستوريزه پگاه فارس,3,1147,19874069,18238,17327,17327,-911,-5,18237,-1,-0.01,17327,17327
570,غبهنوش,بهنوش‌ ايران‌,3,268,17532560,68860,65420,65420,-3440,-5,68860,0,0,65420,65420
571,وليز,ليزينگ‌ايران‌,3,11987,108722090,9540,9070,9070,-470,-4.93,9540,0,0,9070,9070
572,خنصير,مهندسي‌نصيرماشين‌,3,1050,108139500,108410,102990,102990,-5420,-5,108370,-40,-0.04,102990,102990
573,اخزا716,اسنادخزانه-م16بودجه97-000407,3,141,138461994,980019,981999,982000,1981,0.2,982000,1981,0.2,981999,982000
574,دامين,داروسازي‌ امين‌,3,9036,43101720,5020,4770,4770,-250,-4.98,5020,0,0,4770,4770
575,دسبحا,گروه دارويي سبحان,3,16500,290565000,18530,17610,17610,-920,-4.96,18520,-10,-0.05,17610,17610
576,وسرمد,بيمه  سرمد,3,2750,16227750,6211,5901,5901,-310,-4.99,6210,-1,-0.02,5901,5901
577,اراد36,مرابحه عام دولت3-ش.خ 0104,3,2200,2090000000,1000000,950000,950000,-50000,-5,950000,-50000,-5,950000,950000
578,خرينگ,رينگ‌سازي‌مشهد,3,274,13009520,49970,47480,47480,-2490,-4.98,49970,0,0,47480,47480
579,ضترا3004,اختيارخ شتران-10000-1400/03/09,3,20,82000,5,5,4,-1,-20,4,-1,-20,1,5
580,غويتا,ويتانا,3,1035,17649855,17950,17053,17053,-897,-5,17949,-1,-0.01,17053,17053
581,ضصاد8031,اختيارخ وبصادر-1800-1400/08/12,3,90,19500000,1,230,200,199,19900,217,216,21600,200,230
582,سرو2,صندوق س سروسودمند مدبران-سهام,3,300000,300000,58210,1,1,-58209,-100,1,-58209,-100,1,1
583,دلقما,دارويي‌ لقمان‌,3,1750,40775000,24520,23300,23300,-1220,-4.98,24520,0,0,23300,23300
584,شسينا,صنايع‌شيميايي‌سينا,3,241,29681560,129640,123160,123160,-6480,-5,129630,-10,-0.01,123160,123160
585,ضغدر8056,اختيارخ وغدير-8000-1400/08/26,2,20,42200000,1991,2500,1980,-11,-0.55,2110,119,5.98,1980,2500
586,غشان,شيرپاستوريزه‌پگاه‌خراسان‌,2,1590,11018700,7290,6930,6930,-360,-4.94,7290,0,0,6930,6930
587,غپاك,لبنيات‌ پاك‌,2,7474,213009000,30000,28500,28500,-1500,-5,29980,-20,-0.07,28500,28500
588,ضترا3002,اختيارخ شتران-8000-1400/03/09,2,6,4590000,444,900,90,-354,-79.73,765,321,72.3,90,900
589,ضغدر3002,اختيارخ وغدير-8200-1400/03/26,2,40,51000000,1200,1300,1200,0,0,1275,75,6.25,1200,1300
590,ثنظام,س. ساختماني نظام مهندسي ايران,2,240,11041920,47430,46008,46008,-1422,-3,47428,-2,0,46008,46008
591,صگل039,صكوك اجاره گل گهر039-3ماهه20%,2,18000,18000018000,1030000,1000001,1000001,-29999,-2.91,1000001,-29999,-2.91,1000001,1000001
592,غپآذر,شير پگاه آذربايجان شرقي,2,208,10832848,54822,52081,52081,-2741,-5,54820,-2,0,52081,52081
593,اوصتا4,صندوق انديشه ورزان صباتامين -د,2,11770000,220157850000,18690,18705,18705,15,0.08,18705,15,0.08,18705,18705
594,ضترا8055,اختيارخ شتران-5000-1400/08/09,2,7,16100000,2995,2300,2300,-695,-23.21,2300,-695,-23.21,2300,2300
595,فبيرا,بسته‌ بندي‌ ايران‌,2,7699,22658157,3097,2943,2943,-154,-4.97,3097,0,0,2943,2943
596,جهرم,پتروشيمي جهرم,2,8784,15099696,1772,1719,1719,-53,-2.99,1772,0,0,1719,1719
597,غنوش,نوش‌ مازندران‌,2,221,11819080,56290,53480,53480,-2810,-4.99,56290,0,0,53480,53480
598,ولبهمن,شركت بهمن ليزينگ,2,100882,672681176,7018,6668,6668,-350,-4.99,7001,-17,-0.24,6668,6668
599,كمينا,شيشه سازي مينا,2,750,17837250,25034,23783,23783,-1251,-5,25032,-2,-0.01,23783,23783
600,صخود412,ص مرابحه خودرو412- 3ماهه 18%,2,18,17910018,995001,995001,995001,0,0,995001,0,0,995001,995001
601,سخواف,سيمان مجد خواف,2,830,13495800,16762,16260,16260,-502,-2.99,16761,-1,-0.01,16260,16260
602,آ س پ,آ.س.پ,2,1644,25199232,16134,15328,15328,-806,-5,16133,-1,-0.01,15328,15328
603,سنفت001,سلف موازي استاندارد سنفت001,2,68700,80081185500,1154124,1165665,1165665,11541,1,1165665,11541,1,1165665,1165665
604,ثرود,سرمايه‌گذاري مسكن زاينده رود,2,2775,55214175,20944,19897,19897,-1047,-5,20940,-4,-0.02,19897,19897
605,ثالوند,سرمايه گذاري مسكن الوند,2,2170,66475780,32246,30634,30634,-1612,-5,32238,-8,-0.02,30634,30634
606,گواهي ظرفيت,گواهي ظرفيت نقدي,2,1629000,29629881000,18189,18189,18189,0,0,18189,0,0,18189,18189
607,ضخود4000,اختيارخ خودرو-1400-1400/04/02,2,15,6750000,730,500,350,-380,-52.05,450,-280,-38.36,350,500
608,چكاوه,صنايع‌كاغذسازي‌كاوه‌,2,20550,358803000,18370,17460,17460,-910,-4.95,18350,-20,-0.11,17460,17460
609,كپرور,فرآوري زغال سنگ پروده طبس,2,660,20911440,33351,31684,31684,-1667,-5,33349,-2,-0.01,31684,31684
610,وسالت,بانك قرض الحسنه رسالت,2,14074,16086582,1110,1143,1143,33,2.97,1110,0,0,1143,1143
611,وآوا,سرمايه گذاري آوا نوين,2,1383,11666988,8880,8436,8436,-444,-5,8880,0,0,8436,8436
612,حتوكا,حمل‌ونقل‌توكا,2,5000,101700000,21410,20340,20340,-1070,-5,21400,-10,-0.05,20340,20340
613,ضمخا7075,اختيارخ اخابر-9000-1400/07/28,2,3,1680000,511,560,560,49,9.59,560,49,9.59,560,560
614,كاردان2,صندوق س تجارت شاخصي كاردان,2,200000,200000,139890,1,1,-139889,-100,1,-139889,-100,1,1
615,زشگزا,شير و گوشت زاگرس شهركرد,2,1548,12058920,8200,7790,7790,-410,-5,8200,0,0,7790,7790
616,داوه,داروسازي آوه سينا,2,2617,50152188,20172,19164,19164,-1008,-5,20168,-4,-0.02,19164,19164
617,هجرت,پخش هجرت,2,1328,35400496,28060,26657,26657,-1403,-5,28057,-3,-0.01,26657,26657
618,زفكا,كشت و دامداري فكا,2,4260,50796240,12551,11924,11924,-627,-5,12549,-2,-0.02,11924,11924
619,زمگسا,كشاورزي‌ ودامپروي‌ مگسال‌,2,565,17441550,32490,30870,30870,-1620,-4.99,32490,0,0,30870,30870
620,كلر,كلر پارس,2,82,10056808,129098,122644,122644,-6454,-5,129094,-4,0,122644,122644
621,غديس,پاكديس,2,2900,36980800,13423,12752,12752,-671,-5,13421,-2,-0.01,12752,12752
622,ضمخا7077,اختيارخ اخابر-7000-1400/07/28,2,13,12220000,1112,940,940,-172,-15.47,940,-172,-15.47,940,940
623,قهكمت,قندهكمتان‌,2,231,10106250,46050,43750,43750,-2300,-4.99,46050,0,0,43750,43750
624,ضترا3000,اختيارخ شتران-6000-1400/03/09,2,30,30000000,2486,1000,1000,-1486,-59.77,1000,-1486,-59.77,1000,1000
625,زگلدشت,كشت و دام گلدشت نمونه اصفهان,2,1500,19632000,13776,13088,13088,-688,-4.99,13775,-1,-0.01,13088,13088
626,ضترا3003,اختيارخ شتران-9000-1400/03/09,2,26,2060000,100,100,10,-90,-90,79,-21,-21,10,100
627,خشرق,الكتريك‌ خودرو شرق‌,2,2415,33182100,14460,13740,13740,-720,-4.98,14460,0,0,13740,13740
628,سكرد,سيمان كردستان,2,1600,14896000,9790,9310,9310,-480,-4.9,9790,0,0,9310,9310
629,ضپيك7039,اختيارخ تاپيكو-7000-00/07/18,2,25,84000000,3500,3400,3200,-300,-8.57,3360,-140,-4,3200,3400
630,آوا2,صندوق س.سهام آواي معيار-س,2,1500000,1500000,6503,1,1,-6502,-99.98,1,-6502,-99.98,1,1
631,ثباغ,شهر سازي و خانه سازي باغميشه,2,1117,13811705,13015,12365,12365,-650,-4.99,13014,-1,-0.01,12365,12365
632,لخانه,لوازم‌ خانگي‌ پارس‌,2,1500,39016500,27380,26011,26011,-1369,-5,27374,-6,-0.02,26011,26011
633,پلاسك,پلاسكوكار,2,1445,10057200,7320,6960,6960,-360,-4.92,7320,0,0,6960,6960
634,غشاذر,پگاه‌آذربايجان‌غربي‌,2,2482,23256340,9860,9370,9370,-490,-4.97,9860,0,0,9370,9370
635,ثاباد,توريستي ورفاهي آبادگران ايران,2,10100,519140000,54100,51400,51400,-2700,-4.99,54000,-100,-0.18,51400,51400
636,ضمخا7066,اختيارخ اخابر-12000-1400/07/28,2,15,8985000,391,599,599,208,53.2,599,208,53.2,599,599
637,كگاز,شيشه‌ و گاز,2,587,10284240,18440,17520,17520,-920,-4.99,18440,0,0,17520,17520
638,زقيام,كشت و دام قيام اصفهان,2,792,21601800,28710,27275,27275,-1435,-5,28708,-2,-0.01,27275,27275
639,كمند2,صندوق س. با درآمد ثابت كمند,2,60000000,60000000,10094,1,1,-10093,-99.99,1,-10093,-99.99,1,1
640,بكاب,صنايع‌جوشكاب‌يزد,2,55,18799550,359790,341810,341810,-17980,-5,359770,-20,-0.01,341810,341810
641,سميعا002,سلف موازي استاندارد سميعا002,2,382500,500110717500,1306913,1307479,1307479,566,0.04,1307479,566,0.04,1307479,1307479
642,ضفار3000,اختيارخ فارس-8000-1400/03/05,1,1,300000,1656,300,300,-1356,-81.88,300,-1356,-81.88,300,300
643,ضپنا8002,اختيارخ رمپنا-14000-1400/08/05,1,5,8000000,1100,1600,1600,500,45.45,1600,500,45.45,1600,1600
644,غصينو,صنعتي مينو,1,93,5917404,66976,63628,63628,-3348,-5,66976,0,0,63628,63628
645,وصندوق2,سرمايه‌گذاري‌صندوق‌بازنشستگي‌,1,30000000,410700000000,13690,13690,13690,0,0,13690,0,0,13690,13690
646,تكشا,گسترش‌صنايع‌وخدمات‌كشاورزي‌,1,150,5868000,41170,39120,39120,-2050,-4.98,41170,0,0,39120,39120
647,ثنور,سرمايه گذاري كوه نور,1,725,6710600,9542,9256,9256,-286,-3,9542,0,0,9256,9256
648,گپارس,امور رفاهي كارگزاران پارس,1,27,5350806,208608,198178,198178,-10430,-5,208602,-6,0,198178,198178
649,شپارس,بين‌ المللي‌ محصولات‌  پارس‌,1,285,5999250,22150,21050,21050,-1100,-4.97,22150,0,0,21050,21050
650,وهنر,گروه توسعه هنر ايران,1,80000,630240000,8121,7878,7878,-243,-2.99,8105,-16,-0.2,7878,7878
651,خموتور,موتورسازان‌تراكتورسازي‌ايران‌,1,355,5037450,14930,14190,14190,-740,-4.96,14930,0,0,14190,14190
652,دفارا,داروسازي‌ فارابي‌,1,100,5699000,59980,56990,56990,-2990,-4.98,59980,0,0,56990,56990
653,صفارس1472,صكوك اجاره فارس147- 3ماهه18%,1,1349900,1349900000000,1044733,1000000,1000000,-44733,-4.28,1000000,-44733,-4.28,1000000,1000000
654,شستا0042,اجاره تامين اجتماعي-نوين000523,1,148600,148035320000,992000,996200,996200,4200,0.42,996200,4200,0.42,996200,996200
655,خفناور,مهندسي صنعتي روان فن آور,1,500,23452500,48355,46905,46905,-1450,-3,48351,-4,-0.01,46905,46905
656,شتولي,تولي‌پرس‌,1,300,10523400,35793,35078,35078,-715,-2,35791,-2,-0.01,35078,35078
657,دتوزيع,توزيع دارو پخش,1,200,9059000,47678,45295,45295,-2383,-5,47677,-1,0,45295,45295
658,كتوكا,توليدي و خدمات صنايع نسوز توكا,1,155,5049745,34293,32579,32579,-1714,-5,34292,-1,0,32579,32579
659,وسيزد,شركت س استان يزد,1,18060,21960960,1280,1216,1216,-64,-5,1280,0,0,1216,1216
660,وسكرمان,س.سهام عدالت استان كرمان,1,7700,7538300,1030,979,979,-51,-4.95,1030,0,0,979,979
661,دقاضي,داروسازي شهيد قاضي,1,121,5075345,43242,41945,41945,-1297,-3,43242,0,0,41945,41945
662,فنرژي,گسترش صنايع انرژي آذرآب,1,277,5040569,18568,18197,18197,-371,-2,18568,0,0,18197,18197
663,سدبير,س. تدبيرگران فارس وخوزستان,1,64,5271424,86701,82366,82366,-4335,-5,86699,-2,0,82366,82366
664,غگلستا,شير پاستوريزه پگاه گلستان,1,721,19529727,28512,27087,27087,-1425,-5,28510,-2,-0.01,27087,27087
665,وملت,سرمايه گذاري ملت,1,1200,5032800,4368,4194,4194,-174,-3.98,4368,0,0,4194,4194
666,ضبدر8076,اختيارخ شبندر-20000-1400/08/30,1,15,52500000,1,3500,3500,3499,349900,3500,3499,349900,3500,3500
667,تابان03,اجاره تابان سپهر14021206,1,2000,1860000000,933300,930000,930000,-3300,-0.35,930000,-3300,-0.35,930000,930000
668,افاد72,منفعت دولت7-ش.خاص سپهر0204,1,5000,4301695000,819371,860339,860339,40968,5,860339,40968,5,860339,860339
669,نبروج,نساجي بروجرد,1,792,4790016,5816,6048,6048,232,3.99,5816,0,0,6048,6048
670,دمعيار2,صندوق س. توازن معيار-د,1,2200000,2200000,10005,1,1,-10004,-99.99,1,-10004,-99.99,1,1
671,مصفها203,مشاركت ش اصفهان203-3ماهه18%,1,300,295800000,973000,986000,986000,13000,1.34,986000,13000,1.34,986000,986000
672,شرق1400,مشاركت ليزينگ ايران وشرق140010,1,5,5040000,1008000,1008000,1008000,0,0,1008000,0,0,1008000,1008000
673,ولراز,ليزينگ رازي,1,95,5166670,56068,54386,54386,-1682,-3,56067,-1,0,54386,54386
674,شپديس2,پتروشيمي پرديس,1,350000,31850000000,93100,91000,91000,-2100,-2.26,91000,-2100,-2.26,91000,91000
675,وسصفا,شركت س استان اصفهان,1,5200,5288400,1070,1017,1017,-53,-4.95,1070,0,0,1017,1017
676,وپسا,س. پتروشيمي ساختمان  خليج فارس,1,3394,9998724,3006,2946,2946,-60,-2,3006,0,0,2946,2946
677,ضفار8051,اختيارخ فارس-9000-1400/08/05,1,15,22500000,1027,1500,1500,473,46.06,1500,473,46.06,1500,1500
678,تابان032,اجاره تابان سپهر14021206,1,344006,321645610000,933300,935000,935000,1700,0.18,935000,1700,0.18,935000,935000
679,غدشت,دشت‌ مرغاب‌,1,23,5982070,273770,260090,260090,-13680,-5,273760,-10,0,260090,260090
680,وسگلستا,شركت س استان گلستان,1,12739,15006542,1240,1178,1178,-62,-5,1240,0,0,1178,1178
681,وآذر,سرمايه‌گذاري‌توسعه‌آذربايجان‌,1,2000,156140000,82170,78070,78070,-4100,-4.99,82130,-40,-0.05,78070,78070
682,اخزا722,اسنادخزانه-م22بودجه97-000428,1,514,499402400,971478,971600,971600,122,0.01,971600,122,0.01,971600,971600
683,وسخوز,شركت س استان خوزستان,1,24853,22914466,970,922,922,-48,-4.95,970,0,0,922,922
684,تملي809,تسهيلات مسكن ب. ملي-آذر98,1,37,19486716,501589,526668,526668,25079,5,526668,25079,5,526668,526668
685,غمهرا,توليدي‌مهرام‌,1,105,12159000,121890,115800,115800,-6090,-5,121880,-10,-0.01,115800,115800
686,ومعلم,بيمه معلم,1,2000,9442000,4969,4721,4721,-248,-4.99,4969,0,0,4721,4721
687,ثشرق,سرمايه گذاري مسكن شمال شرق,1,1527,10001850,6890,6550,6550,-340,-4.93,6890,0,0,6550,6550
688,شستا004,اجاره تامين اجتماعي-نوين000523,1,2000,1988000000,992000,994000,994000,2000,0.2,994000,2000,0.2,994000,994000
689,داراب,پتروشيمي داراب,1,2073,4929594,2451,2378,2378,-73,-2.98,2451,0,0,2378,2378
690,ركيش,كارت اعتباري ايران كيش,1,225,5071500,23720,22540,22540,-1180,-4.97,23720,0,0,22540,22540
691,ضغدر8055,اختيارخ وغدير-7000-1400/08/26,1,16,44800000,2937,2800,2800,-137,-4.66,2800,-137,-4.66,2800,2800
692,سيستم4,همكاران سيستم,1,17824762,369150821020,21010,20710,20710,-300,-1.43,20710,-300,-1.43,20710,20710
693,كيميا,معدني كيمياي زنجان گستران,1,313,5219275,17552,16675,16675,-877,-5,17552,0,0,16675,16675
694,ضخود7078,اختيارخ خودرو-3500-1400/07/07,1,100,1100000,9,11,11,2,22.22,11,2,22.22,11,11
695,كاريس4,صندوق س.سپهر كاريزما-س,1,5000000,52500000000,10281,10500,10500,219,2.13,10500,219,2.13,10500,10500
696,كوثر,بيمه كوثر,1,388,5380396,14596,13867,13867,-729,-4.99,14596,0,0,13867,13867
697,بنيرو,نيروترانس‌,1,400,5700000,14990,14250,14250,-740,-4.94,14990,0,0,14250,14250
698,كسرام,پارس‌ سرام‌,1,3500,27335000,8220,7810,7810,-410,-4.99,8220,0,0,7810,7810
699,ختراك,ريخته‌گري‌ تراكتورسازي‌ ايران‌,1,33000,457380000,14580,13860,13860,-720,-4.94,14560,-20,-0.14,13860,13860
700,ولغدر,ليزينگ‌خودروغدير,1,250,5782500,24340,23130,23130,-1210,-4.97,24340,0,0,23130,23130
701,غالبر,لبنيات‌ كالبر,1,1750,32830000,19740,18760,18760,-980,-4.96,19740,0,0,18760,18760
702,ضپيك7042,اختيارخ تاپيكو-10000-00/07/18,1,20,26000000,1500,1300,1300,-200,-13.33,1300,-200,-13.33,1300,1300
703,ثعمرا,عمران و توسعه شاهد,1,1050,13011600,13044,12392,12392,-652,-5,13043,-1,-0.01,12392,12392
704,خلنت,لنت‌ ترمزايران‌,1,110,6408600,61320,58260,58260,-3060,-4.99,61320,0,0,58260,58260
705,ضترا8058,اختيارخ شتران-8000-1400/08/09,1,3,2130000,802,710,710,-92,-11.47,710,-92,-11.47,710,710
706,خساپا4,سايپا,1,402000000,634758000000,1653,1579,1579,-74,-4.48,1579,-74,-4.48,1579,1579
707,اراد364,مرابحه عام دولت3-ش.خ 0104,1,700000,661500000000,1000000,945000,945000,-55000,-5.5,945000,-55000,-5.5,945000,945000
708,آينده,بازرگاني آينده سازان بهشت پارس,1,268,5053676,19849,18857,18857,-992,-5,19848,-1,-0.01,18857,18857
709,افاد4,منفعت دولتي4-شرايط خاص14010729,1,1000,1127138000,1073465,1127138,1127138,53673,5,1127138,53673,5,1127138,1127138
710,اخزا713,اسنادخزانه-م13بودجه97-000518,1,50,48050000,964651,961000,961000,-3651,-0.38,961000,-3651,-0.38,961000,961000
711,وسقم,شركت س استان قم,1,7200,9648000,1410,1340,1340,-70,-4.96,1410,0,0,1340,1340
712,تپكو,توليدتجهيزات‌سنگين‌هپكو,1,1000,5300000,5408,5300,5300,-108,-2,5408,0,0,5300,5300
713,غشوكو,شوكو پارس,1,184,5078216,28452,27599,27599,-853,-3,28452,0,0,27599,27599
714,تبرك,گروه كارخانجات صنعتي تبرك,1,380,7138300,19773,18785,18785,-988,-5,19773,0,0,18785,18785
715,افرا,افرانت,1,157,5108309,34249,32537,32537,-1712,-5,34248,-1,0,32537,32537
716,ضسپا8042,اختيارخ خساپا-1800-1400/08/26,1,1,69000,250,69,69,-181,-72.4,69,-181,-72.4,69,69
717,ثتوسا,س.توسعه و عمران استان اردبيل,1,500,18850500,38867,37701,37701,-1166,-3,38865,-2,-0.01,37701,37701
718,صفارس307,صكوك اجاره فارس307- 3ماهه18%,1,300,298410000,980700,994700,994700,14000,1.43,994700,14000,1.43,994700,994700
719,اكالا,كارگزاران بورس كالاي ايران,1,100000,2954000000,31090,29540,29540,-1550,-4.99,30930,-160,-0.51,29540,29540
720,تاپكيش,تجارت الكترونيك پارسيان كيش,1,446,7701528,18176,17268,17268,-908,-5,18176,0,0,17268,17268
721,اراد354,مرابحه عام دولت3-ش.خ 0103,1,1050000,995400000000,950000,948000,948000,-2000,-0.21,948000,-2000,-0.21,948000,948000
722,اراد504,مرابحه عام دولت5-ش.خ0302,1,850000,850000000000,1000001,1000000,1000000,-1,0,1000000,-1,0,1000000,1000000
723,تپمپي,پمپ‌ سازي‌ ايران‌,1,1000,18020000,18960,18020,18020,-940,-4.96,18960,0,0,18020,18020
724,لكما,كارخانجات‌مخابراتي‌ايران‌,1,2000,11822000,6093,5911,5911,-182,-2.99,6093,0,0,5911,5911
725,سمگا,گروه سرمايه گذاري ميراث فرهنگي,1,185,5023305,28582,27153,27153,-1429,-5,28582,0,0,27153,27153
726,گكيش,توريستي ورفاهي آبادگران كيش,1,1000,46886000,48336,46886,46886,-1450,-3,48329,-7,-0.01,46886,46886
727,شگل,گلتاش‌,1,9500,90820000,10060,9560,9560,-500,-4.97,10060,0,0,9560,9560
728,سپيدما4,صندوق س. سپيد دماوند-د,1,124000000,1286376000000,10366,10374,10374,8,0.08,10374,8,0.08,10374,10374
729,نيرو,نيرو سرمايه,1,370,19333980,53870,52254,52254,-1616,-3,53867,-3,-0.01,52254,52254
730,ضپاس7027,اختيارخ وپارس-1800-1400/07/28,1,3,2742000,900,914,914,14,1.56,914,14,1.56,914,914
731,تبريز112,مشاركت شهرداري تبريز-3ماهه18%,1,5624,5342800000,970000,950000,950000,-20000,-2.06,950000,-20000,-2.06,950000,950000
732,شدوص,دوده‌ صنعتي‌ پارس‌,1,8000,163440000,21500,20430,20430,-1070,-4.98,21490,-10,-0.05,20430,20430
733,اراد50,مرابحه عام دولت5-ش.خ0302,1,4500,4500000000,1000001,1000000,1000000,-1,0,1000000,-1,0,1000000,1000000
734,اعتلا,شركت سرمايه گذاري اعتلاء البرز,1,10000,68350000,7194,6835,6835,-359,-4.99,7192,-2,-0.03,6835,6835
735,قشكر,شكرشاهرود,1,1500,5320500,3733,3547,3547,-186,-4.98,3733,0,0,3547,3547
736,شپاس,نفت پاسارگاد,1,260,5065840,20509,19484,19484,-1025,-5,20509,0,0,19484,19484
737,ساربيل,سيمان آرتا اردبيل,1,1000,50790000,53460,50790,50790,-2670,-4.99,53450,-10,-0.02,50790,50790
738,ضفار3001,اختيارخ فارس-9000-1400/03/05,1,50,1000000,1336,20,20,-1316,-98.5,20,-1316,-98.5,20,20
739,دجابر,داروسازي‌ جابرابن‌حيان‌,1,293,5464450,19630,18650,18650,-980,-4.99,19630,0,0,18650,18650
740,خزر,فنرسازي‌زر,1,1500,64215000,45060,42810,42810,-2250,-4.99,45050,-10,-0.02,42810,42810
741,ثنوسا,نوسازي‌وساختمان‌تهران‌,1,500,6045000,12720,12090,12090,-630,-4.95,12720,0,0,12090,12090
742,سنفت009,سلف موازي استاندارد سنفت009,1,20300,31172680000,1532850,1535600,1535600,2750,0.18,1535600,2750,0.18,1535600,1535600
743,حرهشا,رهشاد سپاهان (سهامي عام,1,80,5021280,64046,62766,62766,-1280,-2,64045,-1,0,62766,62766
744,ضفار3009,اختيارخ فارس-6000-1400/03/05,1,1,1000000,3600,1000,1000,-2600,-72.22,1000,-2600,-72.22,1000,1000
745,سهرمز,سيمان‌هرمزگان‌,1,215,5065400,24800,23560,23560,-1240,-5,24800,0,0,23560,23560
746,كسعدي,كاشي‌ سعدي‌,1,1000,20260000,21320,20260,20260,-1060,-4.97,21320,0,0,20260,20260
