,نماد,نام,تعداد,حجم,ارزش,دیروز,اولین,آخرین معامله - مقدار,آخرین معامله - تغییر,آخرین معامله - درصد,قیمت پایانی - مقدار,قیمت پایانی - تغییر,قیمت پایانی - درصد,کمترین,بیشترین
2,پالايش,صندوق پالايشي يکم-سهام,21089,18342742,1233046499510,69470,67700,66700,-2770,-3.99,67220,-2250,-3.24,66700,68400
3,اپال,فرآوري معدني اپال كاني پارس,16979,11029600,189875755980,17190,17190,17240,50,0.29,17220,30,0.17,17160,17280
4,وپاسار,بانك  پاسارگاد,11693,159531359,2614828826000,16630,16140,16700,70,0.42,16390,-240,-1.44,16140,16700
5,وسپهر,سرمايه گذاري مالي سپهرصادرات,11411,39225211,392682550693,10100,9900,10100,0,0,10011,-89,-0.88,9797,10102
6,دارا يكم,صندوق واسطه گري مالي يكم-سهام,10431,8295889,1093326947150,136180,133200,130740,-5440,-3.99,131790,-4390,-3.22,130740,133210
7,شستا,سرمايه گذاري تامين اجتماعي,10427,60932105,625932732450,10580,10270,10280,-300,-2.84,10270,-310,-2.93,10270,10450
8,وتجارت,بانك تجارت,7896,377086766,918286583645,2471,2450,2397,-74,-2.99,2435,-36,-1.46,2397,2465
9,فملي,ملي‌ صنايع‌ مس‌ ايران‌,7769,52157983,617901124880,12180,11920,11820,-360,-2.96,11850,-330,-2.71,11820,11980
10,وبصادر,بانك صادرات ايران,6840,455736043,1009654997285,2231,2218,2215,-16,-0.72,2215,-16,-0.72,2215,2240
11,امينح,ح . تامين سرمايه امين,6149,4230798,19997389086,4706,4600,4640,-66,-1.4,4727,21,0.45,4600,4880
12,كمند,صندوق س. با درآمد ثابت كمند,6048,241375869,2419196375005,10017,10025,10022,5,0.05,10023,6,0.06,10022,10025
13,فولاد,فولاد مباركه اصفهان,5735,59627396,690754738960,11930,11650,11580,-350,-2.93,11580,-350,-2.93,11580,11750
14,بوعلي,پتروشيمي بوعلي سينا,5495,5190488,220109438900,42810,41650,41690,-1120,-2.62,42410,-400,-0.93,41530,43730
15,رانفور,خدمات‌انفورماتيك‌,5122,93563272,582061707440,6300,6120,6490,190,3.02,6220,-80,-1.27,6120,6580
16,ذوب,سهامي ذوب آهن  اصفهان,5112,124137087,371901369176,3086,3000,2994,-92,-2.98,2996,-90,-2.92,2994,3057
17,پترول,گروه پتروشيمي س. ايرانيان,4778,32508443,252074756700,7930,7760,7710,-220,-2.77,7750,-180,-2.27,7700,8000
18,دماوند,توليد نيروي برق دماوند,4548,7779426,231516473689,29018,29550,29820,802,2.76,29760,742,2.56,29018,29999
19,سيتا,سرمايه گذاري سيمان تامين,4060,9984281,149767157010,15000,15000,15000,0,0,15000,0,0,15000,15010
20,وكبهمن,مديريت سرمايه گذاري كوثربهمن,4046,1681027,16703355509,10118,10118,10004,-114,-1.13,10055,-63,-0.62,9851,10118
21,وپارس,بانك‌پارسيان‌,3535,161039086,384515263718,2388,2380,2393,5,0.21,2388,0,0,2330,2400
22,امين,تامين سرمايه امين,3420,2851474,19934269400,6990,6990,7000,10,0.14,6990,0,0,6990,7000
23,آريا,پليمر آريا ساسول,3348,1057400,89446730222,85922,84000,85014,-908,-1.06,84704,-1218,-1.42,84000,85499
24,هخود108,اختيارف ت خودرو-2850-01/08/03,3300,330000000,94380000000,1,286,286,285,28500,286,285,28500,286,286
25,ساراب,سيمان‌ داراب‌,3168,17713893,409164878110,22520,23870,21850,-670,-2.98,23100,580,2.58,21850,23870
26,بگيلان,توسعه مسير برق گيلان,3061,966300,19182854309,20064,19551,19501,-563,-2.81,19981,-83,-0.41,19463,20290
27,وغدير,سرمايه‌گذاري‌غدير(هلدينگ‌,2710,36269023,337282326990,9560,9320,9290,-270,-2.82,9300,-260,-2.72,9280,9550
28,شگويا,پتروشيمي تندگويان,2603,18168910,147944649525,8391,8171,8140,-251,-2.99,8143,-248,-2.96,8140,8200
29,امين يكم,صندوق درآمد ثابت امين يكم فردا,2341,69528914,703099686060,10107,10112,10114,7,0.07,10112,5,0.05,10108,10116
30,كيان,صندوق س. با درآمد ثابت كيان,2113,105386214,2987624866164,28336,28350,28353,17,0.06,28349,13,0.05,28344,28355
31,ولانا,شركت ليزينگ آريا دانا,2074,3162954,123827394911,39664,38100,38078,-1586,-4,39149,-515,-1.3,38078,40800
32,دعبيد,لابراتوارداروسازي‌  دكترعبيدي‌,1993,4794814,121578513340,25910,25140,25150,-760,-2.93,25360,-550,-2.12,25140,26470
33,تسه0001,امتيازتسهيلات مسكن فروردين1400,1744,36885,20197517101,540112,546001,531000,-9112,-1.69,547581,7469,1.38,530000,555000
34,نوري,پتروشيمي نوري,1702,3108244,169538161470,56180,55020,54500,-1680,-2.99,54540,-1640,-2.92,54500,55580
35,وخارزمح,ح.سرمايه گذاري خوارزمي,1628,7996987,21505348936,2837,2740,2667,-170,-5.99,2689,-148,-5.22,2667,2777
36,هفملي108,اختيارف ت فملي-16070-01/08/08,1601,160000000,71360000000,781,446,446,-335,-42.89,446,-335,-42.89,446,446
37,غگل,گلوكوزان‌,1588,40035080,108298504884,2788,2705,2706,-82,-2.94,2705,-83,-2.98,2705,2716
38,سمازن,سيمان‌مازندران‌,1565,5751640,70727503620,12280,12060,12070,-210,-1.71,12300,20,0.16,11950,12690
39,هساپا108,اختيارف ت سايپا-2750-01/08/16,1550,155000000,43710000000,1,282,282,281,28100,282,281,28100,282,282
40,وساپا,سرمايه‌گذاري‌ سايپا,1542,47278104,202642639331,4418,4286,4286,-132,-2.99,4286,-132,-2.99,4286,4330
41,شتران,پالايش نفت تهران,1468,21270161,163142134870,7900,7670,7670,-230,-2.91,7670,-230,-2.91,7670,7670
42,بپيوند,برق و انرژي پيوندگستر پارس,1465,1177769,12632752542,11057,10726,10726,-331,-2.99,10970,-87,-0.79,10726,10730
43,ومعادنح,ح . توسعه‌معادن‌وفلزات‌,1455,11129406,51963893390,4860,4760,4670,-190,-3.91,4670,-190,-3.91,4640,4760
44,هفولا108,اختيارف ت فولاد-11912-01/08/07,1450,145000000,170085000000,1127,1173,1173,46,4.08,1173,46,4.08,1173,1173
45,اعتماد,صندوق س.اعتماد آفرين پارسيان-د,1434,21303160,773750127920,36305,36319,36323,18,0.05,36321,16,0.04,36319,36323
46,فخوز,فولاد  خوزستان,1389,12104818,170498351870,14500,14110,14070,-430,-2.97,14090,-410,-2.83,14070,14330
47,واحيا,م .صنايع و معادن احياء سپاهان,1333,1718534,240532615116,137427,141549,138120,693,0.5,139964,2537,1.85,137265,141549
48,ومعادن,توسعه‌معادن‌وفلزات‌,1311,21083747,146427967760,7150,6960,6950,-200,-2.8,6950,-200,-2.8,6940,6990
49,هتران108,اختيارف ت شتران-12000-01/08/11,1300,130000000,192010000000,1273,1477,1477,204,16.03,1477,204,16.03,1477,1477
50,فارس,صنايع پتروشيمي خليج فارس,1270,16225164,132705354120,8420,8180,8170,-250,-2.97,8180,-240,-2.85,8170,8420
51,خودرو,ايران‌ خودرو,1243,61487751,116457800394,1952,1894,1894,-58,-2.97,1894,-58,-2.97,1894,1894
52,شپنا,پالايش نفت اصفهان,1210,21029231,203983540700,10000,9700,9700,-300,-3,9700,-300,-3,9700,9700
53,تاپيكو,س. نفت و گاز و پتروشيمي تأمين,1205,17073031,166535725700,10050,9770,9750,-300,-2.99,9750,-300,-2.99,9750,9930
54,پارند,صندوق س. پارند پايدار سپهر,1150,29522186,330512932459,11188,11195,11196,8,0.07,11195,7,0.06,11193,11197
55,فنوال,نورد آلومينيوم‌,1133,1586261,42888969350,26570,26500,26620,50,0.19,26960,390,1.47,26500,27500
56,سفارس,سيمان فارس و خوزستان,1101,6252351,87646024330,14420,13990,14000,-420,-2.91,14020,-400,-2.77,13990,14400
57,البرز,بيمه البرز,1069,18002197,60396961050,3423,3355,3351,-72,-2.1,3355,-68,-1.99,3321,3449
58,تسه9912,امتياز تسهيلات مسكن اسفند99,1045,24698,13664968952,552806,550000,527004,-25802,-4.67,553282,476,0.09,526117,560000
59,سرو,صندوق س سروسودمند مدبران-سهام,1024,1496503,89373583720,60650,60000,59540,-1110,-1.83,59720,-930,-1.53,59500,60600
60,بپاس,بيمه پاسارگاد,968,776222,66957954008,88180,85551,86241,-1939,-2.2,86867,-1313,-1.49,85551,88000
61,كچاد,معدني‌وصنعتي‌چادرملو,936,5152666,103310968990,20630,20130,20030,-600,-2.91,20120,-510,-2.47,20020,20330
62,آگاس,صندوق س.هستي بخش آگاه-س,872,1038060,63458579420,62279,61725,60890,-1389,-2.23,61132,-1147,-1.84,60800,61725
63,صبا,سرمايه گذاري صبا تامين,871,7495250,54006339662,7427,7210,7205,-222,-2.99,7323,-104,-1.4,7205,7281
64,آوا,صندوق س.سهام آواي معيار-س,841,18601851,117190744794,6319,6301,6300,-19,-0.3,6300,-19,-0.3,6280,6328
65,بجهرم,توسعه مولد نيروگاهي جهرم,830,15315171,32281621696,2172,2107,2107,-65,-2.99,2128,-44,-2.03,2107,2148
66,وصنعت,سرمايه گذاري توسعه صنعت وتجارت,818,6697943,36913255370,5660,5560,5500,-160,-2.83,5550,-110,-1.94,5500,5570
67,هتجار108,اختيارف ت تجارت-3600-01/08/17,802,750000000,255000000000,1000,340,340,-660,-66,340,-660,-66,340,340
68,فباهنرح,ح . مس‌ شهيدباهنر,784,2183681,34667736560,16760,16350,15760,-1000,-5.97,15880,-880,-5.25,15760,16540
69,كيان2,صندوق س. با درآمد ثابت كيان,770,77000000,77000000,28336,1,1,-28335,-100,1,-28335,-100,1,1
70,ونوين,بانك‌اقتصادنوين‌,763,27416242,116027136435,4362,4232,4232,-130,-2.98,4232,-130,-2.98,4232,4294
71,ما,بيمه  ما,754,6697862,49421065420,7330,7490,7500,170,2.32,7380,50,0.68,7120,7600
72,فايرا,آلومينيوم‌ايران‌,752,4111863,72681591340,18200,17770,17660,-540,-2.97,17680,-520,-2.86,17660,18000
73,تماوند,تامين سرمايه دماوند,731,14077745,77811359562,5625,5513,5513,-112,-1.99,5527,-98,-1.74,5513,5792
74,ومهان,گروه توسعه مالي مهر آيندگان,674,2304304,27331425521,12187,12000,11822,-365,-2.99,12002,-185,-1.52,11822,12170
75,وسكاب,س.ص.بازنشستگي كاركنان بانكها,665,5139791,24018957604,4761,4669,4750,-11,-0.23,4718,-43,-0.9,4619,4800
76,طلا,صندوق س.پشتوانه طلاي لوتوس,657,615197,41999217057,67278,68700,68551,1273,1.89,68270,992,1.47,67850,68720
77,كگل,معدني و صنعتي گل گهر,647,4977574,64861796120,13360,13430,12970,-390,-2.92,13180,-180,-1.35,12960,13430
78,شسپا,نفت سپاهان,643,2839772,39687406010,13950,13600,13760,-190,-1.36,13970,20,0.14,13550,14470
79,كهمداح,ح . شيشه‌ همدان‌,617,15006857,115552798900,7700,7700,7700,0,0,7700,0,0,7700,7700
80,دالبرح,ح . البرزدارو,616,782002,6454344230,8490,8250,8280,-210,-2.47,8250,-240,-2.83,8230,8300
81,مدير,ص.س.مديريت ثروت ص.بازنشستگي-س,607,2314847,17402499490,7667,7690,7480,-187,-2.44,7518,-149,-1.94,7450,7690
82,افران,صندوق س افرا نماد پايدار-ثابت,604,5688753,75577144544,13274,13280,13282,8,0.06,13285,11,0.08,13280,13299
83,كگلح,ح . معدني و صنعتي گل گهر,603,2631681,25717647350,9940,9790,9780,-160,-1.61,9770,-170,-1.71,9700,10000
84,فاسمين,كالسيمين‌,584,3696165,49575468640,13790,13500,13380,-410,-2.97,13410,-380,-2.76,13380,13600
85,شصدف,صنعتي دوده فام,576,21729,716557233,31111,32977,32977,1866,6,31136,25,0.08,32977,32977
86,تصميم,صندوق س با درآمد ثابت تصميم,575,8585813,139797343188,16283,16316,16270,-13,-0.08,16282,-1,-0.01,16258,16316
87,زاگرس,پتروشيمي زاگرس,567,242747,47127477643,196739,195000,192900,-3839,-1.95,195496,-1243,-0.63,192871,199960
88,سپيدما,صندوق س. سپيد دماوند-د,553,51117172,525585940358,10276,10281,10282,6,0.06,10282,6,0.06,10281,10285
89,كاوه,فولاد كاوه جنوب كيش,544,3566646,68011125990,19620,19040,19040,-580,-2.96,19230,-390,-1.99,19040,19300
90,شساخت,مهندسي و ساختمان صنايع نفت,530,1158775,48006407196,40252,41400,41459,1207,3,41429,1177,2.92,40010,41459
91,ورازي,بيمه رازي,529,6737085,53494818371,8341,7931,7924,-417,-5,7940,-401,-4.81,7924,8250
92,ميدكو,هلدينگ صنايع  معدني خاورميانه,498,1358715,44163809657,33068,33100,32550,-518,-1.57,32857,-211,-0.64,32076,33200
93,فردا,صندوق س آواي فرداي زاگرس-ثابت,490,20442851,217777137776,10647,10654,10653,6,0.06,10653,6,0.06,10652,10654
94,پيزد,مجتمع صنايع لاستيك يزد,486,113201,6770009586,61654,59805,59805,-1849,-3,61395,-259,-0.42,59805,59850
95,خساپا,سايپا,483,7379921,13357657010,1865,1810,1810,-55,-2.95,1859,-6,-0.32,1810,1810
96,سپ,پرداخت الكترونيك سامان كيش,480,1204713,26267550760,21450,21600,21500,50,0.23,21630,180,0.84,21380,22100
97,افق,فروشگاههاي زنجيره اي افق كوروش,479,405845,26923896780,68370,66940,66320,-2050,-3,67680,-690,-1.01,66320,67450
98,ضخود7075,اختيارخ خودرو-2000-1400/07/07,476,22270,3635385000,215,186,159,-56,-26.05,163,-52,-24.19,157,190
99,سمتاز,سيمان ممتازان كرمان,476,572160,13607123890,23141,23835,23835,694,3,23562,421,1.82,23640,23835
100,شپديس,پتروشيمي پرديس,470,570731,51143750070,90950,90000,89000,-1950,-2.14,90250,-700,-0.77,89000,91430
101,پارسان,گسترش نفت و گاز پارسيان,466,6116374,104559125010,17610,17250,17090,-520,-2.95,17150,-460,-2.61,17090,17270
102,ضسپا3004,اختيارخ خساپا-2500-1400/03/26,463,23647,173728000,12,7,6,-6,-50,7,-5,-41.67,5,11
103,وتوس,توسعه‌شهري‌توس‌گستر,462,2549715,34219560320,13830,13420,13460,-370,-2.68,13540,-290,-2.1,13420,13750
104,وبانك,سرمايه گذاري گروه توسعه ملي,460,2275884,16513953550,7450,7230,7260,-190,-2.55,7410,-40,-0.54,7230,7360
105,تسه9908,امتياز تسهيلات مسكن آبان99,455,11328,6192602166,542544,559700,516090,-26454,-4.88,546663,4119,0.76,516090,559700
106,تسه9911,امتياز تسهيلات مسكن بهمن99,442,6427,3523873325,539377,530099,555000,15623,2.9,548292,8915,1.65,530057,559000
107,كاريس,صندوق س.سپهر كاريزما-س,438,2475231,25169590978,10200,10131,10150,-50,-0.49,10169,-31,-0.3,10105,10200
108,ارزش,صندوق س ارزش آفرين بيدار-سهام,436,3468902,30668382240,9010,8940,8740,-270,-3,8840,-170,-1.89,8740,9000
109,كرمان,س. توسعه و عمران استان كرمان,431,12636585,14304614220,1166,1132,1132,-34,-2.92,1156,-10,-0.86,1132,1132
110,آساميد,صندوق س.مشترك آسمان اميد -د,428,19828588,238152564303,11982,11984,11992,10,0.08,12011,29,0.24,11984,12014
111,ارمغان,ص سرمايه گذاري ارمغان ايرانيان,412,13519976,135524056239,10018,10023,10025,7,0.07,10024,6,0.06,10020,10028
112,هرمز,فولاد هرمزگان جنوب,408,5861858,85132931068,14972,14550,14523,-449,-3,14643,-329,-2.2,14523,14550
113,تاصيكو,سرمايه گذاري صدرتامين,402,5903842,57975797720,9850,9850,9560,-290,-2.94,9840,-10,-0.1,9560,10000
114,شبندر,پالايش نفت بندرعباس,401,6298168,120798862240,19770,19180,19180,-590,-2.98,19180,-590,-2.98,19180,19180
115,وساخت,سرمايه‌ گذاري‌ ساختمان‌ايران‌,388,800543,35129335110,45230,43880,43890,-1340,-2.96,44230,-1000,-2.21,43880,43970
116,شاراك,پتروشيمي شازند,380,3410380,85808758470,25900,25150,25500,-400,-1.54,25160,-740,-2.86,25130,25680
117,شفن,پتروشيمي فناوران,371,103348,31108107410,310270,301020,300970,-9300,-3,307280,-2990,-0.96,300970,305890
118,لوتوس,تامين سرمايه لوتوس پارسيان,363,9979953,89661055340,9250,9000,9080,-170,-1.84,8980,-270,-2.92,8980,9200
119,خبهمن,گروه‌بهمن‌,359,14275886,19029756038,1374,1333,1333,-41,-2.98,1363,-11,-0.8,1333,1333
120,آكورد,صندوق س. آرمان آتي كوثر-د,329,5637569,180298320112,31966,31984,31985,19,0.06,31982,16,0.05,31980,31985
121,اطلس,صندوق س.توسعه اندوخته آينده-س,323,1779172,341991164755,197494,197000,190500,-6994,-3.54,192219,-5275,-2.67,190500,197000
122,بركت,گروه دارويي بركت,316,480773,13067410140,28020,27180,27180,-840,-3,27850,-170,-0.61,27180,27180
123,خكرمان,گروه اقتصادي كرمان خودرو,313,6404967,21362004859,3403,3335,3335,-68,-2,3335,-68,-2,3335,3365
124,شغدير,پتروشيمي غدير,310,314250,18380326700,60050,58250,58250,-1800,-3,59440,-610,-1.02,58250,59990
125,بفجر,فجر انرژي خليج فارس,309,584820,12272280760,20920,20430,21030,110,0.53,20930,10,0.05,20420,21450
126,دلر,داروسازي‌ اكسير,300,674917,23425071380,35520,34460,34460,-1060,-2.98,35130,-390,-1.1,34460,35990
127,فنورد,نوردوقطعات‌ فولادي‌,299,189538,28119394860,152610,149110,148040,-4570,-2.99,150160,-2450,-1.61,148040,153840
128,تسه9909,امتياز تسهيلات مسكن آذر99,296,5454,3000992966,541093,568147,543800,2707,0.5,550237,9144,1.69,520055,568147
129,ياقوت,صندوق س ياقوت آگاه-ثابت,294,2385603,29462981114,12344,12350,12350,6,0.05,12350,6,0.05,12348,12355
130,شبهرن,نفت‌ بهران‌,289,2141818,22639016260,10890,10570,10570,-320,-2.94,10750,-140,-1.29,10570,10570
131,دمعيار,صندوق س. توازن معيار-د,289,13806442,139386578560,10093,10095,10095,2,0.02,10096,3,0.03,10095,10100
132,شرانل,نفت ايرانول,288,941742,35846821289,39195,38020,38020,-1175,-3,38357,-838,-2.14,38020,38690
133,تسه9803,امتياز تسهيلات مسكن خرداد98,288,5885,3156354318,523056,500000,523800,744,0.14,536339,13283,2.54,500000,548980
134,تسه9910,امتياز تسهيلات مسكن دي99,279,3423,1890260907,543464,540000,570000,26536,4.88,552223,8759,1.61,517000,570000
135,كاردان,صندوق س تجارت شاخصي كاردان,271,100834,14005019430,142400,142390,138200,-4200,-2.95,138890,-3510,-2.46,137400,142390
136,سيدكو,سرمايه گذاري توسعه صنايع سيمان,271,3003675,16776273020,5750,5580,5630,-120,-2.09,5690,-60,-1.04,5580,5630
137,دسبحانح,ح. سبحان دارو,270,297489,3439899980,12240,11560,12000,-240,-1.96,11560,-680,-5.56,11510,12170
138,تنوين,تامين سرمايه نوين,270,3258873,23458472920,7200,7200,7210,10,0.14,7200,0,0,7120,7210
139,سخوز,سيمان خوزستان,270,1259152,25905888530,21200,20570,20570,-630,-2.97,20860,-340,-1.6,20570,20880
140,ونفت,سرمايه‌گذاري‌ صنعت‌ نفت‌,261,3134665,41545237320,13620,13300,13220,-400,-2.94,13300,-320,-2.35,13220,13800
141,همراه,شركت ارتباطات سيار ايران,261,1079173,24260394450,23170,22480,22480,-690,-2.98,23000,-170,-0.73,22480,22650
142,ضسپا3003,اختيارخ خساپا-2000-1400/03/26,257,12311,420930000,55,42,29,-26,-47.27,34,-21,-38.18,26,47
143,جم,پتروشيمي جم,242,586346,20227054930,35470,34450,34410,-1060,-2.99,35270,-200,-0.56,34410,35690
144,ارفع,شركت آهن و فولاد ارفع,238,1898371,25063008959,13609,13201,13201,-408,-3,13448,-161,-1.18,13201,13310
145,سكه0012پ01,سكه تمام بهارتحويلي 1روزه رفاه,237,83900,78697916600,935359,930200,941501,6142,0.66,937997,2638,0.28,930100,942000
146,شيران,س. صنايع‌شيميايي‌ايران,231,2424906,47115923580,20030,19430,19430,-600,-3,19650,-380,-1.9,19430,19430
147,فجر,فولاد اميركبيركاشان,231,294001,16245850810,56940,55300,55240,-1700,-2.99,56370,-570,-1,55240,56000
148,ضسپا3002,اختيارخ خساپا-1800-1400/03/26,217,8015,589017000,101,93,72,-29,-28.71,73,-28,-27.72,70,93
149,سحرخيز,صندوق س. گروه زعفران سحرخيز,212,924944,8046067463,8918,8841,8650,-268,-3.01,8699,-219,-2.46,8627,8871
150,حسينا,توسعه خدمات دريايي وبندري سينا,208,246412,13639641180,56610,55001,55500,-1110,-1.96,56250,-360,-0.64,55001,56310
151,تسه9810,امتياز تسهيلات مسكن دي98,206,3133,1717052297,537379,532222,545000,7621,1.42,548054,10675,1.99,525000,559000
152,فردا2,صندوق س آواي فرداي زاگرس-ثابت,200,20000000,20000000,10647,1,1,-10646,-99.99,1,-10646,-99.99,1,1
153,پارس,پتروشيمي پارس,199,264978,37188868630,141800,140000,141550,-250,-0.18,141250,-550,-0.39,139970,141990
154,وخاور,بانك خاورميانه,193,4490311,37930298040,8620,8580,8370,-250,-2.9,8490,-130,-1.51,8370,8590
155,تسه9902,امتياز تسهيلات مسكن ارديبهشت99,192,3091,1691801476,547078,533555,520000,-27078,-4.95,547331,253,0.05,519725,555000
156,فباهنر,مس‌ شهيدباهنر,189,773603,17663458240,23530,22850,22830,-700,-2.97,23270,-260,-1.1,22830,22870
157,داروح,ح . كارخانجات‌داروپخش,184,1780623,31004874800,18490,20100,17390,-1100,-5.95,17410,-1080,-5.84,17390,20100
158,گوهران,سرمايه گذاري توسعه گوهران اميد,182,1039997,7065582467,6929,6730,6735,-194,-2.8,6909,-20,-0.29,6730,6879
159,كرماشا,صنايع پتروشيمي كرمانشاه,180,905952,29376219260,33410,32750,32410,-1000,-2.99,32810,-600,-1.8,32410,32750
160,رمپنا,گروه مپنا (سهامي عام),178,2370960,35042788800,15230,14780,14780,-450,-2.95,15090,-140,-0.92,14780,14780
161,مبين,مبين انرژي خليج فارس,175,1173538,17691323750,15530,15370,15070,-460,-2.96,15460,-70,-0.45,15070,15370
162,تسه9907,امتياز تسهيلات مسكن مهر99,172,2492,1369530546,543777,525000,542004,-1773,-0.33,549571,5794,1.07,525000,569999
163,خگستر,گسترش‌سرمايه‌گذاري‌ايران‌خودرو,169,1340347,3017121097,2320,2251,2251,-69,-2.97,2316,-4,-0.17,2251,2251
164,سرود,سيمان‌شاهرود,169,957775,15879943750,17090,16580,16580,-510,-2.98,16920,-170,-0.99,16580,16590
165,تيپيكو,سرمايه گذاري دارويي تامين,164,546951,18181903200,34260,33240,33240,-1020,-2.98,33940,-320,-0.93,33240,33450
166,سپاس,صندوق س. پاداش سهامداري توسعه1,161,4288816,42990965803,10017,10024,10025,8,0.08,10024,7,0.07,10021,10025
167,شتولي,تولي‌پرس‌,161,1308929,46962450140,35299,36004,34594,-705,-2,35879,580,1.64,34594,36004
168,وحكمت,بيمه حكمت صبا,160,3376089,11376997745,3436,3368,3376,-60,-1.75,3397,-39,-1.14,3368,3464
169,زعف0008پ16,زعفران0008نگين بيرجند(پ),158,92477,11157128438,120081,120000,120001,-80,-0.07,120648,567,0.47,119121,121300
170,واعتبار,سرمايه گذاري اعتبار ايران,156,2778014,26224452160,8910,9440,9440,530,5.95,9170,260,2.92,9440,9440
171,عيار,صندوق س. پشتوانه طلاي مفيد,150,83023,1991218746,23737,23530,24150,413,1.74,23984,247,1.04,23530,24310
172,فيروزه,صندوق شاخص30 شركت فيروزه- سهام,147,115047,14383269990,126550,125510,125000,-1550,-1.22,125020,-1530,-1.21,124150,125510
173,زر,صندوق س.پشتوانه سكه طلاي زر,146,90309,3580550264,39096,39640,39801,705,1.8,39648,552,1.41,39280,39979
174,آساس,صندوق س.آسمان آرماني سهام-س,145,58719,9281389850,160609,159002,157421,-3188,-1.98,158065,-2544,-1.58,157420,159002
175,اخزا910,اسنادخزانه-م10بودجه99-020807,144,341645,207402067088,606652,606001,608000,1348,0.22,607069,417,0.07,605511,608120
176,كنور,توسعه معدني و صنعتي صبانور,144,130098,6065698490,47870,47830,46580,-1290,-2.69,47730,-140,-0.29,46520,47830
177,ثاميد,توسعه و عمران اميد,143,1823709,2432827806,1375,1334,1334,-41,-2.98,1373,-2,-0.15,1334,1334
178,تسه9904,امتياز تسهيلات مسكن تير99,143,1946,1075073973,541398,539000,530000,-11398,-2.11,552453,11055,2.04,530000,568467
179,زعف0008پ20,زعفران0008نگين وحدت جام(پ),142,33789,4069277808,118865,120000,121599,2734,2.3,120432,1567,1.32,119051,122790
180,انرژي3,سايراشخاص بورس انرژي,142,18978,4476151080,250910,235860,235860,-15050,-6,249720,-1190,-0.47,235860,235860
181,اخزا902,اسنادخزانه-م2بودجه99-011019,141,240142,171429616515,713227,711559,714000,773,0.11,713868,641,0.09,711559,719500
182,وثوق,سرمايه گذاري وثوق امين,139,356767,5943704174,16916,16990,16578,-338,-2,16836,-80,-0.47,16578,16990
183,شخارك,پتروشيمي‌ خارك‌,137,320524,13491092790,43390,42110,42090,-1300,-3,43210,-180,-0.41,42090,42110
184,ضخود7076,اختيارخ خودرو-2500-1400/07/07,137,3274,339758000,136,121,97,-39,-28.68,104,-32,-23.53,97,121
185,شصفها,پتروشيمي‌ اصفهان‌,131,337792,41726586591,126045,123525,123525,-2520,-2,123527,-2518,-2,123525,123700
186,سشمال,سيمان‌ شمال‌,129,1320218,12594879720,9830,9540,9540,-290,-2.95,9750,-80,-0.81,9540,9540
187,وتوسم,سرمايه‌گذاري‌توسعه‌ملي‌,127,1037036,7841178090,7790,7570,7560,-230,-2.95,7750,-40,-0.51,7560,7580
188,كخاك,صنايع‌خاك‌چيني‌ايران‌,127,174630,6894076420,40460,39250,39250,-1210,-2.99,40320,-140,-0.35,39250,40910
189,وگردش,بانك گردشگري,123,6012938,97493776732,16544,16214,16214,-330,-1.99,16214,-330,-1.99,16214,16214
190,زعف0008پ05,زعفران0008نگين زرين(پ),123,76507,9318598738,120287,126500,120560,273,0.23,121801,1514,1.26,119301,126500
191,وصندوق,سرمايه‌گذاري‌صندوق‌بازنشستگي‌,121,2772382,38064804860,14150,13730,13730,-420,-2.97,14010,-140,-0.99,13730,13730
192,دارا,صندوق س. دارا الگوريتم-د,121,1895532,19054133608,10055,10068,10058,3,0.03,10052,-3,-0.03,10040,10069
193,تسه9804,امتياز تسهيلات مسكن تير98,118,1557,852340526,539789,523000,544000,4211,0.78,547425,7636,1.41,523000,555000
194,ضجار2002,اختيارخ وتجارت-2500-1400/02/22,117,5740,115692000,48,26,12,-36,-75,20,-28,-58.33,12,37
195,شلعابح,ح . لعابيران‌,116,1666857,15016922290,9380,9800,9000,-380,-4.05,9010,-370,-3.94,9000,9800
196,كگهر,سنگ آهن گهرزمين,115,626607,25994294036,42642,41364,41363,-1279,-3,42383,-259,-0.61,41363,42290
197,آسيا,بيمه آسيا,114,6560804,11789764788,1852,1797,1797,-55,-2.97,1839,-13,-0.7,1797,1797
198,تسه9906,امتياز تسهيلات مسكن شهريور99,111,1447,804565650,549556,527222,577033,27477,5,556023,6467,1.18,522079,577033
199,شنفت,نفت‌ پارس‌,110,153865,7023841180,47050,45640,45640,-1410,-3,46850,-200,-0.43,45640,46100
200,آريان,سرمايه گذاري پارس آريان,109,2290064,22302933296,9456,9739,9739,283,2.99,9538,82,0.87,9739,9739
201,كروي,توسعه‌ معادن‌ روي‌ ايران‌,106,526885,13077285700,25580,24820,24820,-760,-2.97,25370,-210,-0.82,24820,24820
202,هجرتح,ح . پخش هجرت,105,3877869,67322205840,17896,17600,17360,-536,-3,17361,-535,-2.99,17360,17600
203,پارتا,مجتمع‌صنعتي‌آرتاويل‌تاير,105,454210,14009199030,29945,30843,30843,898,3,30408,463,1.55,30843,30843
204,اخزا901,اسنادخزانه-م1بودجه99-010621,104,75831,57691948840,761567,760009,760571,-996,-0.13,760796,-771,-0.1,760009,762000
205,ونيكي,سرمايه‌گذاري‌ ملي‌ايران‌,103,547559,4249057840,7990,7760,7760,-230,-2.88,7970,-20,-0.25,7760,7760
206,تسه9806,امتياز تسهيلات مسكن شهريور98,103,1856,1023054528,541265,514510,532188,-9077,-1.68,551215,9950,1.84,514510,567990
207,وبازار,صندوق س شاخصي بازارآشنا,101,1010441,9089943420,9000,8710,9010,10,0.11,9000,0,0,8710,9020
208,تسه9808,امتياز تسهيلات مسكن آبان98,97,1151,631827216,539495,530000,550000,10505,1.95,548938,9443,1.75,530000,566469
209,كاما,باما,97,808155,9237211650,11780,11430,11430,-350,-2.97,11710,-70,-0.59,11430,11430
210,تسه9903,امتياز تسهيلات مسكن خرداد99,96,540,295349461,543196,526222,540000,-3196,-0.59,546943,3747,0.69,526222,560901
211,شراز,پالايش نفت شيراز,96,374419,39979339973,110079,106777,106777,-3302,-3,107339,-2740,-2.49,106777,106787
212,تسه9812,امتياز تسهيلات مسكن اسفند98,95,850,462062619,538417,521059,532777,-5640,-1.05,543603,5186,0.96,516599,558000
213,وتوصا,گروه س توسعه صنعتي ايران,95,3061897,33987056700,11440,11100,11100,-340,-2.97,11200,-240,-2.1,11100,11100
214,ضخود7074,اختيارخ خودرو-1800-1400/07/07,95,4051,883302000,325,269,203,-122,-37.54,218,-107,-32.92,197,269
215,گوهر,صندوق سكه طلاي كيان,93,29124,1353161149,45744,46650,46600,856,1.87,46462,718,1.57,45911,46650
216,خاتم,صندوق س خاتم ايساتيس پويا-ثابت,93,980564,10859685820,11068,11071,11085,17,0.15,11075,7,0.06,11071,11089
217,تسه9905,امتياز تسهيلات مسكن مرداد99,93,946,514447273,539840,521000,550500,10660,1.97,543813,3973,0.74,521000,559990
218,كارين,صندوق س نگين سامان-ثابت,88,1762925,17824834507,10106,10110,10115,9,0.09,10111,5,0.05,10109,10118
219,تسه9811,امتياز تسهيلات مسكن بهمن98,88,785,429447852,539370,522009,513000,-26370,-4.89,547067,7697,1.43,513000,558555
220,لبوتان,گروه‌صنعتي‌بوتان‌,86,215351,12533428200,60000,58200,58200,-1800,-3,59530,-470,-0.78,58200,58200
221,حكشتي,كشتيراني جمهوري اسلامي ايران,85,166563,2665008000,16490,16000,16000,-490,-2.97,16480,-10,-0.06,16000,16000
222,تسه9809,امتياز تسهيلات مسكن آذر98,84,535,293242859,536695,522225,540561,3866,0.72,548117,11422,2.13,522225,563529
223,وخارزم,سرمايه گذاري خوارزمي,82,405810,1822492710,4629,4491,4491,-138,-2.98,4624,-5,-0.11,4491,4491
224,تسه9901,امتياز تسهيلات مسكن فروردين99,82,678,380444165,545544,526250,572821,27277,5,561127,15583,2.86,526250,572821
225,زگلدشتح,ح.كشت و دام گلدشت نمونه اصفهان,81,421305,2546788725,6231,6045,6045,-186,-2.99,6045,-186,-2.99,6045,6045
226,مارون,پتروشيمي مارون,80,218161,31605648407,149352,144872,144872,-4480,-3,147890,-1462,-0.98,144872,145091
227,اخزا903,اسنادخزانه-م3بودجه99-011110,79,143023,100738035967,704493,704000,705000,507,0.07,704348,-145,-0.02,703553,705000
228,درازك,دارويي‌ رازك‌,77,316947,9359496140,30440,29530,29530,-910,-2.99,30260,-180,-0.59,29530,30000
229,سشرق,سيمان‌ شرق‌,76,2115974,12420767380,6050,5870,5870,-180,-2.98,6000,-50,-0.83,5870,5870
230,شيراز,پتروشيمي‌شيراز,74,518772,26260665950,52180,50620,50620,-1560,-2.99,51760,-420,-0.8,50620,50680
231,زرين,صندوق س. سهام زرين كوروش-س,73,151655,1398580180,9179,8921,9180,1,0.01,9222,43,0.47,8921,9367
232,تسه9805,امتياز تسهيلات مسكن مرداد98,70,593,327170071,543375,518000,541723,-1652,-0.3,551720,8345,1.54,518000,560000
233,ماديرا,صنايع ماشين هاي اداري ايران,69,555684,3925351776,7282,7064,7064,-218,-2.99,7264,-18,-0.25,7064,7064
234,اخزا909,اسنادخزانه-م9بودجه99-020316,67,359266,236345559916,657953,656629,656844,-1109,-0.17,657857,-96,-0.01,656522,659000
235,سكرما,سيمان‌ كرمان‌,65,453305,6790508900,15440,14980,14980,-460,-2.98,15380,-60,-0.39,14980,14980
236,تسه9807,امتياز تسهيلات مسكن مهر98,64,210,115316780,534620,536000,515000,-19620,-3.67,549127,14507,2.71,507889,561351
237,بترانس,ايران‌ ترانسفو,63,665789,1819601337,2817,2733,2733,-84,-2.98,2814,-3,-0.11,2733,2733
238,ثاخت,بين‌المللي‌توسعه‌ساختمان,63,3657145,8784462290,2476,2402,2402,-74,-2.99,2463,-13,-0.53,2402,2402
239,كدما,معدني‌ دماوند,60,103610,9931018500,98810,95850,95850,-2960,-3,98200,-610,-0.62,95850,95850
240,نهال,صندوق س. طلاي سرخ نوويرا,59,48848,431457592,9009,8861,8820,-189,-2.1,8833,-176,-1.95,8801,8861
241,تملت,تامين سرمايه بانك ملت,57,1214305,5833521220,4952,4804,4804,-148,-2.99,4934,-18,-0.36,4804,4804
242,اوصتا,صندوق انديشه ورزان صباتامين -د,56,1739924,32310751599,18568,18570,18580,12,0.06,18570,2,0.01,18570,18580
243,ضخود7077,اختيارخ خودرو-3000-1400/07/07,55,2409,80557000,53,38,28,-25,-47.17,33,-20,-37.74,28,50
244,شبريز,پالايش نفت تبريز,55,529593,12832038390,24970,24230,24230,-740,-2.96,24870,-100,-0.4,24230,24230
245,اتكاي,بيمه اتكايي ايرانيان,55,118871,1903187128,16419,15927,15927,-492,-3,16403,-16,-0.1,15927,16955
246,ساروج,بين المللي ساروج بوشهر,54,747080,12967069660,17711,17357,17357,-354,-2,17473,-238,-1.34,17357,17360
247,سكه0011پ02,سكه تمام بهارتحويلي 1روزه ملت,54,8100,7583783700,934426,927001,942000,7574,0.81,936270,1844,0.2,927001,942000
248,اخزا908,اسنادخزانه-م8بودجه99-020606,53,112765,70919640099,629477,628355,628527,-950,-0.15,628915,-562,-0.09,628270,630000
249,ضملي3003,اختيارخ فملي-12000-1400/03/02,52,1217,270927000,526,220,240,-286,-54.37,223,-303,-57.6,195,500
250,افق ملت,صندوق س در سهام افق ملت,51,30756,3709778710,121590,121700,120300,-1290,-1.06,120620,-970,-0.8,120300,121700
251,خديزل,بهمن  ديزل,51,115933,4411714382,39230,38054,38054,-1176,-3,39122,-108,-0.28,38054,38054
252,گشان,توسعه بين المللي پديده شانديز,51,75413,1661876281,22486,22037,22037,-449,-2,22429,-57,-0.25,22037,22037
253,صايند,صندوق س. گنجينه آينده روشن-د,49,521870,5091208010,9758,9766,9732,-26,-0.27,9756,-2,-0.02,9732,9773
254,خراسان,پتروشيمي خراسان,49,155574,10362788060,68660,66610,66610,-2050,-2.99,68220,-440,-0.64,66610,66620
255,ضشنا2002,اختيارخ شپنا-12000-1400/02/27,49,2061,11909000,19,10,10,-9,-47.37,6,-13,-68.42,5,13
256,ضپاس2000,اختيارخ وپارس-2000-1400/02/29,48,291,108323000,440,400,355,-85,-19.32,372,-68,-15.45,289,429
257,حريل,ريل پردازسير,47,3134000,16933002000,5570,5403,5403,-167,-3,5512,-58,-1.04,5403,5403
258,فروي,ذوب روي اصفهان,47,13118,725084332,56983,55274,55274,-1709,-3,56957,-26,-0.05,55274,55274
259,سكه0012پ04,سكه تمام بهارتحويلي1روز صادرات,47,6900,6471148200,935048,935000,941800,6752,0.72,937848,2800,0.3,933002,941800
260,سكه0112پ03,سكه تمام بهارتحويلي1روزه سامان,47,12000,11260618300,934138,932000,941890,7752,0.83,938385,4247,0.45,932000,942000
261,چخزر,صنايع چوب خزر كاسپين,46,207711,10860792768,53905,52288,52288,-1617,-3,53543,-362,-0.67,52288,52288
262,هنوري102,اختيارف ت نوري73761-01/02/15,46,212014,932861600,3260,4400,4400,1140,34.97,4400,1140,34.97,4400,4400
263,وكار,بانك‌ كارآفرين‌,44,2165965,6144845097,2924,2837,2837,-87,-2.98,2913,-11,-0.38,2837,2860
264,اخزا914,اسنادخزانه-م14بودجه99-021025,44,18572,10786391582,580002,583000,580000,-2,0,580788,786,0.14,580000,583000
265,ضپاس2002,اختيارخ وپارس-3000-1400/02/29,44,2046,4259000,3,9,1,-2,-66.67,2,-1,-33.33,1,9
266,كوير,توليدي فولاد سپيد فراب كوير,41,1262580,23648123400,19300,18730,18730,-570,-2.95,19130,-170,-0.88,18730,18730
267,آتيمس,صندوق س.آرمان آتيه درخشان مس-س,41,13046,2244129844,174064,172472,171617,-2447,-1.41,172017,-2047,-1.18,171105,173000
268,ولپارس,ليزينگ پارسيان,40,517018,2502367120,4989,4840,4840,-149,-2.99,4981,-8,-0.16,4840,4840
269,ضملي7002,اختيارخ فملي-10000-1400/07/11,40,426,1228456000,3466,3300,2870,-596,-17.2,2884,-582,-16.79,2715,3400
270,دفرا,فرآورده‌هاي‌ تزريقي‌ ايران‌,39,53600,1357688000,26110,25330,25330,-780,-2.99,26090,-20,-0.08,25330,25330
271,فاراك,ماشين‌ سازي‌ اراك‌,38,229170,531903570,2392,2321,2321,-71,-2.97,2391,-1,-0.04,2321,2321
272,وبشهر,توسعه‌ صنايع‌ بهشهر(هلدينگ,38,906251,8953759880,10180,9880,9880,-300,-2.95,10120,-60,-0.59,9880,9880
273,ضخود7072,اختيارخ خودرو-1400-1400/07/07,37,726,421681000,616,610,540,-76,-12.34,581,-35,-5.68,520,690
274,اخزا911,اسنادخزانه-م11بودجه99-020906,37,27509,16394374697,596020,596005,596000,-20,0,595964,-56,-0.01,595200,596005
275,زعف0008پ08,زعفران0008نگين روستا(پ),36,10065,1218152210,120672,120000,121800,1128,0.93,121029,357,0.3,120000,123490
276,فيروزا,صندوق بادرآمد ثابت فيروزه آسيا,35,36773,838285474,22750,22750,22800,50,0.22,22796,46,0.2,22750,22811
277,خصدرا,صنعتي‌ دريايي‌ ايران‌,35,279122,680778558,2488,2439,2439,-49,-1.97,2487,-1,-0.04,2439,2439
278,غسالم,سالمين‌,35,283785,1093423605,3972,3853,3853,-119,-3,3969,-3,-0.08,3853,3853
279,كزغال,زغال سنگ پروده طبس,34,311904,9542702880,31541,30595,30595,-946,-3,31354,-187,-0.59,30595,30595
280,ضپيك2008,اختيارخ تاپيكو-9000-00/02/19,34,450,201647000,598,401,543,-55,-9.2,448,-150,-25.08,351,547
281,شاملا,معدني‌ املاح‌  ايران‌,32,195627,9409658700,49580,48100,48100,-1480,-2.99,49290,-290,-0.58,48100,48100
282,وسينا,بانك سينا,32,335078,872208034,2683,2603,2603,-80,-2.98,2682,-1,-0.04,2603,2603
283,اخزا814,اسنادخزانه-م14بودجه98-010318,32,16811,13496541365,805523,805000,803499,-2024,-0.25,802840,-2683,-0.33,801000,805600
284,رتكو,كنترل‌خوردگي‌تكين‌كو,31,400000,6928000000,17850,17320,17320,-530,-2.97,17770,-80,-0.45,17320,17320
285,وسپه,سرمايه‌گذاري‌ سپه‌,31,532079,3293569010,6380,6190,6190,-190,-2.98,6370,-10,-0.16,6190,6190
286,اخابر,مخابرات ايران,30,48515,442941950,9410,9130,9130,-280,-2.98,9410,0,0,9130,9130
287,وآرين,شركت توسعه اقتصادي آرين,29,297513,999048654,3497,3358,3358,-139,-3.97,3490,-7,-0.2,3358,3358
288,حفاري,حفاري شمال,27,57269,362512770,6520,6330,6330,-190,-2.91,6520,0,0,6330,6330
289,زعف0008پ19,زعفران0008نگين تروند قاينات(پ),27,6159,741837680,119000,120000,121900,2900,2.44,120448,1448,1.22,115861,121999
290,قشرين,قند شيرين خراسان,27,654760,7494382960,11679,11446,11446,-233,-2,11587,-92,-0.79,11446,11446
291,وكارح,ح . بانك‌ كارآفرين‌,27,950187,1356272549,1518,1480,1427,-91,-5.99,1427,-91,-5.99,1427,1480
292,اطلس2,صندوق س.توسعه اندوخته آينده-س,26,260000,260000,197494,1,1,-197493,-100,1,-197493,-100,1,1
293,واميدح,ح.گروه مديريت سرمايه گذار اميد,26,555975,3847347000,7360,6920,6920,-440,-5.98,6920,-440,-5.98,6920,6920
294,باران,بيمه زندگي باران50%تاديه,26,403000,1555177000,3747,3859,3859,112,2.99,3755,8,0.21,3859,3859
295,اخزا815,اسنادخزانه-م15بودجه98-010406,26,41059,32694557792,797303,796001,795300,-2003,-0.25,796282,-1021,-0.13,795200,796770
296,دلرح,ح . داروسازي‌ اكسير,26,122823,3229940400,27440,27000,25800,-1640,-5.98,26300,-1140,-4.15,25800,27000
297,كفپارس,فرآورده‌هاي‌ نسوز پارس‌,26,266869,847042206,3272,3174,3174,-98,-3,3270,-2,-0.06,3174,3174
298,فسپا,گروه‌صنعتي‌سپاهان‌,26,135064,4611084960,35190,34140,34140,-1050,-2.98,35090,-100,-0.28,34140,34140
299,فراز,صندوق س.سهام فراز داريك-س,25,21237,218738141,10295,10300,10299,4,0.04,10300,5,0.05,10299,10300
300,ضملي3002,اختيارخ فملي-10000-1400/03/02,25,63,111768000,2172,1851,1700,-472,-21.73,1774,-398,-18.32,1511,1999
301,وپترو,سرمايه‌گذاري صنايع پتروشيمي‌,25,1001571,13391004270,13780,13370,13370,-410,-2.98,13670,-110,-0.8,13370,13370
302,بورس,بورس اوراق بهادار تهران,24,380398,12697685240,34410,33380,33380,-1030,-2.99,34170,-240,-0.7,33380,33380
303,ضجار2003,اختيارخ وتجارت-3000-1400/02/22,24,1000,1000000,2,1,1,-1,-50,1,-1,-50,1,1
304,اخزا818,اسنادخزانه-م18بودجه98-010614,24,26517,20291524004,767497,765619,765112,-2385,-0.31,765227,-2270,-0.3,765012,766000
305,اخزا907,اسنادخزانه-م7بودجه99-020704,24,112234,69419382550,618577,620000,620000,1423,0.23,618524,-53,-0.01,617000,620000
306,كمنگنز,معادن‌منگنزايران‌,23,111569,9563694680,88370,85720,85720,-2650,-3,87850,-520,-0.59,85720,85720
307,وسبحان,سرمايه گذاري سبحان,23,1418930,3896381780,2830,2746,2746,-84,-2.97,2823,-7,-0.25,2746,2746
308,ضپيك2009,اختيارخ تاپيكو-10000-00/02/19,23,702,987000,23,1,1,-22,-95.65,1,-22,-95.65,1,5
309,بكهنوج,توليد برق ماهتاب كهنوج,23,162429,258262110,1639,1590,1590,-49,-2.99,1639,0,0,1590,1590
310,ثمسكن,سرمايه‌گذاري‌ مسكن‌,23,78490,375888610,4937,4789,4789,-148,-3,4936,-1,-0.02,4789,4789
311,سپر,صندوق س سپر سرمايه بيدار- ثابت,23,345303,4067017320,11775,11779,11778,3,0.03,11778,3,0.03,11778,11781
312,اخزا809,اسنادخزانه-م9بودجه98-000923,22,32033,28419134333,887027,885904,888888,1861,0.21,887183,156,0.02,885743,888888
313,سامان,بانك سامان,22,513861,4274809659,8488,8319,8319,-169,-1.99,8469,-19,-0.22,8319,8319
314,شسينا,صنايع‌شيميايي‌سينا,21,2296,285783120,132410,124470,124470,-7940,-6,132360,-50,-0.04,124470,124470
315,اخزا905,اسنادخزانه-م5بودجه99-020218,21,62485,41710713415,669581,666000,668900,-681,-0.1,667532,-2049,-0.31,666000,668900
316,پاكشو,گروه صنعتي پاكشو,21,164755,1011595700,6320,6140,6140,-180,-2.85,6320,0,0,6140,6140
317,گكوثر,هتل پارسيان كوثر اصفهان,20,164616,365776752,2290,2222,2222,-68,-2.97,2289,-1,-0.04,2222,2222
318,آكورد2,صندوق س. آرمان آتي كوثر-د,20,2000000,2000000,31966,1,1,-31965,-100,1,-31965,-100,1,1
319,سخند,صندوق س.سپهرخبرگان نفت-د,20,131680,1319514320,10016,10020,10020,4,0.04,10021,5,0.05,10020,10024
320,شكف,كف,20,6021,613816866,106193,101946,101946,-4247,-4,105937,-256,-0.24,101946,101946
321,گنجين,صندوق س. گنجينه يكم آويد-د,20,67144,858257048,12774,12793,12784,10,0.08,12782,8,0.06,12778,12793
322,شپترو,پتروشيمي آبادان,20,427199,1876258008,4574,4392,4392,-182,-3.98,4556,-18,-0.39,4392,4392
323,ضشنا8001,اختيارخ شپنا-8000-1400/08/16,20,1022,2419750000,3014,2400,2370,-644,-21.37,2368,-646,-21.43,2300,2400
324,چكاپا,گروه صنايع كاغذ پارس,20,72257,364175280,5190,5040,5040,-150,-2.89,5190,0,0,5040,5040
325,وبوعلي,سرمايه‌گذاري‌بوعلي‌,20,63898,356550840,5750,5580,5580,-170,-2.96,5750,0,0,5580,5580
326,بذر,صندوق س بذر اميد آفرين-سهام,18,8737,788184650,90290,90700,88830,-1460,-1.62,90210,-80,-0.09,88820,92000
327,شفارا,پتروشيمي فارابي,18,708215,2577194385,3713,3639,3639,-74,-1.99,3703,-10,-0.27,3639,3639
328,وهور,مديريت انرژي اميد  تابان هور,18,83754,165246642,2033,1973,1973,-60,-2.95,2033,0,0,1973,1973
329,اخزا906,اسنادخزانه-م6بودجه99-020321,17,12067,9033470000,755878,740000,749000,-6878,-0.91,748609,-7269,-0.96,740000,755000
330,خزاميا,زامياد,17,25967,220459830,8750,8490,8490,-260,-2.97,8750,0,0,8490,8490
331,اخزا821,اسنادخزانه-م21بودجه98-020906,17,1141,683889420,599176,599000,599420,244,0.04,599377,201,0.03,599000,599800
332,همبين102,اختيارف ت مبين19752-01/02/10,17,453363,331861716,694,732,732,38,5.48,732,38,5.48,732,732
333,اخزا820,اسنادخزانه-م20بودجه98-020806,17,54310,33121902290,609130,609130,609000,-130,-0.02,609867,737,0.12,609000,610112
334,اخزا721,اسنادخزانه-م21بودجه97-000728,17,4970,4538229498,914426,913000,914426,0,0,913125,-1301,-0.14,912801,914426
335,صايپا012,صكوك مرابحه سايپا012-3ماهه 16%,17,170000,170000340000,1000002,1000002,1000002,0,0,1000002,0,0,1000002,1000002
336,شكبير,پتروشيمي اميركبير,16,103029,8415408720,83346,81680,81680,-1666,-2,83203,-143,-0.17,81680,81680
337,شاوان,پالايش نفت لاوان,16,262235,21168920375,83221,80725,80725,-2496,-3,82132,-1089,-1.31,80725,80725
338,اخزا816,اسنادخزانه-م16بودجه98-010503,16,10390,8136489300,784557,784000,783100,-1457,-0.19,783108,-1449,-0.18,783100,784000
339,سبزوا,سيمان لار سبزوار,16,121325,390666500,3319,3220,3220,-99,-2.98,3318,-1,-0.03,3220,3220
340,خودكفا,اقتصادي و خودكفايي آزادگان,16,14470,255612550,18025,17665,17665,-360,-2,18023,-2,-0.01,17665,17665
341,بموتو,موتوژن‌,15,4868,250653320,53080,51490,51490,-1590,-3,53070,-10,-0.02,51490,51490
342,ثبهساز,بهساز كاشانه تهران,15,172451,380944259,2277,2209,2209,-68,-2.99,2276,-1,-0.04,2209,2209
343,لپارس,پارس‌ الكتريك‌,15,41203,3647701590,91260,88530,88530,-2730,-2.99,91050,-210,-0.23,88530,88530
344,ملت,بيمه ملت,15,100830,1524549600,15580,15120,15120,-460,-2.95,15570,-10,-0.06,15120,15120
345,ضشنا2004,اختيارخ شپنا-16000-1400/02/27,15,569,1742000,4,3,6,2,50,3,-1,-25,3,6
346,فجام,جام‌دارو,15,500000,5000000000,10300,10000,10000,-300,-2.91,10270,-30,-0.29,10000,10000
347,ونيرو,سرمايه‌گذاري‌نيرو,15,170972,427430000,2577,2500,2500,-77,-2.99,2576,-1,-0.04,2500,2500
348,دپارس,پارس‌ دارو,15,3324,153502320,47600,46180,46180,-1420,-2.98,47600,0,0,46180,46180
349,شبصير,توليدات پتروشيمي قائد بصير,14,1872,121318704,66811,64807,64807,-2004,-3,66806,-5,-0.01,64807,64807
350,ضشنا2003,اختيارخ شپنا-14000-1400/02/27,14,629,629000,1,1,1,0,0,1,0,0,1,1
351,كرازي,كارخانجات‌توليدي‌شيشه‌رازي‌,14,17925,390585750,22460,21790,21790,-670,-2.98,22450,-10,-0.04,21790,21790
352,ضصاد3001,اختيارخ وبصادر-2000-1400/03/12,14,625,192155000,283,240,270,-13,-4.59,307,24,8.48,240,320
353,اخزا808,اسنادخزانه-م8بودجه98-000817,14,3360,3036910603,904687,903900,904500,-187,-0.02,903842,-845,-0.09,903000,904500
354,غپينو,پارس‌ مينو,14,19034,117059100,6340,6150,6150,-190,-3,6340,0,0,6150,6150
355,جوين,كشت و صنعت جوين,14,72063,351523314,4977,4878,4878,-99,-1.99,4975,-2,-0.04,4878,4878
356,پارسيان,بيمه پارسيان,13,501000,4699380000,9670,9380,9380,-290,-3,9640,-30,-0.31,9380,9380
357,ضخود7073,اختيارخ خودرو-1600-1400/07/07,13,572,199807000,409,307,367,-42,-10.27,349,-60,-14.67,302,370
358,هاي وب,داده گسترعصرنوين-هاي وب,13,17432,177109120,10470,10160,10160,-310,-2.96,10470,0,0,10160,10160
359,زعف0008پ10,زعفران0008نگين طلاي سرخ(پ),13,3292,404474276,123036,121001,123100,64,0.05,122866,-170,-0.14,121001,126500
360,كهمدا,شيشه‌ همدان‌,13,30277,297925680,10140,9840,9840,-300,-2.96,10140,0,0,9840,9840
361,صنوين,صندوق سرمايه‌گذاري صنوين-مختلط,13,4233,432973210,102410,102410,102000,-410,-0.4,102290,-120,-0.12,102000,102500
362,فرابورس,فرابورس ايران,12,6270,190263150,31283,30345,30345,-938,-3,31279,-4,-0.01,30345,30345
363,دالبر,البرزدارو,12,43571,623065300,14740,14300,14300,-440,-2.99,14730,-10,-0.07,14300,14300
364,هپارس102,اختيارف ت پارس-177010-01/02/05,12,56027,240972127,4028,4301,4301,273,6.78,4301,273,6.78,4301,4301
365,سپيدار,سپيدار سيستم آسيا,12,2353,134205708,58800,57036,57036,-1764,-3,58795,-5,-0.01,57036,57036
366,زپارس,ملي كشت و صنعت و دامپروري پارس,12,210500,27889145000,136580,132490,132490,-4090,-2.99,134180,-2400,-1.76,132490,132490
367,اخزا720,اسنادخزانه-م20بودجه97-000324,12,10171,9964295237,980052,980500,979235,-817,-0.08,979677,-375,-0.04,979235,980500
368,وسديد,گروه ‌صنعتي‌سديد,12,126943,361152835,2903,2845,2845,-58,-2,2902,-1,-0.03,2845,2845
369,خمحركه,نيرو محركه‌,12,32252,143876172,4598,4461,4461,-137,-2.98,4598,0,0,4461,4461
370,برن0003پ01,برنج طارم0003تجارت مازندران(پ),12,780,219216000,279754,279500,283000,3246,1.16,281046,1292,0.46,279500,285000
371,مفاخر,توسعه فناوري اطلاعات خوارزمي,12,260000,15748720000,62445,60572,60572,-1873,-3,61831,-614,-0.98,60572,60572
372,اخزا904,اسنادخزانه-م4بودجه99-011215,12,59045,41099599539,697345,695630,695627,-1718,-0.25,696072,-1273,-0.18,695627,697000
373,ضپاس2001,اختيارخ وپارس-2500-1400/02/29,11,150,7625000,70,140,50,-20,-28.57,51,-19,-27.14,50,140
374,قرن,پديده شيمي قرن,11,3561,213873660,61910,60060,60060,-1850,-2.99,61900,-10,-0.02,60060,60060
375,رتاپ,تجارت الكترونيك  پارسيان,11,239758,1601583440,6880,6680,6680,-200,-2.91,6870,-10,-0.15,6680,6680
376,وملي,گروه‌ صنعتي‌ ملي‌ (هلدينگ‌,11,620,102517000,170460,165350,165350,-5110,-3,170450,-10,-0.01,165350,165350
377,آسام,صندوق س.آرمان سپهر آشنا-م,11,2990,306144650,103773,102000,102900,-873,-0.84,102390,-1383,-1.33,101105,103200
378,شسم,توليد سموم‌ علف‌ كش,11,1070,100134880,89985,93584,93584,3599,4,90020,35,0.04,93584,93584
379,ددام,داروسازي زاگرس فارمد پارس,11,11565,245524950,21880,21230,21230,-650,-2.97,21880,0,0,21230,21230
380,ثروتم,صندوق س. ثروت آفرين پارسيان-س,11,2690,190098470,70666,70900,70900,234,0.33,70669,3,0,70447,70950
381,ختوقا,قطعات‌ اتومبيل‌ ايران‌,10,50011,121726774,2509,2434,2434,-75,-2.99,2509,0,0,2434,2434
382,فافزا,فولاد افزا سپاهان,10,11777,564094746,49893,47898,47898,-1995,-4,49834,-59,-0.12,47898,47898
383,نوين,بيمه نوين,10,44344,254711936,5921,5744,5744,-177,-2.99,5920,-1,-0.02,5744,5744
384,ضشنا8002,اختيارخ شپنا-9000-1400/08/16,10,99,167225000,1928,1684,1690,-238,-12.34,1689,-239,-12.4,1679,1690
385,اخزا713,اسنادخزانه-م13بودجه97-000518,10,2509,2384540000,951254,952500,950200,-1054,-0.11,950395,-859,-0.09,950000,952500
386,فسرب,ملي‌ سرب‌وروي‌ ايران‌,10,923,70526430,78770,76410,76410,-2360,-3,78770,0,0,76410,76410
387,آبادا,توليد نيروي برق آبادان,10,8036,98039200,12570,12200,12200,-370,-2.94,12570,0,0,12200,12200
388,ضشنا2001,اختيارخ شپنا-10000-1400/02/27,10,115,8235000,255,83,50,-205,-80.39,72,-183,-71.76,50,246
389,كالا,بورس كالاي ايران,10,4545,140622300,31890,30940,30940,-950,-2.98,31890,0,0,30940,30940
390,شوينده,مديريت صنعت شوينده ت.ص.بهشهر,10,7980,199500000,25770,25000,25000,-770,-2.99,25770,0,0,25000,25000
391,اخزا807,اسنادخزانه-م7بودجه98-000719,10,3095,2841390310,919971,918500,921000,1029,0.11,918058,-1913,-0.21,918010,921000
392,فسازان,غلتك سازان سپاهان,10,201028,6370577320,32660,31690,31690,-970,-2.97,32530,-130,-0.4,31690,31690
393,گدنا,تهيه توزيع غذاي دنا آفرين فدك,10,3339,109883151,33926,32909,32909,-1017,-3,33924,-2,-0.01,32909,32909
394,تايرا,تراكتورسازي‌ايران‌,10,40327,1054954320,26960,26160,26160,-800,-2.97,26940,-20,-0.07,26160,26160
395,اراد33,مرابحه عام دولت3-ش.خ 0303,10,6000,5499292800,948090,900685,900685,-47405,-5,916549,-31541,-3.33,900685,979999
396,زگلدشت,كشت و دام گلدشت نمونه اصفهان,9,13138,177809692,13952,13534,13534,-418,-3,13950,-2,-0.01,13534,13534
397,اخزا812,اسنادخزانه-م12بودجه98-001111,9,3195,2770364992,866747,865510,867000,253,0.03,867094,347,0.04,864051,870000
398,قثابت,قند ثابت‌ خراسان‌,9,16923,1110318030,67630,65610,65610,-2020,-2.99,67580,-50,-0.07,65610,65610
399,پتاير,ايران‌ تاير,9,35218,125270426,3667,3557,3557,-110,-3,3667,0,0,3557,3557
400,چكارن,كارتن‌ ايران‌,9,20599,66555369,3330,3231,3231,-99,-2.97,3330,0,0,3231,3231
401,غگرجي,بيسكويت‌  گرجي‌,9,53230,940574100,18210,17670,17670,-540,-2.97,18200,-10,-0.05,17670,17670
402,الماس,صندوق س.امين تدبيرگران فردا-س,9,4827,511662000,106000,106000,106000,0,0,106000,0,0,106000,106000
403,رافزا,رايان هم افزا,9,996,103054128,106668,103468,103468,-3200,-3,106661,-7,-0.01,103468,103468
404,كماسه,تامين‌ ماسه‌ ريخته‌گري‌,8,5318,225376840,43690,42380,42380,-1310,-3,43680,-10,-0.02,42380,42380
405,اخزا817,اسنادخزانه-م17بودجه98-010512,8,6438,5018431265,779245,779500,779500,255,0.03,779502,257,0.03,779500,779600
406,اخزا810,اسنادخزانه-م10بودجه98-001006,8,4127,3630390430,881380,879401,879772,-1608,-0.18,879668,-1712,-0.19,879401,880000
407,اخزا804,اسنادخزانه-م4بودجه98-000421,8,2628,2533418950,964993,966000,964007,-986,-0.1,964010,-983,-0.1,964001,966000
408,ستران,سيمان‌ تهران‌,8,13753,312193100,23400,22700,22700,-700,-2.99,23400,0,0,22700,22700
409,ضفلا7000,اختيارخ فولاد-5706-1400/07/25,8,133,575400000,1,4300,4400,4399,439900,4326,4325,432500,4300,4400
410,ضملي3004,اختيارخ فملي-14000-1400/03/02,8,311,12020000,90,70,37,-53,-58.89,39,-51,-56.67,35,70
411,وآيند,بانك  آينده,8,18584,298050192,16365,16038,16038,-327,-2,16364,-1,-0.01,16038,16038
412,وصنا,گروه‌صنايع‌بهشهرايران‌,8,30840,168694800,5630,5470,5470,-160,-2.84,5630,0,0,5470,5470
413,ضفلا7001,اختيارخ فولاد-6420-1400/07/25,8,264,895200000,1,3300,3500,3499,349900,3391,3390,339000,3300,3500
414,تليسه,دامداري تليسه نمونه,8,28399,119815381,4349,4219,4219,-130,-2.99,4349,0,0,4219,4219
415,فخاس,فولاد خراسان,8,390344,9867896320,26060,25280,25280,-780,-2.99,25980,-80,-0.31,25280,25280
416,بكام,كارخانجات توليدي شهيد قندي,8,20999,80153183,3935,3817,3817,-118,-3,3935,0,0,3817,3817
417,ضجار2005,اختيارخ وتجارت-4000-1400/02/22,8,379,2729000,7,9,4,-3,-42.86,7,0,0,4,10
418,بنيرو,نيروترانس‌,7,53367,778624530,15040,14590,14590,-450,-2.99,15030,-10,-0.07,14590,14590
419,وپويا,سرمايه گذاري پويا,7,17086,106548296,6428,6236,6236,-192,-2.99,6428,0,0,6236,6236
420,اخزا716,اسنادخزانه-م16بودجه97-000407,7,2011,1960417194,974004,973800,975000,996,0.1,974847,843,0.09,973800,975000
421,پرديس,سرمايه گذاري پرديس,7,18722,98664940,5430,5270,5270,-160,-2.95,5430,0,0,5270,5270
422,زعف0008پ12,زعفران0008پوشالمعمول سحرخيز(پ),7,552,47149266,84610,82000,80702,-3908,-4.62,85415,805,0.95,80702,88840
423,اخزا722,اسنادخزانه-م22بودجه97-000428,7,2054,1974967800,960347,961500,962400,2053,0.21,961523,1176,0.12,961500,962400
424,نگين,ص.س. زمين و ساختمان نگين شهرري,7,1526,73472940,48270,48390,47650,-620,-1.28,48150,-120,-0.25,47650,48390
425,خريخت,صنايع‌ريخته‌گري‌ايران‌,7,114714,325787760,2927,2840,2840,-87,-2.97,2926,-1,-0.03,2840,2840
426,ضشنا8003,اختيارخ شپنا-10000-1400/08/16,7,169,219020000,1301,1305,1100,-201,-15.45,1296,-5,-0.38,1051,1305
427,خرينگ,رينگ‌سازي‌مشهد,7,7455,379086750,52420,50850,50850,-1570,-3,52410,-10,-0.02,50850,50850
428,لكما,كارخانجات‌مخابراتي‌ايران‌,7,15485,90788555,6107,5863,5863,-244,-4,6106,-1,-0.02,5863,5863
429,ضجار2000,اختيارخ وتجارت-1800-1400/02/22,7,238,113540000,566,560,500,-66,-11.66,477,-89,-15.72,350,590
430,شپاس,نفت پاسارگاد,7,230600,4784258200,21388,20747,20747,-641,-3,21324,-64,-0.3,20747,20747
431,ساوه,سيمان ساوه,7,2098,113579426,55811,54137,54137,-1674,-3,55807,-4,-0.01,54137,54137
432,ضمخا7066,اختيارخ اخابر-12000-1400/07/28,7,49,29887000,600,613,670,70,11.67,610,10,1.67,503,899
433,خفناور,مهندسي صنعتي روان فن آور,7,3540,164571060,48426,46489,46489,-1937,-4,48409,-17,-0.04,46489,46489
434,ضغدر3000,اختيارخ وغدير-6200-1400/03/26,7,159,476614000,3600,3000,2998,-602,-16.72,2998,-602,-16.72,2906,3000
435,آوا2,صندوق س.سهام آواي معيار-س,7,18000000,18000000,6319,1,1,-6318,-99.98,1,-6318,-99.98,1,1
436,داريك,صندوق س.اعتماد داريك-د,7,5740,60622595,10559,10561,10565,6,0.06,10561,2,0.02,10560,10565
437,فروس,فروسيليس‌ ايران‌,6,8237,42173440,5270,5120,5120,-150,-2.85,5270,0,0,5120,5120
438,زبينا,كشاورزي و دامپروري بينالود,6,13787,52252730,3907,3790,3790,-117,-2.99,3907,0,0,3790,3790
439,اخزا806,اسنادخزانه-م6بودجه98-000519,6,1380,1311006300,950168,950000,950003,-165,-0.02,950005,-163,-0.02,950000,951000
440,ثشاهد,سرمايه‌ گذاري‌ شاهد,6,2241,37805670,17390,16870,16870,-520,-2.99,17390,0,0,16870,16870
441,غشان,شيرپاستوريزه‌پگاه‌خراسان‌,6,19025,141926500,7690,7460,7460,-230,-2.99,7690,0,0,7460,7460
442,اعتماد2,صندوق س.اعتماد آفرين پارسيان-د,6,54500000,54500000,36305,1,1,-36304,-100,1,-36304,-100,1,1
443,بزاگرس,نيروگاه زاگرس كوثر,6,12649,87784060,7154,6940,6940,-214,-2.99,7154,0,0,6940,6940
444,سپاها,سيمان‌سپاهان‌,6,20394,161316540,8150,7910,7910,-240,-2.94,8150,0,0,7910,7910
445,ضشنا2000,اختيارخ شپنا-9000-1400/02/27,6,56,21254000,810,323,649,-161,-19.88,380,-430,-53.09,322,649
446,ختور,رادياتور ايران‌,6,2184,41539680,19600,19020,19020,-580,-2.96,19600,0,0,19020,19020
447,دامين,داروسازي‌ امين‌,6,27825,141351000,5230,5080,5080,-150,-2.87,5230,0,0,5080,5080
448,ولبهمن,شركت بهمن ليزينگ,6,111700,825798100,7621,7393,7393,-228,-2.99,7617,-4,-0.05,7393,7393
449,قصفها,قنداصفهان‌,6,278,42239320,156630,151940,151940,-4690,-2.99,156630,0,0,151940,151940
450,وثنو,سرمايه گذاري ساختماني نوين,6,11925,55176975,4721,4627,4627,-94,-1.99,4721,0,0,4627,4627
451,وبيمه,سرمايه‌ گذاري‌ صنعت‌ بيمه‌,6,14888,40435808,2799,2716,2716,-83,-2.97,2799,0,0,2716,2716
452,شپاكسا,پاكسان‌,6,1993,52455760,27130,26320,26320,-810,-2.99,27130,0,0,26320,26320
453,تصميم2,صندوق س با درآمد ثابت تصميم,6,6000000,6000000,16283,1,1,-16282,-99.99,1,-16282,-99.99,1,1
454,دزهراوي,داروسازي‌زهراوي‌,6,5111,43187950,8710,8450,8450,-260,-2.99,8710,0,0,8450,8450
455,فملي2,ملي‌ صنايع‌ مس‌ ايران‌,6,253062000,2991192840000,12180,11820,11820,-360,-2.96,11820,-360,-2.96,11820,11820
456,ضسپا3005,اختيارخ خساپا-3000-1400/03/26,6,220,830000,7,3,4,-3,-42.86,4,-3,-42.86,3,4
457,ضصاد3000,اختيارخ وبصادر-1800-1400/03/12,6,78,35880000,467,460,460,-7,-1.5,460,-7,-1.5,460,460
458,پكرمان,گروه‌ صنعتي‌ بارز,6,12135,286992750,24380,23650,23650,-730,-2.99,24380,0,0,23650,23650
459,ضخوز7037,اختيارخ فخوز-12000-1400/07/14,5,33,99030000,3500,3010,3000,-500,-14.29,3001,-499,-14.26,3000,3010
460,عفولاد3,اوراق سلف موازي ورق گرم فولاد,5,1500000,1280550000000,852000,853700,853700,1700,0.2,853700,1700,0.2,853700,853700
461,وپست,پست بانك ايران,5,3204,63086760,20290,19690,19690,-600,-2.96,20290,0,0,19690,19690
462,ضترا8056,اختيارخ شتران-6000-1400/08/09,5,111,244200000,2400,2200,2200,-200,-8.33,2200,-200,-8.33,2200,2200
463,زعف0008پ11,زعفران0008نگين سحرخيز(پ),5,2800,339299000,122010,120500,122000,-10,-0.01,121178,-832,-0.68,120500,124490
464,شستان,پتروشيمي گلستان,5,84818,320442404,3855,3778,3778,-77,-2,3852,-3,-0.08,3778,3778
465,دسبحان,سبحان دارو,5,6690,122025600,18800,18240,18240,-560,-2.98,18800,0,0,18240,18240
466,پسهند,صنايع‌ لاستيكي‌  سهند,5,1080,40176000,38350,37200,37200,-1150,-3,38350,0,0,37200,37200
467,خمحور,توليدمحورخودرو,5,486,29932740,63490,61590,61590,-1900,-2.99,63490,0,0,61590,61590
468,ورنا,سرمايه‌گذاري‌ رنا(هلدينگ‌,5,31620,167902200,5470,5310,5310,-160,-2.93,5470,0,0,5310,5310
469,طپيك2017,اختيارف تاپيكو-32000-00/02/19,5,500,11200000000,1,22400,22400,22399,2239900,22400,22399,2239900,22400,22400
470,ولساپا,ليزينگ رايان‌ سايپا,5,21004,67317820,3304,3205,3205,-99,-3,3304,0,0,3205,3205
471,سمايه,بانك سرمايه,5,18466,88156684,4972,4774,4774,-198,-3.98,4971,-1,-0.02,4774,4774
472,كبافق,معادن‌ بافق‌,5,763,35769440,48320,46880,46880,-1440,-2.98,48320,0,0,46880,46880
473,ودي,بيمه  دي,5,7151,144864958,20884,20258,20258,-626,-3,20882,-2,-0.01,20258,20258
474,اراد50,مرابحه عام دولت5-ش.خ0302,5,100800,100800000000,1000000,1000000,1000000,0,0,1000000,0,0,1000000,1000000
475,اراد43,مرابحه عام دولت4-ش.خ 0205,5,100000,95000000000,940000,950000,950000,10000,1.06,950000,10000,1.06,950000,950000
476,غمارگ,مارگارين‌,5,3007,91352660,31310,30380,30380,-930,-2.97,31310,0,0,30380,30380
477,شكربن,كربن‌ ايران‌,5,40000,3372400000,86910,84310,84310,-2600,-2.99,86730,-180,-0.21,84310,84310
478,ضصاد8033,اختيارخ وبصادر-2500-1400/08/12,5,100,15000000,1,150,150,149,14900,150,149,14900,150,150
479,اخزا813,اسنادخزانه-م13بودجه98-010219,5,287,234589259,816642,817500,817322,680,0.08,817384,742,0.09,817322,817500
480,ضفلا3003,اختيارخ فولاد-7133-1400/03/19,5,21,35470000,2072,1600,1774,-298,-14.38,1689,-383,-18.48,1600,1774
481,والبر,سرمايه‌ گذاري‌ البرز(هلدينگ‌,5,7815,122539200,16160,15680,15680,-480,-2.97,16160,0,0,15680,15680
482,زقيام,كشت و دام قيام اصفهان,5,1247,35003290,28938,28070,28070,-868,-3,28937,-1,0,28070,28070
483,غصينو,صنعتي مينو,5,3710,241127740,67004,64994,64994,-2010,-3,66999,-5,-0.01,64994,64994
484,اخزا811,اسنادخزانه-م11بودجه98-001013,5,5608,4928600669,876677,878500,878000,1323,0.15,878852,2175,0.25,878000,878999
485,غشاذر,پگاه‌آذربايجان‌غربي‌,4,12201,118349700,9990,9700,9700,-290,-2.9,9990,0,0,9700,9700
486,ضجار2004,اختيارخ وتجارت-3500-1400/02/22,4,100,100000,61,1,1,-60,-98.36,1,-60,-98.36,1,1
487,وسگيلا,شركت س استان گيلان,4,36689,27406683,770,747,747,-23,-2.99,770,0,0,747,747
488,لخزر,پارس‌ خزر,4,159,28763100,186490,180900,180900,-5590,-3,186490,0,0,180900,180900
489,خكاوه,سايپا ديزل,4,51638,182488692,3606,3534,3534,-72,-2,3605,-1,-0.03,3534,3534
490,رطب0002پ01,رطب مضافتي0002افشارتعاون بم(پ),4,521,81266362,155446,163216,154400,-1046,-0.67,155981,535,0.34,147675,163217
491,كيميا,معدني كيمياي زنجان گستران,4,3908,67065188,17691,17161,17161,-530,-3,17690,-1,-0.01,17161,17161
492,ثفارس,عمران‌وتوسعه‌فارس‌,4,3736,36239200,10000,9700,9700,-300,-3,10000,0,0,9700,9700
493,خودرو2,ايران‌ خودرو,4,330000000,625020000000,1952,1894,1894,-58,-2.97,1894,-58,-2.97,1894,1894
494,قشكر,شكرشاهرود,4,11943,44487675,3840,3725,3725,-115,-2.99,3840,0,0,3725,3725
495,واميد,گروه مديريت سرمايه گذاري اميد,4,8243,99740300,12470,12100,12100,-370,-2.97,12470,0,0,12100,12100
496,سيستم,همكاران سيستم,4,848,21089760,25630,24870,24870,-760,-2.97,25630,0,0,24870,24870
497,سمگا,گروه سرمايه گذاري ميراث فرهنگي,4,1315,36566205,28666,27807,27807,-859,-3,28665,-1,0,27807,27807
498,بمپنا,توليد برق عسلويه  مپنا,4,1508,102780756,70264,68157,68157,-2107,-3,70260,-4,-0.01,68157,68157
499,اراد35,مرابحه عام دولت3-ش.خ 0103,4,26000,24667459000,948523,948523,949500,977,0.1,948748,225,0.02,948523,949500
500,تپمپي,پمپ‌ سازي‌ ايران‌,4,2300,43309000,19410,18830,18830,-580,-2.99,19410,0,0,18830,18830
501,ضمخا7070,اختيارخ اخابر-20000-1400/07/28,4,14,7364000,253,253,799,546,215.81,526,273,107.91,253,799
502,ضصاد8032,اختيارخ وبصادر-2000-1400/08/12,4,51,21902000,1,430,402,401,40100,429,428,42800,402,430
503,وپخش,داروپخش‌ (هلدينگ‌,4,907,89266940,101460,98420,98420,-3040,-3,101450,-10,-0.01,98420,98420
504,اشاد1,مشاركت دولتي1-شرايط خاص001026,4,600,598472300,999945,985000,999945,0,0,997454,-2491,-0.25,985000,999945
505,بخاور,بيمه زندگي خاورميانه,4,138864,911781024,6769,6566,6566,-203,-3,6765,-4,-0.06,6566,6566
506,قيستو,شركت قند بيستون,4,2468,46620520,19275,18890,18890,-385,-2,19273,-2,-0.01,18890,18890
507,غزر,صنعتي زر ماكارون,4,1515,37708350,25650,24890,24890,-760,-2.96,25650,0,0,24890,24890
508,حتايد,تايدواترخاورميانه,4,2505,61798350,25430,24670,24670,-760,-2.99,25430,0,0,24670,24670
509,ضپاس7028,اختيارخ وپارس-2000-1400/07/28,4,220,110410000,503,540,500,-3,-0.6,502,-1,-0.2,500,540
510,ضصاد3003,اختيارخ وبصادر-3000-1400/03/12,4,180,900000,8,5,5,-3,-37.5,5,-3,-37.5,5,5
511,شاروم,پتروشيمي اروميه,4,2571,48190824,19323,18744,18744,-579,-3,19322,-1,-0.01,18744,18744
512,فسا,پتروشيمي فسا,4,14425,24536925,1771,1701,1701,-70,-3.95,1771,0,0,1701,1701
513,اميد,تامين سرمايه اميد,4,4716,35464320,7750,7520,7520,-230,-2.97,7750,0,0,7520,7520
514,خكمك,كمك‌فنرايندامين‌,4,3331,87671920,27130,26320,26320,-810,-2.99,27130,0,0,26320,26320
515,ضپيك7042,اختيارخ تاپيكو-10000-00/07/18,4,257,312764000,1520,1212,1220,-300,-19.74,1217,-303,-19.93,1212,1220
516,غالبر,لبنيات‌ كالبر,4,1905,37357050,20210,19610,19610,-600,-2.97,20210,0,0,19610,19610
517,وتجارت2,بانك تجارت,3,750000000,1797750000000,2471,2397,2397,-74,-2.99,2397,-74,-2.99,2397,2397
518,ضپيك7040,اختيارخ تاپيكو-8000-00/07/18,3,100,240000000,2874,2400,2400,-474,-16.49,2400,-474,-16.49,2400,2400
519,ضسپا3001,اختيارخ خساپا-1600-1400/03/26,3,120,26280000,227,190,240,13,5.73,219,-8,-3.52,190,240
520,زير0003پ04,زيره سبز0003شركت مينوبذر(پ),3,209,126530896,575044,600000,614544,39500,6.87,605411,30367,5.28,600000,614544
521,خمهر,مهركام‌پارس‌,3,8679,20465082,2430,2358,2358,-72,-2.96,2430,0,0,2358,2358
522,غبهنوش,بهنوش‌ ايران‌,3,3004,208447560,71530,69390,69390,-2140,-2.99,71520,-10,-0.01,69390,69390
523,تملي612,تسهيلات مسكن بانك ملي-اسفند96,3,28,16024652,545057,572309,572309,27252,5,572309,27252,5,572309,572309
524,ضجار2001,اختيارخ وتجارت-2000-1400/02/22,3,4,1515000,448,555,350,-98,-21.88,379,-69,-15.4,305,555
525,غدشت,دشت‌ مرغاب‌,3,90,25149600,288080,279440,279440,-8640,-3,288080,0,0,279440,279440
526,تكنو,تكنوتار,3,95708,2041451640,21980,21330,21330,-650,-2.96,21950,-30,-0.14,21330,21330
527,كسرا,سراميك‌هاي‌صنعتي‌اردكان‌,3,5854,118133720,20800,20180,20180,-620,-2.98,20800,0,0,20180,20180
528,پكوير,كوير تاير,3,4028,50269440,12860,12480,12480,-380,-2.95,12860,0,0,12480,12480
529,ضملي7000,اختيارخ فملي-8000-1400/07/11,3,40,184000000,3701,4600,4600,899,24.29,4600,899,24.29,4600,4600
530,دسينا,داروسازي‌ سينا,3,679,15678110,23800,23090,23090,-710,-2.98,23800,0,0,23090,23090
531,وپسا,س. پتروشيمي ساختمان  خليج فارس,3,10942,31589554,3007,2887,2887,-120,-3.99,3007,0,0,2887,2887
532,دسبحا,گروه دارويي سبحان,3,1327,24562770,19080,18510,18510,-570,-2.99,19080,0,0,18510,18510
533,فزرين,زرين معدن آسيا,3,1489,38926927,26951,26143,26143,-808,-3,26950,-1,0,26143,26143
534,زكوثر,سرمايه گذاري كشاورزي كوثر,3,7240,151967600,21630,20990,20990,-640,-2.96,21630,0,0,20990,20990
535,خاذين,سايپاآذين‌,3,4100,18892800,4750,4608,4608,-142,-2.99,4750,0,0,4608,4608
536,اتكام,شركت بيمه اتكايي امين,3,13414,61771470,4747,4605,4605,-142,-2.99,4747,0,0,4605,4605
537,دسانكو,داروسازي سبحان انكولوژي,3,3474,49831056,14787,14344,14344,-443,-3,14787,0,0,14344,14344
538,ثتوسا,س.توسعه و عمران استان اردبيل,3,545,20785755,38917,38139,38139,-778,-2,38916,-1,0,38139,38139
539,تبرك,گروه كارخانجات صنعتي تبرك,3,41023,788421037,19813,19219,19219,-594,-3,19803,-10,-0.05,19219,19219
540,ضترا3002,اختيارخ شتران-8000-1400/03/09,3,42,8400000,442,200,200,-242,-54.75,200,-242,-54.75,200,200
541,اعتلا,شركت سرمايه گذاري اعتلاء البرز,3,4424,31158232,7260,7043,7043,-217,-2.99,7260,0,0,7043,7043
542,سبهان,سيمان‌ بهبهان‌,3,1677,231291840,142180,137920,137920,-4260,-3,142160,-20,-0.01,137920,137920
543,غشهداب,كشت و صنعت شهداب ناب خراسان,3,6425,24691275,3961,3843,3843,-118,-2.98,3961,0,0,3843,3843
544,شتهران,داروسازي تهران شيمي,3,4550,35781200,7710,7864,7864,154,2,7711,1,0.01,7864,7864
545,ضچاد7031,اختيارخ كچاد-16000-1400/07/04,3,85,454750000,5695,5350,5350,-345,-6.06,5350,-345,-6.06,5350,5350
546,ركيش,كارت اعتباري ايران كيش,3,3000,69150000,23760,23050,23050,-710,-2.99,23760,0,0,23050,23050
547,ضملي3005,اختيارخ فملي-16000-1400/03/02,3,7,170000,82,20,49,-33,-40.24,24,-58,-70.73,1,49
548,ضملي7003,اختيارخ فملي-12000-1400/07/11,3,19,31299000,1867,1500,1780,-87,-4.66,1647,-220,-11.78,1500,1780
549,زير0003پ01,زيره سبز0003كيميابذر(پ),3,400,235089200,610134,560000,605950,-4184,-0.69,587723,-22411,-3.67,556017,605950
550,فلامي,لاميران‌,3,4000,173880000,44810,43470,43470,-1340,-2.99,44810,0,0,43470,43470
551,چفيبر,فيبر ايران‌,3,5000,67250000,13860,13450,13450,-410,-2.96,13860,0,0,13450,13450
552,فولاد2,فولاد مباركه اصفهان,3,145000000,1679100000000,11930,11580,11580,-350,-2.93,11580,-350,-2.93,11580,11580
553,ثامان,سامان‌ گستراصفهان‌,3,758,17578020,23900,23190,23190,-710,-2.97,23900,0,0,23190,23190
554,آپ,آسان پرداخت پرشين,3,1927,32547030,17410,16890,16890,-520,-2.99,17410,0,0,16890,16890
555,بنو,بيمه تجارت نو,3,722,22317742,31866,30911,30911,-955,-3,31866,0,0,30911,30911
556,تپكو,توليدتجهيزات‌سنگين‌هپكو,3,17270,91617350,5413,5305,5305,-108,-2,5413,0,0,5305,5305
557,تملي708,تسهيلات مسكن ب. ملي-آبان97,3,27,19628406,692360,726978,726978,34618,5,726978,34618,5,726978,726978
558,دابور,داروسازي‌ ابوريحان‌,3,1410,51986700,38010,36870,36870,-1140,-3,38010,0,0,36870,36870
559,وهنر,گروه توسعه هنر ايران,3,80000,649440000,8283,8118,8118,-165,-1.99,8278,-5,-0.06,8118,8118
560,ثباغ,شهر سازي و خانه سازي باغميشه,3,16811,246718236,15129,14676,14676,-453,-2.99,15127,-2,-0.01,14676,14676
561,فپنتا,سپنتا,3,101,39766730,405900,393730,393730,-12170,-3,405890,-10,0,393730,393730
562,بكاب,صنايع‌جوشكاب‌يزد,3,579,202134690,359900,349110,349110,-10790,-3,359860,-40,-0.01,349110,349110
563,دبالك,مواد اوليه دارويي البرز بالك,3,10783,217762685,20819,20195,20195,-624,-3,20816,-3,-0.01,20195,20195
564,قشير,قند شيروان قوچان و بجنورد,3,2900,72247700,25683,24913,24913,-770,-3,25682,-1,0,24913,24913
565,اخزا718,اسنادخزانه-م18بودجه97-000525,2,20,19013740,945711,950890,950600,4889,0.52,950687,4976,0.53,950600,950890
566,صايپا203,صكوك مرابحه سايپا203-3ماهه 16%,2,27,25709400,970000,952200,952200,-17800,-1.84,952200,-17800,-1.84,952200,952200
567,طلا2,صندوق س.پشتوانه طلاي لوتوس,2,200000,200000,67278,1,1,-67277,-100,1,-67277,-100,1,1
568,دارو,كارخانجات‌داروپخش‌,2,300,9729000,33430,32430,32430,-1000,-2.99,33430,0,0,32430,32430
569,ضملي7001,اختيارخ فملي-9000-1400/07/11,2,20,72000000,3590,3600,3600,10,0.28,3600,10,0.28,3600,3600
570,افاد82,منفعت دولت8-ش.خاص لوتوس0205,2,6000,5182000000,840000,882000,860000,20000,2.38,863667,23667,2.82,860000,882000
571,غشصفا,شيرپاستوريزه‌پگاه‌اصفهان‌,2,450,12222000,28000,27160,27160,-840,-3,28000,0,0,27160,27160
572,ضملي7004,اختيارخ فملي-14000-1400/07/11,2,10,6000000,409,600,600,191,46.7,600,191,46.7,600,600
573,سخواف,سيمان مجد خواف,2,5620,90881020,16844,16171,16171,-673,-4,16841,-3,-0.02,16171,16171
574,لسرما,سرما آفرين‌,2,11256,262940160,24080,23360,23360,-720,-2.99,24080,0,0,23360,23360
575,دفارا,داروسازي‌ فارابي‌,2,181,11316120,64450,62520,62520,-1930,-2.99,64450,0,0,62520,62520
576,كگاز,شيشه‌ و گاز,2,2304,41978880,18780,18220,18220,-560,-2.98,18780,0,0,18220,18220
577,بالبر,كابل‌ البرز,2,1332,76310280,59060,57290,57290,-1770,-3,59060,0,0,57290,57290
578,خساپا2,سايپا,2,155000000,280550000000,1865,1810,1810,-55,-2.95,1810,-55,-2.95,1810,1810
579,لابسا,آبسال‌,2,1365,70024500,52880,51300,51300,-1580,-2.99,52880,0,0,51300,51300
580,قنيشا,قند  نيشابور,2,800,49984000,64410,62480,62480,-1930,-3,64410,0,0,62480,62480
581,ثعتما,س. ساختماني اعتماد گستر,2,502,33045656,67171,65828,65828,-1343,-2,67169,-2,0,65828,65828
582,داراب,پتروشيمي داراب,2,6310,15156620,2451,2402,2402,-49,-2,2451,0,0,2402,2402
583,وتعاون,بيمه  تعاون,2,13233,81766707,6305,6179,6179,-126,-2,6304,-1,-0.02,6179,6179
584,سيمرغ,سيمرغ,2,845,14981850,18270,17730,17730,-540,-2.96,18270,0,0,17730,17730
585,حخزر,كشتيراني درياي خزر,2,554,15259930,28396,27545,27545,-851,-3,28396,0,0,27545,27545
586,ضپاس2005,اختيارخ وپارس-4500-1400/02/29,2,100,300000,2,3,3,1,50,3,1,50,3,3
587,دلقما,دارويي‌ لقمان‌,2,2500,62725000,25860,25090,25090,-770,-2.98,25860,0,0,25090,25090
588,دجابر,داروسازي‌ جابرابن‌حيان‌,2,715,14042600,20240,19640,19640,-600,-2.96,20240,0,0,19640,19640
589,واتي,سرمايه‌ گذاري‌ آتيه‌ دماوند,2,4195,41320750,10150,9850,9850,-300,-2.96,10150,0,0,9850,9850
590,دشيمي,شيمي‌ داروئي‌ داروپخش‌,2,516,15289080,30540,29630,29630,-910,-2.98,30540,0,0,29630,29630
591,سنفت009,سلف موازي استاندارد سنفت009,2,134000,204343300000,1501300,1524950,1524950,23650,1.58,1524950,23650,1.58,1524950,1524950
592,ضپيك2011,اختيارخ تاپيكو-14000-00/02/19,2,2,2000,1,1,1,0,0,1,0,0,1,1
593,قاسم,قاسم ايران,2,820,10384480,13055,12664,12664,-391,-3,13055,0,0,12664,12664
594,حفارس,حمل و نقل بين المللي خليج فارس,2,11085,51877800,4824,4680,4680,-144,-2.99,4824,0,0,4680,4680
595,سفاسي,شركت فارسيت اهواز,2,6500,91858000,14420,14132,14132,-288,-2,14419,-1,-0.01,14132,14132
596,رنيك,جنرال مكانيك,2,3090,66870690,22310,21641,21641,-669,-3,22309,-1,0,21641,21641
597,سرو2,صندوق س سروسودمند مدبران-سهام,2,400000,400000,60650,1,1,-60649,-100,1,-60649,-100,1,1
598,غويتا,ويتانا,2,824,14356552,17961,17423,17423,-538,-3,17961,0,0,17423,17423
599,كفرآور,فرآورده هاي سيمان شرق,2,503,11400998,23610,22666,22666,-944,-4,23609,-1,0,22666,22666
600,بساما,بيمه سامان,2,2144,45096896,21684,21034,21034,-650,-3,21683,-1,0,21034,21034
601,ضغدر3002,اختيارخ وغدير-8200-1400/03/26,2,13,19555000,1775,1500,1555,-220,-12.39,1504,-271,-15.27,1500,1555
602,ثاژن,سخت آژند,2,7277,67566945,9671,9285,9285,-386,-3.99,9668,-3,-0.03,9285,9285
603,وسرمد,بيمه  سرمد,2,12505,76343025,6229,6105,6105,-124,-1.99,6229,0,0,6105,6105
604,ولملت,واسپاري ملت,2,1784,13594080,7850,7620,7620,-230,-2.93,7850,0,0,7620,7620
605,ضجار7041,اختيارخ وتجارت-3000-1400/07/21,2,3,120000,108,40,40,-68,-62.96,40,-68,-62.96,40,40
606,ريشمك,توليد و صادرات ريشمك,2,1105,60631350,56567,54870,54870,-1697,-3,56565,-2,0,54870,54870
607,غمينو,شركت صنايع غذايي مينو شرق,2,1035,11466765,11421,11079,11079,-342,-2.99,11421,0,0,11079,11079
608,وآذر,سرمايه‌گذاري‌توسعه‌آذربايجان‌,2,435,35574300,84300,81780,81780,-2520,-2.99,84300,0,0,81780,81780
609,پست0008پ08,پسته فندقي32-30مه ولات0008(پ),2,9,14769000,1610000,1686000,1605000,-5000,-0.31,1641000,31000,1.93,1605000,1686000
610,كلر,كلر پارس,2,130,16378570,129885,125989,125989,-3896,-3,129884,-1,0,125989,125989
611,ضترا3001,اختيارخ شتران-7000-1400/03/09,2,38,26600000,1000,700,700,-300,-30,700,-300,-30,700,700
612,غگلپا,شير پاستوريزه پگاه گلپايگان,2,350,22329300,65771,63798,63798,-1973,-3,65770,-1,0,63798,63798
613,ضجار7039,اختيارخ وتجارت-2000-1400/07/21,2,13,7930000,693,610,610,-83,-11.98,610,-83,-11.98,610,610
614,رويش,ص.س.جسورانه رويش لوتوس70%تأديه,2,250,405000000,1620000,1620000,1620000,0,0,1620000,0,0,1620000,1620000
615,زملارد,كشاورزي و دامپروري ملارد شير,2,298,10855544,37554,36428,36428,-1126,-3,37554,0,0,36428,36428
616,وبهمن,سرمايه‌گذاري‌بهمن‌,2,101437,1405916820,14280,13860,13860,-420,-2.94,14270,-10,-0.07,13860,13860
617,افاد4,منفعت دولتي4-شرايط خاص14010729,2,14000,15028515000,1042700,1035000,1094835,52135,5,1073465,30765,2.95,1035000,1094835
618,ثرود,سرمايه‌گذاري مسكن زاينده رود,2,616,12591656,21073,20441,20441,-632,-3,21073,0,0,20441,20441
619,پارسان2,گسترش نفت و گاز پارسيان,2,20554000,351267860000,17610,17090,17090,-520,-2.95,17090,-520,-2.95,17090,17090
620,دتوليد,داروسازي توليد دارو,2,806,20771426,26568,25771,25771,-797,-3,26568,0,0,25771,25771
621,سجام,مجتمع سيمان غرب آسيا,2,4662,19491822,4266,4181,4181,-85,-1.99,4266,0,0,4181,4181
622,وزمين,بانك ايران زمين,2,1395,17738820,12975,12716,12716,-259,-2,12975,0,0,12716,12716
623,فسديد,لوله‌وتجهيزات‌ سديد - ورشكسته,2,270,30155760,112816,111688,111688,-1128,-1,112809,-7,-0.01,111688,111688
624,ضشنا2006,اختيارخ شپنا-20000-1400/02/27,2,11,11000,8,1,1,-7,-87.5,1,-7,-87.5,1,1
625,كوثر,بيمه كوثر,2,855,12165795,14669,14229,14229,-440,-3,14669,0,0,14229,14229
626,وسهمدا,شركت س استان همدان,2,12000,10368000,890,864,864,-26,-2.92,890,0,0,864,864
627,كفرا,فراورده‌ هاي‌ نسوزايران‌,2,230,10575400,47400,45980,45980,-1420,-3,47400,0,0,45980,45980
628,ضمخا7074,اختيارخ اخابر-36000-1400/07/28,2,2,491000,400,91,400,0,0,245,-155,-38.75,91,400
629,زدشت,كشت و صنعت دشت خرم دره,2,360,10275120,29424,28542,28542,-882,-3,29424,0,0,28542,28542
630,ضفلا7002,اختيارخ فولاد-7133-1400/07/25,2,60,147000000,1,2450,2450,2449,244900,2450,2449,244900,2450,2450
631,ضفار3010,اختيارخ فارس-7000-1400/03/05,2,20,40000000,1950,2000,2000,50,2.56,2000,50,2.56,2000,2000
632,سباقر,سيمان باقران,1,1915,29881660,15922,15604,15604,-318,-2,15922,0,0,15604,15604
633,چكاوه,صنايع‌كاغذسازي‌كاوه‌,1,285,5092950,18420,17870,17870,-550,-2.99,18420,0,0,17870,17870
634,وسنا,سرمايه گذاري نيروگاهي ايران,1,2077,31931798,15687,15374,15374,-313,-2,15687,0,0,15374,15374
635,ضپيك2010,اختيارخ تاپيكو-12000-00/02/19,1,20,20000,1,1,1,0,0,1,0,0,1,1
636,كپرور,فرآوري زغال سنگ پروده طبس,1,1000,35364000,36457,35364,35364,-1093,-3,36456,-1,0,35364,35364
637,ولغدر,ليزينگ‌خودروغدير,1,250,5967500,24600,23870,23870,-730,-2.97,24600,0,0,23870,23870
638,وسالت,بانك قرض الحسنه رسالت,1,5046,5767578,1110,1143,1143,33,2.97,1110,0,0,1143,1143
639,مرقام,ايران‌ارقام‌,1,264,5000160,19520,18940,18940,-580,-2.97,19520,0,0,18940,18940
640,چافست,افست‌,1,315,5074650,16600,16110,16110,-490,-2.95,16600,0,0,16110,16110
641,كترام,توليدي‌ كاشي‌ تكسرام‌,1,111,5225880,48530,47080,47080,-1450,-2.99,48530,0,0,47080,47080
642,ضخوز7036,اختيارخ فخوز-10000-1400/07/14,1,12,60000000,5340,5000,5000,-340,-6.37,5000,-340,-6.37,5000,5000
643,شتران2,پالايش نفت تهران,1,130000000,997100000000,7900,7670,7670,-230,-2.91,7670,-230,-2.91,7670,7670
644,شپنا2,پالايش نفت اصفهان,1,51546000,499996200000,10000,9700,9700,-300,-3,9700,-300,-3,9700,9700
645,وآوا,سرمايه گذاري آوا نوين,1,600,5176200,8893,8627,8627,-266,-2.99,8893,0,0,8627,8627
646,ختراك,ريخته‌گري‌ تراكتورسازي‌ ايران‌,1,33000,497970000,15550,15090,15090,-460,-2.96,15550,0,0,15090,15090
647,كسرام,پارس‌ سرام‌,1,5455,44076400,8320,8080,8080,-240,-2.88,8320,0,0,8080,8080
648,دكيمي,كيميدارو,1,200,5820000,30000,29100,29100,-900,-3,30000,0,0,29100,29100
649,غشهد,شهد ايران ‌,1,733,5174980,7270,7060,7060,-210,-2.89,7270,0,0,7060,7060
650,فالوم,آلومتك‌,1,145,5156055,36284,35559,35559,-725,-2,36284,0,0,35559,35559
651,ضفلا3004,اختيارخ فولاد-8560-1400/03/19,1,1,300000,1202,300,300,-902,-75.04,300,-902,-75.04,300,300
652,اراد364,مرابحه عام دولت3-ش.خ 0104,1,100,99455500,994555,994555,994555,0,0,994555,0,0,994555,994555
653,آينده,بازرگاني آينده سازان بهشت پارس,1,260,5058820,19854,19457,19457,-397,-2,19854,0,0,19457,19457
654,ثغرب,شركت سرمايه گذاري مسكن شمالغرب,1,20650,159500600,7962,7724,7724,-238,-2.99,7961,-1,-0.01,7724,7724
655,تملي711,تسهيلات مسكن ب. ملي-بهمن97,1,11,5225000,500000,475000,475000,-25000,-5,475000,-25000,-5,475000,475000
656,سنير,سيمان‌ سفيد ني‌ريز,1,24,5804880,249350,241870,241870,-7480,-3,249350,0,0,241870,241870
657,سيلام,سيمان‌ ايلام‌,1,2518,27370660,11200,10870,10870,-330,-2.95,11200,0,0,10870,10870
658,ثعمرا,عمران و توسعه شاهد,1,450,5696550,13050,12659,12659,-391,-3,13050,0,0,12659,12659
659,ضخود4000,اختيارخ خودرو-1400-1400/04/02,1,1,590000,1,590,590,589,58900,590,589,58900,590,590
660,بميلا,توسعه بازرگاني آهن وفولادميلاد,1,1000,13726000,14006,13726,13726,-280,-2,14006,0,0,13726,13726
661,گواهي ظرفيت,گواهي ظرفيت نقدي,1,3000000,51969000000,16499,17323,17323,824,4.99,17323,824,4.99,17323,17323
662,ثنام,س ساختماني ب نام آوران مهندسي,1,1000,16324000,16657,16324,16324,-333,-2,16657,0,0,16324,16324
663,غدام,خوراك‌  دام‌ پارس‌,1,5268,2016063600,394530,382700,382700,-11830,-3,394040,-490,-0.12,382700,382700
664,شستا003,اجاره تامين اجتماعي-سپهر000523,1,1981,1964018868,991428,991428,991428,0,0,991428,0,0,991428,991428
665,غديس,پاكديس,1,700,9119600,13430,13028,13028,-402,-2.99,13430,0,0,13028,13028
666,قنقش,قند نقش جهان,1,270,19435140,73451,71982,71982,-1469,-2,73448,-3,0,71982,71982
667,ضپيك7041,اختيارخ تاپيكو-9000-00/07/18,1,20,32000000,1755,1600,1600,-155,-8.83,1600,-155,-8.83,1600,1600
668,وايران,ليزينگ ايرانيان,1,815,9951150,12580,12210,12210,-370,-2.94,12580,0,0,12210,12210
669,داوه,داروسازي آوه سينا,1,509,9963166,20179,19574,19574,-605,-3,20179,0,0,19574,19574
670,زفكا,كشت و دامداري فكا,1,406,5000296,12696,12316,12316,-380,-2.99,12696,0,0,12316,12316
671,خعمرا,توسعه و عمران شهرستان نائين,1,100,2343100,22749,23431,23431,682,3,22749,0,0,23431,23431
672,ومعلم,بيمه معلم,1,1100,5320700,4986,4837,4837,-149,-2.99,4986,0,0,4837,4837
673,ثاصفا,شركت‌ ساختمان‌ اصفهان‌,1,50,1361200,27779,27224,27224,-555,-2,27779,0,0,27224,27224
674,شرق1400,مشاركت ليزينگ ايران وشرق140010,1,15,15120000,1002533,1008000,1008000,5467,0.55,1008000,5467,0.55,1008000,1008000
675,جم2,پتروشيمي جم,1,2500000,87500000000,35470,35000,35000,-470,-1.33,35000,-470,-1.33,35000,35000
676,افاد72,منفعت دولت7-ش.خاص سپهر0204,1,5000,4096855000,780354,819371,819371,39017,5,819371,39017,5,819371,819371
677,كطبس,ذغال‌سنگ‌ نگين‌ ط‌بس‌,1,70,5546100,81680,79230,79230,-2450,-3,81680,0,0,79230,79230
678,زعف0008پ09,زعفران0008نگين نوين(پ),1,600,72000000,121361,120000,120000,-1361,-1.12,120000,-1361,-1.12,120000,120000
679,ضپاس2003,اختيارخ وپارس-3500-1400/02/29,1,13,78000,2,6,6,4,200,6,4,200,6,6
680,حريل2,ريل پردازسير,1,37000000,199911000000,5570,5403,5403,-167,-3,5403,-167,-3,5403,5403
681,ضشنا2005,اختيارخ شپنا-18000-1400/02/27,1,5,5000,5,1,1,-4,-80,1,-4,-80,1,1
682,پخش,پخش البرز,1,163,5021704,31760,30808,30808,-952,-3,31760,0,0,30808,30808
683,ولراز,ليزينگ رازي,1,100,5495300,56074,54953,54953,-1121,-2,56074,0,0,54953,54953
684,كدما4,معدني‌ دماوند,1,3000000,294600000000,98810,98200,98200,-610,-0.62,98200,-610,-0.62,98200,98200
685,اراد61,مرابحه عام دولت61-ش.خ0309,1,15000,15000000000,1000000,1000000,1000000,0,0,1000000,0,0,1000000,1000000
686,وگستر,گسترش سرمايه گذاري ايرانيان,1,540,9938700,18974,18405,18405,-569,-3,18974,0,0,18405,18405
687,شگل,گلتاش‌,1,3000,29370000,10090,9790,9790,-300,-2.97,10090,0,0,9790,9790
688,ضفار3002,اختيارخ فارس-10000-1400/03/05,1,50,50000,10,1,1,-9,-90,1,-9,-90,1,1
689,شلعاب,لعابيران‌,1,250,5315000,21910,21260,21260,-650,-2.97,21910,0,0,21260,21260
690,سهگمت,سيمان‌هگمتان‌,1,400,9616000,24780,24040,24040,-740,-2.99,24780,0,0,24040,24040
691,اراد36,مرابحه عام دولت3-ش.خ 0104,1,100,100000000,994555,1000000,1000000,5445,0.55,1000000,5445,0.55,1000000,1000000
692,اراد71,مرابحه عام دولت71-ش.خ0311,1,10000,10100000000,1000000,1010000,1010000,10000,1,1010000,10000,1,1010000,1010000
693,اخزا723,اسنادخزانه-م23بودجه97-000824,1,100,90000100,901892,900001,900001,-1891,-0.21,900001,-1891,-0.21,900001,900001
694,فبيرا,بسته‌ بندي‌ ايران‌,1,1668,5067384,3100,3038,3038,-62,-2,3100,0,0,3038,3038
695,ضترا8055,اختيارخ شتران-5000-1400/08/09,1,1,3150000,1,3150,3150,3149,314900,3150,3149,314900,3150,3150
696,شبندر2,پالايش نفت بندرعباس,1,15641000,299994380000,19770,19180,19180,-590,-2.98,19180,-590,-2.98,19180,19180
697,تملي807,تسهيلات مسكن ب. ملي-مهر98,1,10,5463440,575098,546344,546344,-28754,-5,546344,-28754,-5,546344,546344
698,وارس,سرمايه گذاري ارس صبا,1,1000,16887000,17231,16887,16887,-344,-2,17231,0,0,16887,16887
699,افاد614,منفعت دولت6-ش.خاص140109,1,1000000,980000000000,982000,980000,980000,-2000,-0.2,980000,-2000,-0.2,980000,980000
700,غپآذر,شير پگاه آذربايجان شرقي,1,93,5928378,65717,63746,63746,-1971,-3,65717,0,0,63746,63746
701,دانا,بيمه دانا,1,4000,25680000,6610,6420,6420,-190,-2.87,6610,0,0,6420,6420
702,غنوش,نوش‌ مازندران‌,1,500,27580000,56860,55160,55160,-1700,-2.99,56860,0,0,55160,55160
703,فلوله,لوله‌وماشين‌سازي‌ايران‌,1,2000,42980000,22150,21490,21490,-660,-2.98,22150,0,0,21490,21490
704,كاذر,فرآورده‌هاي‌نسوزآذر,1,1200,38112000,32740,31760,31760,-980,-2.99,32740,0,0,31760,31760
705,ضپاس7027,اختيارخ وپارس-1800-1400/07/28,1,100,69500000,925,695,695,-230,-24.86,695,-230,-24.86,695,695
706,شتوكا,توكا رنگ فولاد سپاهان,1,202,10104242,51568,50021,50021,-1547,-3,51568,0,0,50021,50021
707,افاد2,منفعت دولتي2-شرايط خاص14000626,1,600,591000000,985000,985000,985000,0,0,985000,0,0,985000,985000
708,ضفار8047,اختيارخ فارس-5000-1400/08/05,1,10,37000000,3700,3700,3700,0,0,3700,0,0,3700,3700
709,قشهد,شهد,1,254,5034280,20430,19820,19820,-610,-2.99,20430,0,0,19820,19820
710,شفا,سرمايه گذاري شفادارو,1,111,5012760,46550,45160,45160,-1390,-2.99,46550,0,0,45160,45160
711,ثنوسا,نوسازي‌وساختمان‌تهران‌,1,500,6300000,12980,12600,12600,-380,-2.93,12980,0,0,12600,12600
712,ياقوت2,صندوق س ياقوت آگاه-ثابت,1,8000000,8000000,12344,1,1,-12343,-99.99,1,-12343,-99.99,1,1
713,اراد594,مرابحه عام دولتي5-ش.خ 0309,1,9500000,8879716500000,1000000,934707,934707,-65293,-6.53,934707,-65293,-6.53,934707,934707
714,خوساز,محورسازان‌ايران‌خودرو,1,650,5057000,8020,7780,7780,-240,-2.99,8020,0,0,7780,7780
715,ولشرق,ليزينگ ايران و شرق,1,610,5157550,8716,8455,8455,-261,-2.99,8716,0,0,8455,8455
716,اراد644,مرابحه عام دولتي64-ش.خ0111,1,10050000,9462075000000,944500,941500,941500,-3000,-0.32,941500,-3000,-0.32,941500,941500
717,خفنر,فنرسازي‌خاور,1,1200,10092000,8660,8410,8410,-250,-2.89,8660,0,0,8410,8410
718,سدور,سيمان‌ دورود,1,1000,18790000,19370,18790,18790,-580,-2.99,19370,0,0,18790,18790
719,زشگزا,شير و گوشت زاگرس شهركرد,1,2500,19967500,8233,7987,7987,-246,-2.99,8233,0,0,7987,7987
720,زشريف,كشت وصنعت شريف آباد,1,13800,69745200,5210,5054,5054,-156,-2.99,5210,0,0,5054,5054
721,ضصاد3002,اختيارخ وبصادر-2500-1400/03/12,1,20,1800000,80,90,90,10,12.5,90,10,12.5,90,90
722,نطرين,عطرين نخ قم,1,848,9975872,12127,11764,11764,-363,-2.99,12127,0,0,11764,11764
723,فنرژي,گسترش صنايع انرژي آذرآب,1,270,5023350,18984,18605,18605,-379,-2,18984,0,0,18605,18605
724,دقاضي,داروسازي شهيد قاضي,1,50,2119150,43247,42383,42383,-864,-2,43247,0,0,42383,42383
725,كي بي سي,شركت كي بي سي,1,200,5025000,25902,25125,25125,-777,-3,25902,0,0,25125,25125
726,هصيكو402,اختيارف ت تاصيكو13500-00/02/20,1,4530,16516380,3602,3646,3646,44,1.22,3646,44,1.22,3646,3646
727,كقزوي,شيشه‌ قزوين‌,1,2978,29890186,10241,10037,10037,-204,-1.99,10241,0,0,10037,10037
728,پاسا,ايران‌ياساتايرورابر,1,1100,28468000,26680,25880,25880,-800,-3,26680,0,0,25880,25880
729,اپرداز,آتيه داده پرداز,1,495,10239075,21324,20685,20685,-639,-3,21324,0,0,20685,20685
730,خشرق,الكتريك‌ خودرو شرق‌,1,4000,58000000,14940,14500,14500,-440,-2.95,14940,0,0,14500,14500
731,وصندوق2,سرمايه‌گذاري‌صندوق‌بازنشستگي‌,1,30000000,411900000000,14150,13730,13730,-420,-2.97,13730,-420,-2.97,13730,13730
732,تكشا,گسترش‌صنايع‌وخدمات‌كشاورزي‌,1,180,8110800,46450,45060,45060,-1390,-2.99,46450,0,0,45060,45060
733,فوكا,فولاد كاويان,1,1280,14919680,11893,11656,11656,-237,-1.99,11893,0,0,11656,11656
734,ضمخا7069,اختيارخ اخابر-18000-1400/07/28,1,4,1400000,356,350,350,-6,-1.69,350,-6,-1.69,350,350
735,ضپيك7039,اختيارخ تاپيكو-7000-00/07/18,1,20,66000000,3900,3300,3300,-600,-15.38,3300,-600,-15.38,3300,3300
736,دتوزيع,توزيع دارو پخش,1,105,5127570,50344,48834,48834,-1510,-3,50344,0,0,48834,48834
737,شزنگ,تجهيزنيروي‌زنگان‌,1,22,5056260,234520,229830,229830,-4690,-2,234519,-1,0,229830,229830
738,كتوكا,توليدي و خدمات صنايع نسوز توكا,1,24000,908328000,39017,37847,37847,-1170,-3,38995,-22,-0.06,37847,37847
739,سكرد,سيمان كردستان,1,2252,21394000,9790,9500,9500,-290,-2.96,9790,0,0,9500,9500
740,ضجار7038,اختيارخ وتجارت-1800-1400/07/21,1,1,720000,1,720,720,719,71900,720,719,71900,720,720
741,كباده,توليد خاك نسوزاستقلال آباده,1,3400,30657800,8755,9017,9017,262,2.99,8755,0,0,9017,9017
742,تملي703,تسهيلات مسكن ب. ملي-خرداد97,1,10,5518710,580916,551871,551871,-29045,-5,551871,-29045,-5,551871,551871
743,كپشير,پشم‌شيشه‌ايران‌,1,141,5467980,39970,38780,38780,-1190,-2.98,39970,0,0,38780,38780
744,پلاسك,پلاسكوكار,1,755,5473750,7470,7250,7250,-220,-2.95,7470,0,0,7250,7250
745,صگل1411,ص اجاره گل گهر 1411-3 ماهه 17%,1,10,10000000,995800,1000000,1000000,4200,0.42,1000000,4200,0.42,1000000,1000000
746,كمينا,شيشه سازي مينا,1,405,9960570,25095,24594,24594,-501,-2,25095,0,0,24594,24594
747,فن آوا,گروه فن آوا,1,340,6080900,18250,17885,17885,-365,-2,18250,0,0,17885,17885
748,ضترا3006,اختيارخ شتران-14000-1400/03/09,1,1,10000,88,10,10,-78,-88.64,10,-78,-88.64,10,10
749,شپارس,بين‌ المللي‌ محصولات‌  پارس‌,1,235,5080700,22280,21620,21620,-660,-2.96,22280,0,0,21620,21620
750,اراد51,مرابحه عام دولت5-ش.خ 0010,1,1000,1000000000,980000,1000000,1000000,20000,2.04,1000000,20000,2.04,1000000,1000000
751,اراد214,مرابحه عام دولت2ش.خ صادرات0212,1,8000000,7565016000000,1000000,945627,945627,-54373,-5.44,945627,-54373,-5.44,945627,945627
752,رايان106,مشاركت رايان سايپا-3ماهه16%,1,7335,7081150320,965392,965392,965392,0,0,965392,0,0,965392,965392
753,خكار,ايركا پارت صنعت,1,610,12968600,21910,21260,21260,-650,-2.97,21910,0,0,21260,21260
754,ضبدر3004,اختيارخ شبندر-24000-1400/03/30,1,3,1500000,1800,500,500,-1300,-72.22,500,-1300,-72.22,500,500
755,اوان,مبين وان كيش,1,410,21723440,54622,52984,52984,-1638,-3,54621,-1,0,52984,52984
756,ضترا3005,اختيارخ شتران-12000-1400/03/09,1,1,20000,500,20,20,-480,-96,20,-480,-96,20,20
757,كمند2,صندوق س. با درآمد ثابت كمند,1,110000000,110000000,10017,1,1,-10016,-99.99,1,-10016,-99.99,1,1
758,اعتماد4,صندوق س.اعتماد آفرين پارسيان-د,1,55000000,1997490000000,36305,36318,36318,13,0.04,36318,13,0.04,36318,36318
