,نماد,نام,تعداد,حجم,ارزش,دیروز,اولین,آخرین معامله - مقدار,آخرین معامله - تغییر,آخرین معامله - درصد,قیمت پایانی - مقدار,قیمت پایانی - تغییر,قیمت پایانی - درصد,کمترین,بیشترین
2,فتوسا,توليد و توسعه سرب روي ايرانيان,44079,1859465,22319158395,11432,12003,12003,571,4.99,12003,571,4.99,12003,12003
3,پالايش,صندوق پالايشي يکم-سهام,38783,60926994,4408154731470,73070,71650,71450,-1620,-2.22,72350,-720,-0.99,70500,74000
4,فگستر,گسترش صنايع روي ايرانيان,29939,893579,9959831534,10616,11146,11146,530,4.99,10920,304,2.86,11146,11146
5,سپيدار,سپيدار سيستم آسيا,23160,2264665,110454328949,47557,45180,49934,2377,5,48773,1216,2.56,45180,49934
6,چخزر,صنايع چوب خزر كاسپين,22521,7113874,239144246665,33220,31559,34881,1661,5,33617,397,1.2,31559,34881
7,غكورش,صنعت غذايي كورش,17962,2258989,82204609710,34660,36390,36390,1730,4.99,36390,1730,4.99,36390,36390
8,دارا يكم,صندوق واسطه گري مالي يكم-سهام,17885,14512368,1769850654770,124220,121210,120420,-3800,-3.06,121950,-2270,-1.83,120000,124700
9,شپنا,پالايش نفت اصفهان,14512,128649085,1383643627450,10730,10600,10640,-90,-0.84,10760,30,0.28,10460,11080
10,غزر,صنعتي زر ماكارون,12540,6609466,151689019620,23890,22810,22700,-1190,-4.98,22950,-940,-3.93,22700,23820
11,ثبهساز,بهساز كاشانه تهران,12272,141621517,251117647186,1730,1650,1816,86,4.97,1773,43,2.49,1650,1816
12,خساپا,سايپا,11728,449246318,683881158069,1581,1540,1517,-64,-4.05,1522,-59,-3.73,1502,1600
13,خودرو,ايران‌ خودرو,10005,290490707,489865784157,1740,1682,1672,-68,-3.91,1686,-54,-3.1,1654,1750
14,اپال,فرآوري معدني اپال كاني پارس,9855,11330892,222148495510,19320,19480,19590,270,1.4,19610,290,1.5,19230,19960
15,وبملت,بانك ملت,9545,242715802,892781450845,3825,3750,3634,-191,-4.99,3678,-147,-3.84,3634,3837
16,چكاپا,گروه صنايع كاغذ پارس,9414,141308205,575061350805,4271,4058,4103,-168,-3.93,4070,-201,-4.71,4058,4180
17,كزغال,زغال سنگ پروده طبس,8924,4427548,135040122868,30861,30200,30252,-609,-1.97,30500,-361,-1.17,29841,31400
18,فملي,ملي‌ صنايع‌ مس‌ ايران‌,8114,43272709,536264308830,12460,12260,12250,-210,-1.69,12390,-70,-0.56,12190,12750
19,ثاميد,توسعه و عمران اميد,7943,117761287,186830280359,1524,1539,1600,76,4.99,1587,63,4.13,1539,1600
20,شتران,پالايش نفت تهران,7508,64758633,514551947970,8080,7820,7840,-240,-2.97,7950,-130,-1.61,7680,8200
21,فولاد,فولاد مباركه اصفهان,7348,58977676,569295889040,9640,9520,9570,-70,-0.73,9650,10,0.1,9520,9800
22,امينح,ح . تامين سرمايه امين,6948,4627718,22033741390,5050,4840,4710,-340,-6.73,4760,-290,-5.74,4620,4940
23,شبندر,پالايش نفت بندرعباس,6763,37493900,788493427960,21750,21180,20710,-1040,-4.78,21030,-720,-3.31,20670,21880
24,شستا,سرمايه گذاري تامين اجتماعي,6616,28473539,288736835130,10330,10060,10050,-280,-2.71,10140,-190,-1.84,9970,10410
25,ولپارس,ليزينگ پارسيان,6569,17903664,72833888152,3902,3710,4097,195,5,4068,166,4.25,3710,4097
26,كاما,باما,6094,50810842,399029384370,8240,7830,7830,-410,-4.98,7850,-390,-4.73,7830,8190
27,پتاير,ايران‌ تاير,5603,120490000,324973839941,2691,2610,2825,134,4.98,2697,6,0.22,2560,2825
28,خبهمن,گروه‌بهمن‌,4208,220510827,235218610344,1115,1076,1060,-55,-4.93,1067,-48,-4.3,1060,1120
29,خگستر,گسترش‌سرمايه‌گذاري‌ايران‌خودرو,4079,141458700,260022271924,1908,1830,1813,-95,-4.98,1838,-70,-3.67,1813,1900
30,كرمان,س. توسعه و عمران استان كرمان,4066,113906421,110948585441,986,970,968,-18,-1.83,974,-12,-1.22,960,1000
31,بركت,گروه دارويي بركت,3987,11918146,326263278110,26190,27390,27490,1300,4.96,27380,1190,4.54,26710,27490
32,كوير,توليدي فولاد سپيد فراب كوير,3888,24258548,325534967800,13000,12970,13650,650,5,13420,420,3.23,12490,13650
33,غگل,گلوكوزان‌,3864,83251678,230170728855,2648,2601,2780,132,4.98,2765,117,4.42,2601,2780
34,بوعلي,پتروشيمي بوعلي سينا,3797,677439,29608004710,44590,43510,43630,-960,-2.15,44160,-430,-0.96,43460,44160
35,وكبهمن,مديريت سرمايه گذاري كوثربهمن,3796,862930,9273826627,10926,10651,10783,-143,-1.31,10818,-108,-0.99,10651,10950
36,وتجارت,بانك تجارت,3603,127459700,255465325453,2024,2043,2001,-23,-1.14,2004,-20,-0.99,1981,2043
37,آريا,پليمر آريا ساسول,3438,1105466,92611567341,83516,82521,83920,404,0.48,83737,221,0.26,82521,84220
38,وسپهر,سرمايه گذاري مالي سپهرصادرات,3314,7969926,72478974893,9096,9094,9095,-1,-0.01,9095,-1,-0.01,9094,9095
39,ذوب,سهامي ذوب آهن  اصفهان,3302,62820322,204575003902,3271,3212,3271,0,0,3257,-14,-0.43,3211,3316
40,وبيمه,سرمايه‌ گذاري‌ صنعت‌ بيمه‌,3234,83213899,157997458754,1846,1810,1938,92,4.98,1899,53,2.87,1758,1938
41,خمهر,مهركام‌پارس‌,2937,131450236,218900740226,2204,1605,1685,-519,-23.55,1665,-539,-24.46,1525,1685
42,پيزد,مجتمع صنايع لاستيك يزد,2897,555509,30797480115,53877,52010,56570,2693,5,55440,1563,2.9,52000,56570
43,كمند,صندوق س. با درآمد ثابت كمند,2819,109096721,1107249556410,10143,10149,10150,7,0.07,10149,6,0.06,10148,10150
44,پترول,گروه پتروشيمي س. ايرانيان,2800,12463855,104501890510,8570,8320,8310,-260,-3.03,8380,-190,-2.22,8210,8610
45,حكشتي,كشتيراني جمهوري اسلامي ايران,2733,10202136,128768814850,13090,12630,12550,-540,-4.13,12620,-470,-3.59,12440,13080
46,خودكفا,اقتصادي و خودكفايي آزادگان,2630,13268288,224513102789,16631,16133,17129,498,2.99,16921,290,1.74,16133,17129
47,وبصادر,بانك صادرات ايران,2600,61187435,112908784103,1896,1880,1822,-74,-3.9,1850,-46,-2.43,1810,1907
48,دفارا,داروسازي‌ فارابي‌,2598,3515814,177982718640,51490,48920,52190,700,1.36,50620,-870,-1.69,48920,53000
49,خصدرا,صنعتي‌ دريايي‌ ايران‌,2539,73740669,155008591138,2076,2014,2138,62,2.99,2102,26,1.25,2014,2138
50,ثاخت,بين‌المللي‌توسعه‌ساختمان,2523,51640791,99369335965,2014,1967,1914,-100,-4.97,1924,-90,-4.47,1914,2000
51,غگيلا,شيرپاستوريزه پگاه گيلان,2510,1815123,30421295684,17470,16900,16597,-873,-5,16760,-710,-4.06,16597,17100
52,شتوكا,توكا رنگ فولاد سپاهان,2447,4894039,160267896429,32149,33756,31110,-1039,-3.23,32748,599,1.86,30690,33756
53,سيتا,سرمايه گذاري سيمان تامين,2425,4198954,62986654130,15000,15000,15000,0,0,15000,0,0,15000,15020
54,شگويا,پتروشيمي تندگويان,2392,11591804,97464729612,8625,8600,8313,-312,-3.62,8408,-217,-2.52,8201,8720
55,امين,تامين سرمايه امين,2375,1183672,8417246260,7110,7110,7120,10,0.14,7110,0,0,7110,7120
56,ماديرا,صنايع ماشين هاي اداري ايران,2322,16004996,115742456405,7261,7300,7210,-51,-0.7,7232,-29,-0.4,7040,7480
57,امين يكم,صندوق درآمد ثابت امين يكم فردا,2258,59040952,594445180378,10063,10065,10069,6,0.06,10068,5,0.05,10064,10071
58,گشان,توسعه بين المللي پديده شانديز,2211,6644654,143581889113,21214,20891,21638,424,2,21609,395,1.86,20890,21638
59,فارس,صنايع پتروشيمي خليج فارس,2143,24573339,234714579250,9480,9800,9380,-100,-1.05,9550,70,0.74,9290,9800
60,ودي,بيمه  دي,2057,9171348,177400481760,19134,19227,19300,166,0.87,19343,209,1.09,18800,19599
61,وپاسار,بانك  پاسارگاد,2017,31183022,493602575200,15820,15820,15830,10,0.06,15830,10,0.06,15820,15850
62,تسه0002,امتيازتسهيلاتمسكن ارديبهشت1400,1986,62137,33397145617,547000,551000,527992,-19008,-3.47,537476,-9524,-1.74,520000,559988
63,غپينو,پارس‌ مينو,1969,23981248,147414932370,5870,5900,6140,270,4.6,6150,280,4.77,5870,6160
64,اعتماد,صندوق س.اعتماد آفرين پارسيان-د,1964,43289500,1590085966660,36713,36730,36731,18,0.05,36731,18,0.05,36729,36734
65,خزاميا,زامياد,1962,27824759,152928479420,5760,5480,5480,-280,-4.86,5500,-260,-4.51,5480,5650
66,دانا,بيمه دانا,1957,18713490,89447792980,4970,5020,4740,-230,-4.63,4780,-190,-3.82,4730,5030
67,وتوكا,سرمايه‌گذاري‌توكافولاد(هلدينگ,1930,11636723,96717843730,8300,7900,8540,240,2.89,8310,10,0.12,7890,8700
68,بترانس,ايران‌ ترانسفو,1861,37138039,78937513541,2211,2130,2124,-87,-3.93,2126,-85,-3.84,2101,2225
69,وخارزم,سرمايه گذاري خوارزمي,1825,20847344,78837225443,3888,3810,3724,-164,-4.22,3782,-106,-2.73,3700,3890
70,كيان,صندوق س. با درآمد ثابت كيان,1825,26741323,766706107431,28655,28659,28672,17,0.06,28671,16,0.06,28659,28676
71,وپارس,بانك‌پارسيان‌,1822,46573572,132120674688,2823,2849,2840,17,0.6,2837,14,0.5,2817,2849
72,غسالم,سالمين‌,1729,18951234,64585254594,3402,3400,3362,-40,-1.18,3408,6,0.18,3271,3552
73,وغدير,سرمايه‌گذاري‌غدير(هلدينگ‌,1710,11036805,113371864250,10320,10070,10250,-70,-0.68,10280,-40,-0.39,10070,10390
74,وخارزمح,ح.سرمايه گذاري خوارزمي,1696,10417410,25399988830,2663,2660,2430,-233,-8.75,2438,-225,-8.45,2397,2660
75,وپست,پست بانك ايران,1607,7690750,177892068980,22750,22930,22830,80,0.35,23130,380,1.67,22400,23580
76,بگيلان,توسعه مسير برق گيلان,1585,265032,4808745760,18219,18190,18240,21,0.12,18207,-12,-0.07,17880,18499
77,نوري,پتروشيمي نوري,1546,1740043,109249794820,62720,62990,62480,-240,-0.38,62790,70,0.11,60010,64200
78,فخوز,فولاد  خوزستان,1537,6724742,105091463900,15590,15300,15480,-110,-0.71,15620,30,0.19,15300,15850
79,ثتران,سرمايه گذاري مسكن تهران,1527,24063656,73491201293,3100,3139,2945,-155,-5,3054,-46,-1.48,2945,3229
80,بكهنوج,توليد برق ماهتاب كهنوج,1526,37942759,50026914847,1379,1375,1307,-72,-5.22,1318,-61,-4.42,1307,1390
81,كاذر,فرآورده‌هاي‌نسوزآذر,1482,6105520,88403214250,15020,14500,14270,-750,-4.99,14480,-540,-3.6,14270,15110
82,قاسم,قاسم ايران,1463,12906990,126778209024,10330,9814,9814,-516,-5,9822,-508,-4.92,9814,10100
83,آريان,سرمايه گذاري پارس آريان,1314,20630250,230824924829,10946,11090,11000,54,0.49,11189,243,2.22,10623,11274
84,دماوند,توليد نيروي برق دماوند,1301,9698506,298146982206,30479,28956,30750,271,0.89,30742,263,0.86,28956,30750
85,بپيوند,برق و انرژي پيوندگستر پارس,1273,1650105,17077703427,10035,9605,10536,501,4.99,10349,314,3.13,9605,10536
86,ونوين,بانك‌اقتصادنوين‌,1266,20137437,83920756268,4132,4090,4135,3,0.07,4167,35,0.85,4001,4230
87,كلوند,كاشي‌ الوند,1207,2330759,44191484840,19590,20000,18620,-970,-4.95,18960,-630,-3.22,18620,20000
88,ستران,سيمان‌ تهران‌,1201,3872486,70320660470,18940,18000,18000,-940,-4.96,18160,-780,-4.12,18000,18700
89,نوين,بيمه نوين,1164,8917264,46837669812,5295,5150,5240,-55,-1.04,5252,-43,-0.81,5150,5417
90,وسلرستا,شركت س استان لرستان,1161,61469465,34749194487,558,541,585,27,4.84,565,7,1.25,536,585
91,صبا,سرمايه گذاري صبا تامين,1149,2991008,21108388181,7205,7050,7090,-115,-1.6,7179,-26,-0.36,7000,7190
92,قرن,پديده شيمي قرن,1136,1937138,62312872330,31400,31550,32500,1100,3.5,32170,770,2.45,31510,32550
93,ولساپا,ليزينگ رايان‌ سايپا,1122,23346577,59845041414,2651,2650,2519,-132,-4.98,2563,-88,-3.32,2519,2679
94,ساوه,سيمان ساوه,1110,471721,19196369207,41255,39710,40183,-1072,-2.6,40694,-561,-1.36,39710,41900
95,درهآور,دارويي ره آورد تامين,1109,2505266,63253038213,26148,26700,25030,-1118,-4.28,25248,-900,-3.44,24841,26720
96,حتايد,تايدواترخاورميانه,1079,5570289,143745142130,24790,25150,25820,1030,4.15,25810,1020,4.11,25000,26020
97,شبريز,پالايش نفت تبريز,1072,3552115,87093112480,25070,24500,24300,-770,-3.07,24580,-490,-1.95,24080,25250
98,وساخت,سرمايه‌ گذاري‌ ساختمان‌ايران‌,1057,2535162,117528713630,44420,45000,46640,2220,5,46360,1940,4.37,44300,46640
99,ونيرو,سرمايه‌گذاري‌نيرو,1053,19963866,43173296835,2272,2160,2159,-113,-4.97,2163,-109,-4.8,2159,2210
100,سدور,سيمان‌ دورود,1042,7111943,56349113310,8290,8100,7880,-410,-4.95,7920,-370,-4.46,7880,8240
101,وبانك,سرمايه گذاري گروه توسعه ملي,1037,6358243,43993564370,7130,6900,6850,-280,-3.93,7010,-120,-1.68,6800,7150
102,فوكا,فولاد كاويان,1035,9171817,112569344068,11950,11650,12308,358,3,12273,323,2.7,11650,12308
103,حفاري,حفاري شمال,1024,10809728,63042974940,5860,5720,5840,-20,-0.34,5830,-30,-0.51,5700,5960
104,غگرجي,بيسكويت‌  گرجي‌,1022,4483604,54835353770,12220,12300,12280,60,0.49,12230,10,0.08,12170,12440
105,تملت,تامين سرمايه بانك ملت,1007,5616440,23471961996,4288,4288,4111,-177,-4.13,4179,-109,-2.54,4074,4299
106,كگلح,ح . معدني و صنعتي گل گهر,997,3519934,39776994590,11260,11020,11360,100,0.89,11300,40,0.36,11020,11480
107,سرو,صندوق س سروسودمند مدبران-سهام,995,804427,47406561060,59420,58210,58770,-650,-1.09,58930,-490,-0.82,58210,59980
108,ساراب,سيمان‌ داراب‌,989,2940366,56012800750,18960,18970,19180,220,1.16,19050,90,0.47,18500,19330
109,شكربن,كربن‌ ايران‌,985,1267412,96582702690,72950,75000,76590,3640,4.99,76200,3250,4.46,73250,76590
110,وساپا,سرمايه‌گذاري‌ سايپا,981,15053544,60749068511,4101,4010,4099,-2,-0.05,4036,-65,-1.58,3961,4200
111,ومعادنح,ح . توسعه‌معادن‌وفلزات‌,959,6429204,37821758690,5870,5790,5810,-60,-1.02,5880,10,0.17,5740,5940
112,گكوثر,هتل پارسيان كوثر اصفهان,959,26999053,54589944047,1949,1902,2046,97,4.98,2022,73,3.75,1902,2046
113,وسگيلا,شركت س استان گيلان,953,66431848,42915099214,626,595,657,31,4.95,646,20,3.19,595,657
114,غمينو,شركت صنايع غذايي مينو شرق,949,6854341,58831799785,8976,8560,8610,-366,-4.08,8583,-393,-4.38,8528,8976
115,فروس,فروسيليس‌ ايران‌,947,9618221,49226569739,5267,5030,5180,-87,-1.65,5118,-149,-2.83,5030,5199
116,كچاد,معدني‌وصنعتي‌چادرملو,937,3553756,81843554890,23070,23160,22900,-170,-0.74,23040,-30,-0.13,22740,23500
117,پكوير,كوير تاير,936,4225640,47285814400,11450,11110,11600,150,1.31,11190,-260,-2.27,10880,11600
118,ختوقا,قطعات‌ اتومبيل‌ ايران‌,916,18460373,31956645636,1812,1724,1722,-90,-4.97,1731,-81,-4.47,1722,1800
119,سرچشمه,سرمايه گذاري مس سرچشمه,914,4401808,30858280072,6871,7000,7000,129,1.88,7010,139,2.02,6851,7077
120,سمايه,بانك سرمايه,908,6827795,28948329487,4313,4191,4184,-129,-2.99,4240,-73,-1.69,4184,4388
121,سفارس,سيمان فارس و خوزستان,884,4535498,73582172190,15960,16090,16250,290,1.82,16220,260,1.63,15940,16500
122,آرمان,بيمه آرمان,876,14352406,104759267283,7496,7272,7480,-16,-0.21,7299,-197,-2.63,7272,7610
123,لوتوس,تامين سرمايه لوتوس پارسيان,875,8894014,64116157210,7000,7350,7180,180,2.57,7210,210,3,7030,7350
124,شلرد,كود شيميايي اوره لردگان,864,9472223,51849885049,5590,5430,5520,-70,-1.25,5474,-116,-2.08,5423,5660
125,لسرما,سرما آفرين‌,846,1669022,35462625920,20770,20120,21200,430,2.07,21250,480,2.31,20120,21780
126,اخابر,مخابرات ايران,845,4710224,33697808520,7420,7130,7150,-270,-3.64,7340,-80,-1.08,7070,7390
127,شغدير,پتروشيمي غدير,836,1296652,92301326710,70710,70030,71800,1090,1.54,71180,470,0.66,70030,71890
128,تاپيكو,س. نفت و گاز و پتروشيمي تأمين,833,7784508,79580790090,10350,10050,10130,-220,-2.13,10270,-80,-0.77,10050,10450
129,تسه0001,امتيازتسهيلات مسكن فروردين1400,820,10675,5793175499,551444,552000,530001,-21443,-3.89,542686,-8758,-1.59,530001,570000
130,وتوصا,گروه س توسعه صنعتي ايران,815,3846276,31165516900,8220,8130,7980,-240,-2.92,8100,-120,-1.46,7970,8290
131,دكوثر,داروسازي‌ كوثر,810,9924559,45483378286,4397,4550,4616,219,4.98,4583,186,4.23,4440,4616
132,ولبهمن,شركت بهمن ليزينگ,804,6637098,39110739819,6193,5901,5884,-309,-4.99,5893,-300,-4.84,5884,6050
133,بجهرم,توسعه مولد نيروگاهي جهرم,798,14389254,28825082116,2040,1950,2024,-16,-0.78,2003,-37,-1.81,1950,2050
134,وسينا,بانك سينا,794,27024518,62159949940,2404,2340,2320,-84,-3.49,2300,-104,-4.33,2284,2390
135,ومعادن,توسعه‌معادن‌وفلزات‌,792,5785262,47206915760,8220,8030,8080,-140,-1.7,8200,-20,-0.24,8030,8330
136,ميدكو,هلدينگ صنايع  معدني خاورميانه,791,5983995,246260336371,41150,41150,41151,1,0,41153,3,0.01,41148,41280
137,سصوفي,سيمان‌ صوفيان‌,786,2875670,33381466430,11620,11210,11320,-300,-2.58,11610,-10,-0.09,11140,12080
138,افران,صندوق س افرا نماد پايدار-ثابت,771,19063988,256092734058,13422,13430,13435,13,0.1,13433,11,0.08,13430,13436
139,رمپنا,گروه مپنا (سهامي عام),770,4802415,58269572750,12490,12490,11950,-540,-4.32,12310,-180,-1.44,11880,12510
140,والبر,سرمايه‌ گذاري‌ البرز(هلدينگ‌,768,4729089,61852081740,12470,12500,13090,620,4.97,13080,610,4.89,12500,13090
141,رتاپ,تجارت الكترونيك  پارسيان,747,3573143,19701553570,5530,5520,5450,-80,-1.45,5510,-20,-0.36,5400,5610
142,فجر,فولاد اميركبيركاشان,745,3916693,93811697310,22980,23200,24120,1140,4.96,23950,970,4.22,23190,24120
143,آگاس,صندوق س.هستي بخش آگاه-س,745,673000,42864668654,64313,63699,63442,-871,-1.35,63692,-621,-0.97,63300,64731
144,شفارا,پتروشيمي فارابي,739,10673243,34749321218,3253,3350,3257,4,0.12,3256,3,0.09,3156,3350
145,آسيا,بيمه آسيا,733,17393086,29296609524,1730,1690,1704,-26,-1.5,1684,-46,-2.66,1661,1728
146,فاسمين,كالسيمين‌,730,3861967,55087640380,14320,13910,14310,-10,-0.07,14260,-60,-0.42,13910,14500
147,دروز,داروسازي‌ روزدارو,728,2492220,77844992160,30160,28660,31660,1500,4.97,31240,1080,3.58,28660,31660
148,پارند,صندوق س. پارند پايدار سپهر,723,24369465,275833590584,11313,11319,11319,6,0.05,11319,6,0.05,11318,11328
149,وبوعلي,سرمايه‌گذاري‌بوعلي‌,720,5039442,19477325962,3810,3880,3869,59,1.55,3865,55,1.44,3794,3970
150,سپ,پرداخت الكترونيك سامان كيش,717,1347767,33199735190,23930,25100,25000,1070,4.47,24400,470,1.96,24000,25100
151,سبزوا,سيمان لار سبزوار,712,9560294,25649801504,2822,2681,2681,-141,-5,2683,-139,-4.93,2681,2790
152,فرآور,فرآوري‌موادمعدني‌ايران‌,705,2247345,56481935940,26350,25300,25040,-1310,-4.97,25130,-1220,-4.63,25040,26290
153,شپترو,پتروشيمي آبادان,702,13314713,53659149315,4150,4031,4026,-124,-2.99,4030,-120,-2.89,4026,4131
154,شنفت,نفت‌ پارس‌,699,1303461,64396586500,47450,49170,49820,2370,4.99,49400,1950,4.11,47750,49820
155,شبصير,توليدات پتروشيمي قائد بصير,678,1165145,96562688011,79140,77260,83097,3957,5,82876,3736,4.72,77260,83097
156,دتماد,توليدمواداوليه‌داروپخش‌,673,1990882,74065751490,38590,37400,37490,-1100,-2.85,37200,-1390,-3.6,36760,39980
157,زاگرس,پتروشيمي زاگرس,672,459653,97497359733,211535,210000,212110,575,0.27,212079,544,0.26,210000,214260
158,فنوال,نورد آلومينيوم‌,660,1580907,40268604960,24440,25120,25660,1220,4.99,25470,1030,4.21,24460,25660
159,وپترو,سرمايه‌گذاري صنايع پتروشيمي‌,653,1946506,22985198580,11870,12110,11720,-150,-1.26,11810,-60,-0.51,11330,12370
160,كهمدا,شيشه‌ همدان‌,652,4850018,41112311310,8890,8560,8500,-390,-4.39,8480,-410,-4.61,8450,8790
161,دكيمي,كيميدارو,647,2194779,43734795820,20830,19790,19790,-1040,-4.99,19930,-900,-4.32,19790,20730
162,شيران,س. صنايع‌شيميايي‌ايران,643,1448615,28718727980,20240,19560,19730,-510,-2.52,20080,-160,-0.79,19510,20350
163,ومهان,گروه توسعه مالي مهر آيندگان,641,3101764,37612428236,12155,11911,12300,145,1.19,12133,-22,-0.18,11812,12349
164,وملي,گروه‌ صنعتي‌ ملي‌ (هلدينگ‌,630,313027,41163922190,138400,131480,131480,-6920,-5,131500,-6900,-4.99,131480,135000
165,كگل,معدني و صنعتي گل گهر,629,3114942,45158282600,14520,14240,14380,-140,-0.96,14510,-10,-0.07,14100,14620
166,كاوه,فولاد كاوه جنوب كيش,624,2312044,42480370700,18680,18050,18330,-350,-1.87,18560,-120,-0.64,18010,18780
167,ضخود7075,اختيارخ خودرو-2000-1400/07/07,611,25023,3808579000,164,150,148,-16,-9.76,152,-12,-7.32,142,170
168,ساروم,سيمان‌اروميه‌,593,1250261,31990961380,25670,25000,25530,-140,-0.55,25590,-80,-0.31,25000,26350
169,ضسپا3002,اختيارخ خساپا-1800-1400/03/26,590,32188,647067000,33,22,14,-19,-57.58,20,-13,-39.39,14,33
170,فمراد,آلومراد,578,195314,14716430900,76610,77000,74250,-2360,-3.08,75350,-1260,-1.64,73790,79500
171,هشستا103,اختيارف ت شستا-11688-01/03/08,572,2645644,2645644,1,1,1,0,0,1,0,0,1,1
172,كفپارس,فرآورده‌هاي‌ نسوز پارس‌,566,6789453,18283203219,2810,2770,2670,-140,-4.98,2693,-117,-4.16,2670,2800
173,پارسان,گسترش نفت و گاز پارسيان,553,8219577,147847290220,18390,17590,18000,-390,-2.12,17990,-400,-2.18,17590,18370
174,تاصيكو,سرمايه گذاري صدرتامين,549,3877739,36364287130,9710,9360,9390,-320,-3.3,9610,-100,-1.03,9320,9640
175,خكرمان,گروه اقتصادي كرمان خودرو,548,5710948,16766992143,2944,2974,2900,-44,-1.49,2936,-8,-0.27,2880,2985
176,حرهشا,رهشاد سپاهان (سهامي عام,547,413967,24808225030,59310,58126,60496,1186,2,59928,618,1.04,58126,60496
177,ورنا,سرمايه‌گذاري‌ رنا(هلدينگ‌,547,9254804,37498751662,4241,4250,4075,-166,-3.91,4052,-189,-4.46,4029,4250
178,وسبحان,سرمايه گذاري سبحان,541,15657215,35997184570,2329,2231,2300,-29,-1.25,2299,-30,-1.29,2231,2344
179,سهگمت,سيمان‌هگمتان‌,540,2284477,44470259710,19310,18520,19340,30,0.16,19470,160,0.83,18520,19810
180,شپديس,پتروشيمي پرديس,534,1217572,119092165190,98030,96800,97930,-100,-0.1,97810,-220,-0.22,96500,98990
181,البرز,بيمه البرز,533,7175397,26309375325,3669,3530,3660,-9,-0.25,3667,-2,-0.05,3530,3765
182,شاراك,پتروشيمي شازند,532,1566819,41793541210,26770,26200,26430,-340,-1.27,26720,-50,-0.19,26200,27000
183,فپنتا,سپنتا,531,196828,76262431580,369780,388260,370000,220,0.06,387460,17680,4.78,369780,388260
184,ثمسكن,سرمايه‌گذاري‌ مسكن‌,530,8501799,34539692947,4241,4041,4029,-212,-5,4063,-178,-4.2,4029,4230
185,كرماشا,صنايع پتروشيمي كرمانشاه,520,798364,23547248360,28610,28590,29350,740,2.59,29110,500,1.75,28200,30000
186,ونيكي,سرمايه‌گذاري‌ ملي‌ايران‌,519,2041563,15935366780,8060,7700,7800,-260,-3.23,7990,-70,-0.87,7700,8000
187,وصنعت,سرمايه گذاري توسعه صنعت وتجارت,517,4020580,21969845280,5480,5390,5510,30,0.55,5460,-20,-0.36,5300,5570
188,آوا,صندوق س.سهام آواي معيار-س,511,3703164,23483202091,6418,6350,6280,-138,-2.15,6341,-77,-1.2,6280,6435
189,خمحركه,نيرو محركه‌,496,7258932,23580304749,3417,3247,3247,-170,-4.98,3248,-169,-4.95,3247,3333
190,سبجنو,سيمان‌ بجنورد,485,1299490,41116682600,30550,30350,32070,1520,4.98,31640,1090,3.57,30350,32070
191,قشرين,قند شيرين خراسان,466,2603778,31530331294,12464,12100,12098,-366,-2.94,12109,-355,-2.85,12091,12299
192,وسكاب,س.ص.بازنشستگي كاركنان بانكها,466,2704401,12901708009,4766,4843,4800,34,0.71,4770,4,0.08,4661,4843
193,خاور,ايران خودرو ديزل,464,7312021,32695886572,4348,4478,4478,130,2.99,4472,124,2.85,4390,4478
194,تسه9912,امتياز تسهيلات مسكن اسفند99,457,6595,3615367028,550620,557000,530000,-20620,-3.74,548198,-2422,-0.44,525000,577192
195,وسخوز,شركت س استان خوزستان,457,21140782,17786135633,885,841,841,-44,-4.97,876,-9,-1.02,841,850
196,طلا,صندوق س.پشتوانه طلاي لوتوس,453,232451,17936184817,75948,77400,77280,1332,1.75,77161,1213,1.6,76840,77400
197,حخزر,كشتيراني درياي خزر,451,1059515,22057715335,21175,20145,21501,326,1.54,20819,-356,-1.68,20117,21678
198,بپاس,بيمه پاسارگاد,450,529407,51899986441,98025,98025,98033,8,0.01,98030,5,0.01,98025,98100
199,وملل,اعتباري ملل,449,14623409,187198937350,12773,12801,12802,29,0.23,12801,28,0.22,12801,12850
200,پاكشو,گروه صنعتي پاكشو,448,2339903,13172565940,5900,5650,5660,-240,-4.07,5870,-30,-0.51,5610,5770
201,شبهرن,نفت‌ بهران‌,444,1198845,12898430510,10810,10800,10630,-180,-1.67,10800,-10,-0.09,10550,10910
202,بميلا,توسعه بازرگاني آهن وفولادميلاد,442,1898152,22004547434,11670,11980,11395,-275,-2.36,11593,-77,-0.66,11351,11980
203,هرمز,فولاد هرمزگان جنوب,440,2193181,34619719735,15886,15300,15650,-236,-1.49,15858,-28,-0.18,15300,15990
204,فايرا,آلومينيوم‌ايران‌,437,924318,15931799090,18010,17110,17300,-710,-3.94,17820,-190,-1.05,17110,17850
205,وشهر,بانك شهر,437,4560670,23138836994,5041,5150,5043,2,0.04,5065,24,0.48,5041,5200
206,تسه9908,امتياز تسهيلات مسكن آبان99,430,8439,4598030576,547355,526111,531500,-15855,-2.9,544855,-2500,-0.46,520800,569990
207,شفن,پتروشيمي فناوران,427,108261,31874728120,287050,297000,295200,8150,2.84,289280,2230,0.78,290570,297450
208,غشوكو,شوكو پارس,425,1518396,37347503724,25356,24596,24596,-760,-3,24597,-759,-2.99,24596,25333
209,كفرا,فراورده‌ هاي‌ نسوزايران‌,421,1282961,23918840030,19610,18630,18670,-940,-4.79,18640,-970,-4.95,18630,19430
210,سخوز,سيمان خوزستان,420,1452746,28787878170,19750,19950,19500,-250,-1.27,19820,70,0.35,19500,20330
211,كي بي سي,شركت كي بي سي,418,1180980,26841095282,23880,22686,22686,-1194,-5,22728,-1152,-4.82,22686,23470
212,ضخود7074,اختيارخ خودرو-1800-1400/07/07,404,16596,3748368000,236,220,207,-29,-12.29,226,-10,-4.24,200,259
213,پخش,پخش البرز,403,1644762,31100348663,19119,19182,18223,-896,-4.69,18909,-210,-1.1,18223,19240
214,شرانل,نفت ايرانول,400,570135,24278295013,43344,43000,42950,-394,-0.91,42802,-542,-1.25,41650,43190
215,ما,بيمه  ما,399,2764189,24264595750,8680,9040,9000,320,3.69,8780,100,1.15,8690,9040
216,گوهران,سرمايه گذاري توسعه گوهران اميد,399,994834,7077342657,7065,7065,7095,30,0.42,7088,23,0.33,7065,7195
217,ارفع,شركت آهن و فولاد ارفع,392,1484028,18782799732,12930,12900,12690,-240,-1.86,12845,-85,-0.66,12430,12900
218,خاذين,سايپاآذين‌,392,7032545,19273178974,2882,2742,2738,-144,-5,2741,-141,-4.89,2738,2799
219,وهور,مديريت انرژي اميد  تابان هور,382,9452777,16623719049,1849,1763,1757,-92,-4.98,1817,-32,-1.73,1757,1793
220,ارزش,صندوق س ارزش آفرين بيدار-سهام,379,2186330,18191860760,8470,8290,8240,-230,-2.72,8320,-150,-1.77,8240,8460
221,افق,فروشگاههاي زنجيره اي افق كوروش,378,413052,27053126800,66680,65990,65830,-850,-1.27,66270,-410,-0.61,64530,66500
222,وصنا,گروه‌صنايع‌بهشهرايران‌,376,2805777,13028863230,4692,4530,4620,-72,-1.53,4652,-40,-0.85,4460,4776
223,كروي,توسعه‌ معادن‌ روي‌ ايران‌,372,821362,16610063740,21060,20220,20010,-1050,-4.99,20350,-710,-3.37,20010,20970
224,سيستم,همكاران سيستم,370,522686,11855281540,22110,22100,22860,750,3.39,22500,390,1.76,21110,22990
225,رانفور,خدمات‌انفورماتيك‌,367,3237195,19031281590,5980,5820,5910,-70,-1.17,5950,-30,-0.5,5760,5980
226,وصندوق,سرمايه‌گذاري‌صندوق‌بازنشستگي‌,367,4044992,52197476460,12900,12600,12780,-120,-0.93,12900,0,0,12600,13130
227,شسپا,نفت سپاهان,366,1177522,16651492920,14330,13710,14050,-280,-1.95,14270,-60,-0.42,13710,14330
228,دسبحان,سبحان دارو,366,1285931,19125378660,15080,15080,14330,-750,-4.97,14870,-210,-1.39,14330,15830
229,ولملت,واسپاري ملت,343,2545740,11769317831,4593,4643,4740,147,3.2,4617,24,0.52,4410,4800
230,سشرق,سيمان‌ شرق‌,342,3361312,18040197200,5410,5510,5390,-20,-0.37,5370,-40,-0.74,5260,5510
231,واميد,گروه مديريت سرمايه گذاري اميد,339,2402860,23233186060,10050,9550,9560,-490,-4.88,9970,-80,-0.8,9550,10000
232,سخزر,سيمان‌ خزر,336,1070631,18663839660,17680,16810,17420,-260,-1.47,17430,-250,-1.41,16810,18560
233,ضخود7077,اختيارخ خودرو-3000-1400/07/07,333,22177,673932000,32,30,31,-1,-3.13,30,-2,-6.25,29,34
234,فنورد,نوردوقطعات‌ فولادي‌,325,90081,13964232280,154150,151000,155900,1750,1.14,154910,760,0.49,151000,156370
235,وثنو,سرمايه گذاري ساختماني نوين,324,3946555,16248846194,4007,3911,4127,120,2.99,4117,110,2.75,3911,4127
236,فردا,صندوق س آواي فرداي زاگرس-ثابت,323,12539804,135266649829,10781,10787,10787,6,0.06,10787,6,0.06,10786,10788
237,پارس,پتروشيمي پارس,318,284731,42526367170,148990,150000,148940,-50,-0.03,149140,150,0.1,148500,151380
238,ياقوت,صندوق س ياقوت آگاه-ثابت,314,1477068,18317360060,12394,12422,12399,5,0.04,12401,7,0.06,12398,12429
239,غمارگ,مارگارين‌,310,857354,15174425330,17890,18400,17760,-130,-0.73,17700,-190,-1.06,17410,18400
240,حسينا,توسعه خدمات دريايي وبندري سينا,308,448163,24496635233,54358,53500,55000,642,1.18,54660,302,0.56,52510,55960
241,همراه,شركت ارتباطات سيار ايران,305,832835,15857306610,19410,19230,19030,-380,-1.96,19350,-60,-0.31,18800,19600
242,مداران,داده‌پردازي‌ايران‌,304,954337,15420467510,16910,16300,16090,-820,-4.85,16160,-750,-4.44,16070,16720
243,خريخت,صنايع‌ريخته‌گري‌ايران‌,300,5070320,11195407866,2322,2250,2206,-116,-5,2237,-85,-3.66,2206,2275
244,تسه9911,امتياز تسهيلات مسكن بهمن99,297,3753,2067553481,547937,541590,540000,-7937,-1.45,550907,2970,0.54,532111,569999
245,سمازن,سيمان‌مازندران‌,296,1010433,10460983130,10540,10110,10420,-120,-1.14,10400,-140,-1.33,10110,10640
246,واعتبار,سرمايه گذاري اعتبار ايران,296,1412672,10562977990,7510,7200,7690,180,2.4,7490,-20,-0.27,7200,7720
247,آكورد,صندوق س. آرمان آتي كوثر-د,294,3350969,108446378566,32347,32363,32363,16,0.05,32363,16,0.05,32362,32367
248,كمنگنز,معادن‌منگنزايران‌,293,190352,12009162960,66360,63050,63050,-3310,-4.99,63250,-3110,-4.69,63050,65000
249,سشمال,سيمان‌ شمال‌,292,1582347,12794485210,8120,8490,7990,-130,-1.6,8090,-30,-0.37,7850,8490
250,فسپا,گروه‌صنعتي‌سپاهان‌,283,417682,14659004700,35190,34200,35050,-140,-0.4,35100,-90,-0.26,34200,35500
251,مدير,ص.س.مديريت ثروت ص.بازنشستگي-س,281,1268844,9811785680,7737,7669,7671,-66,-0.85,7733,-4,-0.05,7629,7800
252,اتكاي,بيمه اتكايي ايرانيان,280,757426,9966412926,13786,13725,13097,-689,-5,13489,-297,-2.15,13097,13740
253,خلنت,لنت‌ ترمزايران‌,276,82004,4479486790,56970,54130,54130,-2840,-4.99,56180,-790,-1.39,54130,56880
254,سحرخيز,صندوق س. گروه زعفران سحرخيز,271,1154476,9823872780,8443,8442,8745,302,3.58,8509,66,0.78,8380,8746
255,سيدكو,سرمايه گذاري توسعه صنايع سيمان,269,1959058,10289883860,5310,5080,5230,-80,-1.51,5260,-50,-0.94,5080,5400
256,سقاين,سيمان‌ قائن‌,265,184396,9060587820,51020,48650,48490,-2530,-4.96,49810,-1210,-2.37,48490,52350
257,سكه0012پ01,سكه تمام بهارتحويلي 1روزه رفاه,263,107100,115678480800,1061940,1078000,1082000,20060,1.89,1080098,18158,1.71,1072200,1083500
258,وكار,بانك‌ كارآفرين‌,261,2062344,5671825941,2763,2675,2761,-2,-0.07,2761,-2,-0.07,2671,2790
259,شپلي,پلي اكريل ايران,255,2353313,24495635017,10205,10409,10409,204,2,10409,204,2,10409,10409
260,سامان,بانك سامان,254,2099981,18979150577,9308,9240,9029,-279,-3,9185,-123,-1.32,9029,9240
261,بزاگرس,نيروگاه زاگرس كوثر,251,5763347,32895733510,7101,6746,5500,-1601,-22.55,5708,-1393,-19.62,5500,6746
262,تصميم,صندوق س با درآمد ثابت تصميم,251,1773530,29191880157,16449,16462,16463,14,0.09,16460,11,0.07,16456,16463
263,جم,پتروشيمي جم,243,403843,14377150050,35240,36770,35230,-10,-0.03,35290,50,0.14,35230,36770
264,عيار,صندوق س. پشتوانه طلاي مفيد,243,241820,6592265582,26915,27280,27202,287,1.07,27261,346,1.29,27126,27478
265,ونفت,سرمايه‌گذاري‌ صنعت‌ نفت‌,242,438525,5583675570,13060,12600,12710,-350,-2.68,12930,-130,-1,12510,13190
266,فسازان,غلتك سازان سپاهان,242,509084,14080420290,28210,27600,28000,-210,-0.74,27690,-520,-1.84,26950,28990
267,پرداخت,به پرداخت ملت,242,305851,6558944730,20780,20600,21600,820,3.95,20950,170,0.82,20600,21800
268,وگردش,بانك گردشگري,241,1444328,20524515489,14474,14070,14040,-434,-3,14411,-63,-0.44,14040,14646
269,تسه9910,امتياز تسهيلات مسكن دي99,240,4090,2276990131,555050,560000,582699,27649,4.98,556721,1671,0.3,527298,582800
270,واميدح,ح.گروه مديريت سرمايه گذار اميد,236,1746257,12831272620,7570,7360,7400,-170,-2.25,7350,-220,-2.91,7210,7560
271,ضسپا3003,اختيارخ خساپا-2000-1400/03/26,232,14283,52873000,8,9,3,-5,-62.5,4,-4,-50,2,9
272,كگهر,سنگ آهن گهرزمين,231,226025,8611802543,39844,37853,38120,-1724,-4.33,39710,-134,-0.34,37852,38984
273,دسينا,داروسازي‌ سينا,230,412576,7393527330,18620,18400,17820,-800,-4.3,18230,-390,-2.09,17700,18500
274,پرديس,سرمايه گذاري پرديس,227,1209028,5176363158,4456,4235,4290,-166,-3.73,4396,-60,-1.35,4235,4395
275,سپاها,سيمان‌سپاهان‌,226,2328853,15735772480,6790,6970,6740,-50,-0.74,6760,-30,-0.44,6650,6970
276,وبهمن,سرمايه‌گذاري‌بهمن‌,224,754299,8757259880,12120,11550,11520,-600,-4.95,11820,-300,-2.48,11520,12360
277,كارين,صندوق س نگين سامان-ثابت,223,7482010,75293442187,10053,10063,10064,11,0.11,10063,10,0.1,10060,10064
278,تسه9909,امتياز تسهيلات مسكن آذر99,222,2709,1491232608,548096,573472,536000,-12096,-2.21,550473,2377,0.43,526000,574999
279,شخارك,پتروشيمي‌ خارك‌,222,455984,19093954730,41820,42270,41600,-220,-0.53,41830,10,0.02,41110,42270
280,ساينا,صنايع بهداشتي ساينا,221,470636,68258257573,143973,137747,140021,-3952,-2.74,145034,1061,0.74,136776,150500
281,بساما,بيمه سامان,220,523247,9250584443,17454,17300,17900,446,2.56,17587,133,0.76,16710,18000
282,بموتو,موتوژن‌,217,177776,8635263320,48900,49130,48020,-880,-1.8,48720,-180,-0.37,47720,49690
283,دعبيد,لابراتوارداروسازي‌  دكترعبيدي‌,215,560163,13153963940,24060,23400,23300,-760,-3.16,23880,-180,-0.75,23270,23760
284,شرنگي,شيميايي رنگين,214,62607,15577625622,255754,248082,251380,-4374,-1.71,248816,-6938,-2.71,248082,251503
285,دكپسول,توليد ژلاتين كپسول ايران,213,208201,5292352967,26080,26050,25151,-929,-3.56,25838,-242,-0.93,25070,26190
286,شيراز,پتروشيمي‌شيراز,212,1099324,56611112450,50930,50510,51870,940,1.85,51240,310,0.61,50090,53110
287,تيپيكو,سرمايه گذاري دارويي تامين,212,369818,13164267870,36240,34650,35530,-710,-1.96,36100,-140,-0.39,34650,36000
288,واحيا,م .صنايع و معادن احياء سپاهان,212,192800,28737258861,149561,147000,149001,-560,-0.37,149316,-245,-0.16,147000,151000
289,تسه9803,امتياز تسهيلات مسكن خرداد98,210,1767,940558685,536401,520000,526013,-10388,-1.94,532291,-4110,-0.77,520000,544000
290,پسهند,صنايع‌ لاستيكي‌  سهند,209,275805,9091928580,34640,32910,33850,-790,-2.28,33470,-1170,-3.38,32910,34200
291,جم پيلن,پلي پروپيلن جم - جم پيلن,208,295383,20294790620,68310,69950,68500,190,0.28,68460,150,0.22,67550,69950
292,بفجر,فجر انرژي خليج فارس,208,450719,9763477260,21500,22100,21790,290,1.35,21530,30,0.14,20900,22170
293,وثوق,سرمايه گذاري وثوق امين,208,594578,8182286297,14182,13757,13757,-425,-3,13807,-375,-2.64,13757,13950
294,دسبحا,گروه دارويي سبحان,205,820022,13156344230,16350,16000,15540,-810,-4.95,16160,-190,-1.16,15540,16500
295,غبشهر,صنعتي‌ بهشهر,204,717855,13965165950,19700,19990,19200,-500,-2.54,19550,-150,-0.76,19020,19990
296,فولاژ,فولاد آلياژي ايران,200,342714,4743241120,14150,14160,13840,-310,-2.19,14130,-20,-0.14,13640,14160
297,دالبر,البرزدارو,200,717888,8732734460,12170,11890,11880,-290,-2.38,12170,0,0,11600,12770
298,كماسه,تامين‌ ماسه‌ ريخته‌گري‌,199,693395,21023736400,28880,30320,30320,1440,4.99,30320,1440,4.99,30320,30320
299,مبين,مبين انرژي خليج فارس,198,1409546,21002474760,15170,14760,14800,-370,-2.44,15120,-50,-0.33,14750,15170
300,وتوسم,سرمايه‌گذاري‌توسعه‌ملي‌,196,727068,5027842050,7150,6900,6850,-300,-4.2,7070,-80,-1.12,6830,7140
301,فاراك,ماشين‌ سازي‌ اراك‌,196,3115356,6062482776,2048,1946,1946,-102,-4.98,2002,-46,-2.25,1946,1946
302,تسه9902,امتياز تسهيلات مسكن ارديبهشت99,193,3824,2089989474,543759,540522,531100,-12659,-2.33,546545,2786,0.51,520000,563000
303,سرود,سيمان‌شاهرود,193,650197,11271328940,17660,16840,17240,-420,-2.38,17430,-230,-1.3,16840,17660
304,واتي,سرمايه‌ گذاري‌ آتيه‌ دماوند,193,654662,5863284850,9060,8660,8990,-70,-0.77,9020,-40,-0.44,8660,9150
305,دزهراوي,داروسازي‌زهراوي‌,191,846260,4824530270,5990,5700,5700,-290,-4.84,5890,-100,-1.67,5700,5800
306,دابور,داروسازي‌ ابوريحان‌,187,360700,9231582660,26120,25600,25890,-230,-0.88,25780,-340,-1.3,25360,26120
307,خديزل,بهمن  ديزل,186,277627,11130607873,39955,41485,39530,-425,-1.06,40050,95,0.24,39215,41485
308,فاما,صنعتي‌ آما,185,404698,5526608670,14020,13980,13720,-300,-2.14,13890,-130,-0.93,13340,13980
309,ضسپا3004,اختيارخ خساپا-2500-1400/03/26,181,13626,13626000,2,1,1,-1,-50,1,-1,-50,1,1
310,وحكمت,بيمه حكمت صبا,179,1550979,4361649721,2867,2783,2806,-61,-2.13,2844,-23,-0.8,2781,2887
311,زر,صندوق س.پشتوانه سكه طلاي زر,178,78328,3687592028,46506,47350,47001,495,1.06,47079,573,1.23,46866,47360
312,وارس,سرمايه گذاري ارس صبا,175,1263343,15793129060,12865,12480,12480,-385,-2.99,12501,-364,-2.83,12480,12820
313,فخاس,فولاد خراسان,170,398877,8561056670,22550,21430,21430,-1120,-4.97,22450,-100,-0.44,21430,22350
314,پارسيان,بيمه پارسيان,169,1948251,15103825840,7990,7600,7800,-190,-2.38,7760,-230,-2.88,7600,7860
315,وتوس,توسعه‌شهري‌توس‌گستر,168,781513,10754694730,13980,13410,13670,-310,-2.22,13820,-160,-1.14,13410,14380
316,پكرمان,گروه‌ صنعتي‌ بارز,167,374198,8797242320,23390,23220,23560,170,0.73,23430,40,0.17,22900,23970
317,زپارس,ملي كشت و صنعت و دامپروري پارس,165,73067,7872965970,106760,108990,109990,3230,3.03,107260,500,0.47,104050,111700
318,وخاور,بانك خاورميانه,164,2129063,17666514710,8380,8450,8300,-80,-0.95,8350,-30,-0.36,8260,8450
319,گوهر,صندوق سكه طلاي كيان,161,76674,4089435080,52218,53990,53439,1221,2.34,53335,1117,2.14,53000,53990
320,بخاور,بيمه زندگي خاورميانه,158,1764254,9621043446,5740,5453,5453,-287,-5,5529,-211,-3.68,5453,5510
321,وكادو,تكادو,154,2279009,30671013530,13674,13510,13264,-410,-3,13458,-216,-1.58,13264,13510
322,تسه9810,امتياز تسهيلات مسكن دي98,150,3394,1821907864,543488,537100,525100,-18388,-3.38,536803,-6685,-1.23,517210,563000
323,اطلس,صندوق س.توسعه اندوخته آينده-س,147,50135,9792802190,196454,194001,196250,-204,-0.1,195329,-1125,-0.57,193900,197300
324,تماوند,تامين سرمايه دماوند,145,2076421,9867121927,4883,4900,4737,-146,-2.99,4786,-97,-1.99,4737,4900
325,دارا2,صندوق س. دارا الگوريتم-د,145,14500000,14500000,10020,1,1,-10019,-99.99,1,-10019,-99.99,1,1
326,شپاكسا,پاكسان‌,144,511268,10187657710,20090,20000,19730,-360,-1.79,19980,-110,-0.55,19650,20400
327,كاردان,صندوق س تجارت شاخصي كاردان,141,31474,4524426800,143400,143240,142480,-920,-0.64,143750,350,0.24,141680,145380
328,خفنر,فنرسازي‌خاور,140,2301491,9067874540,4147,3940,3940,-207,-4.99,4010,-137,-3.3,3940,3940
329,تسه9907,امتياز تسهيلات مسكن مهر99,137,1355,738718760,539466,540277,535000,-4466,-0.83,545180,5714,1.06,513788,564390
330,ضملت3002,اختيارخ وبملت-4000-1400/03/19,136,6964,174224000,34,40,14,-20,-58.82,25,-9,-26.47,14,64
331,شاوان,پالايش نفت لاوان,136,70998,4928183269,72207,69211,69500,-2707,-3.75,71773,-434,-0.6,68700,71958
332,تايرا,تراكتورسازي‌ايران‌,135,313429,6956374390,23010,22910,22390,-620,-2.69,22810,-200,-0.87,21880,22910
333,كاريس,صندوق س.سپهر كاريزما-س,134,381390,4055312238,10497,10499,10570,73,0.7,10633,136,1.3,10445,10750
334,كرازي,كارخانجات‌توليدي‌شيشه‌رازي‌,133,430862,8440586580,20620,19590,19590,-1030,-5,19980,-640,-3.1,19590,19590
335,سكرما,سيمان‌ كرمان‌,133,302157,3869395080,13410,12930,12740,-670,-5,13260,-150,-1.12,12740,13370
336,سپاس,صندوق س. پاداش سهامداري توسعه1,130,2936483,29803455751,10142,10150,10151,9,0.09,10149,7,0.07,10147,10151
337,شلعاب,لعابيران‌,128,246239,2885921080,13020,11720,11720,-1300,-9.98,12740,-280,-2.15,11720,11720
338,كخاك,صنايع‌خاك‌چيني‌ايران‌,128,172650,5143116550,31280,30300,29760,-1520,-4.86,30850,-430,-1.37,29720,30610
339,وسهمدا,شركت س استان همدان,125,6144444,4663632996,798,759,759,-39,-4.89,793,-5,-0.63,759,759
340,خبازرس,بازرسي مهندسي و صنعتي ايران,123,135311,3195233954,24856,23614,23614,-1242,-5,24434,-422,-1.7,23614,23614
341,سباقر,سيمان باقران,123,296516,4215353876,14178,14500,14066,-112,-0.79,14193,15,0.11,13780,14500
342,ضملت3001,اختيارخ وبملت-3500-1400/03/19,121,3925,842152000,353,300,175,-178,-50.42,215,-138,-39.09,103,350
343,تسه9906,امتياز تسهيلات مسكن شهريور99,120,1147,632143225,549626,535000,523000,-26626,-4.84,551127,1501,0.27,522145,577107
344,وسپه,سرمايه‌گذاري‌ سپه‌,117,499510,3130079910,6400,6470,6260,-140,-2.19,6390,-10,-0.16,6210,6480
345,ارمغان,ص سرمايه گذاري ارمغان ايرانيان,117,1812710,18400020516,10145,10152,10147,2,0.02,10151,6,0.06,10145,10156
346,تسه9904,امتياز تسهيلات مسكن تير99,116,1242,690622376,551049,531000,578000,26951,4.89,556057,5008,0.91,524000,578600
347,تماوندح,ح . تامين سرمايه دماوند,115,2916325,9037812623,3098,3083,3099,1,0.03,3099,1,0.03,3083,3150
348,سپيدما,صندوق س. سپيد دماوند-د,115,5089833,53063331522,10419,10425,10425,6,0.06,10425,6,0.06,10425,10430
349,كيان2,صندوق س. با درآمد ثابت كيان,115,11500000,11500000,28655,1,1,-28654,-100,1,-28654,-100,1,1
350,كدما,معدني‌ دماوند,114,130840,12359146400,89970,94460,94460,4490,4.99,93190,3220,3.58,94460,94460
351,درازك,دارويي‌ رازك‌,114,221624,5537404900,25180,24530,24610,-570,-2.26,25110,-70,-0.28,24500,25680
352,دپارس,پارس‌ دارو,107,50636,1805876750,37430,35560,35560,-1870,-5,37210,-220,-0.59,35560,37350
353,آبادا,توليد نيروي برق آبادان,106,121364,1187791520,9990,9790,9540,-450,-4.5,9970,-20,-0.2,9510,9790
354,شساخت,مهندسي و ساختمان صنايع نفت,105,283961,11368873149,41225,40095,39989,-1236,-3,40890,-335,-0.81,39989,40311
355,فيروزه,صندوق شاخص30 شركت فيروزه- سهام,105,58681,7515031730,127810,127150,126730,-1080,-0.85,128070,260,0.2,126710,128980
356,اخزا910,اسنادخزانه-م10بودجه99-020807,104,181788,110973910504,609370,608290,611899,2529,0.42,610458,1088,0.18,608280,611899
357,معيار,سرمايه گذاري معيار صنعت پارس,103,333837,17871963795,51976,53535,53535,1559,3,53535,1559,3,53535,53535
358,تسه9905,امتياز تسهيلات مسكن مرداد99,102,1082,611292435,562714,540599,551000,-11714,-2.08,564965,2251,0.4,537199,590799
359,اوصتا,صندوق انديشه ورزان صباتامين -د,101,5367306,100717754494,18760,18775,18765,5,0.03,18765,5,0.03,18765,18775
360,ضصاد3001,اختيارخ وبصادر-2000-1400/03/12,100,5684,15602000,10,5,1,-9,-90,3,-7,-70,1,6
361,فردا2,صندوق س آواي فرداي زاگرس-ثابت,100,10000000,10000000,10781,1,1,-10780,-99.99,1,-10780,-99.99,1,1
362,شوينده,مديريت صنعت شوينده ت.ص.بهشهر,99,344684,7049389430,20520,20900,20410,-110,-0.54,20490,-30,-0.15,20010,20900
363,صايند,صندوق س. گنجينه آينده روشن-د,99,755410,7413509320,9987,9895,9806,-181,-1.81,9814,-173,-1.73,9768,9895
364,تسه9903,امتياز تسهيلات مسكن خرداد99,98,973,548928354,556692,535298,560000,3308,0.59,564161,7469,1.34,535298,584000
365,ضفلا3004,اختيارخ فولاد-8560-1400/03/19,98,2221,2242434508,964,888,750,-214,-22.2,720,-244,-25.31,655,950
366,وبشهر,توسعه‌ صنايع‌ بهشهر(هلدينگ,97,586496,5433352190,9440,9090,9250,-190,-2.01,9410,-30,-0.32,9090,9650
367,نهال,صندوق س. طلاي سرخ نوويرا,97,140126,1191702068,8389,8407,8510,121,1.44,8505,116,1.38,8403,8675
368,اخزا903,اسنادخزانه-م3بودجه99-011110,97,196574,140760625941,716520,710002,717000,480,0.07,716069,-451,-0.06,710002,717000
369,چكارن,كارتن‌ ايران‌,96,2749489,7473111102,2861,2718,2718,-143,-5,2777,-84,-2.94,2718,2718
370,اخزا909,اسنادخزانه-م9بودجه99-020316,95,486595,321939186748,660961,661291,661501,540,0.08,661616,655,0.1,660209,663000
371,آساس,صندوق س.آسمان آرماني سهام-س,94,33286,5147494106,155815,151000,154500,-1315,-0.84,154644,-1171,-0.75,151000,155800
372,اخزا907,اسنادخزانه-م7بودجه99-020704,93,253775,157609292614,620800,624000,621012,212,0.03,621059,259,0.04,617001,624000
373,اميد,تامين سرمايه اميد,91,411069,2741830230,7020,6670,6670,-350,-4.99,6980,-40,-0.57,6670,6670
374,آتيمس,صندوق س.آرمان آتيه درخشان مس-س,89,28753,4753717123,165394,165000,165000,-394,-0.24,165329,-65,-0.04,164010,167000
375,دفرا,فرآورده‌هاي‌ تزريقي‌ ايران‌,86,101109,2236588070,23250,22090,22090,-1160,-4.99,23070,-180,-0.77,22090,23370
376,اتكام,شركت بيمه اتكايي امين,85,330610,1353858014,4244,4160,4070,-174,-4.1,4230,-14,-0.33,4067,4176
377,بمپنا,توليد برق عسلويه  مپنا,84,16596,991046048,61380,59500,59390,-1990,-3.24,61285,-95,-0.15,57200,60180
378,ضشنا8004,اختيارخ شپنا-12000-1400/08/16,84,3090,2788144000,1005,1000,860,-145,-14.43,902,-103,-10.25,849,1005
379,سكه0011پ02,سكه تمام بهارتحويلي 1روزه ملت,84,30200,32569439800,1062421,1081300,1083200,20779,1.96,1078458,16037,1.51,1072500,1083500
380,تسه9812,امتياز تسهيلات مسكن اسفند98,79,569,304506055,540415,525222,525000,-15415,-2.85,535160,-5255,-0.97,513398,560000
381,دشيمي,شيمي‌ داروئي‌ داروپخش‌,79,56147,1535058980,30370,27340,27340,-3030,-9.98,30020,-350,-1.15,27340,27340
382,ضخود7076,اختيارخ خودرو-2500-1400/07/07,78,2471,194594000,84,80,76,-8,-9.52,79,-5,-5.95,74,99
383,شاملا,معدني‌ املاح‌  ايران‌,77,36975,1212174880,34210,32710,32740,-1470,-4.3,34080,-130,-0.38,32700,34440
384,شراز,پالايش نفت شيراز,76,31637,2940158895,97681,92797,92797,-4884,-5,97316,-365,-0.37,92797,95849
385,ضشنا8001,اختيارخ شپنا-8000-1400/08/16,75,470,1440694000,3164,3191,3147,-17,-0.54,3065,-99,-3.13,2811,3214
386,سمتاز,سيمان ممتازان كرمان,75,153495,3337947319,22071,22030,21610,-461,-2.09,21960,-111,-0.5,21409,22030
387,آساميد,صندوق س.مشترك آسمان اميد -د,73,2040381,24704963407,12101,12110,12106,5,0.04,12108,7,0.06,12105,12112
388,زعف0008پ19,زعفران0008نگين تروند قاينات(پ),73,20154,2378194218,117986,118815,117002,-984,-0.83,118001,15,0.01,117000,119900
389,وپخش,داروپخش‌ (هلدينگ‌,72,16007,1442322210,93160,89200,91000,-2160,-2.32,93010,-150,-0.16,89200,91990
390,اخزا902,اسنادخزانه-م2بودجه99-011019,71,138986,100668131146,724604,727900,725500,896,0.12,724304,-300,-0.04,722101,727900
391,اخزا901,اسنادخزانه-م1بودجه99-010621,69,88893,68780086290,773621,771110,775000,1379,0.18,773740,119,0.02,771000,775000
392,كپشير,پشم‌شيشه‌ايران‌,69,319210,11469215300,39920,35930,35930,-3990,-9.99,36530,-3390,-8.49,35930,35930
393,آپ,آسان پرداخت پرشين,69,879652,13537844280,16190,15390,15390,-800,-4.94,15530,-660,-4.08,15390,15390
394,مارون,پتروشيمي مارون,68,8491,1205411278,143920,141090,141500,-2420,-1.68,143896,-24,-0.02,140081,143300
395,تسه9804,امتياز تسهيلات مسكن تير98,67,927,505110576,559426,546666,536012,-23414,-4.19,544887,-14539,-2.6,532222,559996
396,وساشرقي,شركت س استان آذربايجان شرقي,67,3032000,2719704000,944,897,897,-47,-4.98,942,-2,-0.21,897,897
397,ثعتما,س. ساختماني اعتماد گستر,67,440100,11511695700,25396,26157,26157,761,3,26157,761,3,26157,26157
398,ضپال2007,اختيارخ اپال-32000-1401/02/12,67,2489,209058000,82,100,85,3,3.66,84,2,2.44,79,100
399,تسه9808,امتياز تسهيلات مسكن آبان98,67,943,517351597,542565,535015,545015,2450,0.45,548623,6058,1.12,535015,568000
400,تسه9809,امتياز تسهيلات مسكن آذر98,63,430,239794737,544080,537000,566000,21920,4.03,557662,13582,2.5,535000,566000
401,شكبير,پتروشيمي اميركبير,62,214496,17331442970,82975,80487,80700,-2275,-2.74,82598,-377,-0.45,80486,82820
402,بورس,بورس اوراق بهادار تهران,62,414012,10987878480,27930,26540,26540,-1390,-4.98,27570,-360,-1.29,26540,26540
403,تسه9901,امتياز تسهيلات مسكن فروردين99,61,411,227451613,542806,569946,569946,27140,5,553410,10604,1.95,529015,569946
404,وبرق,س.کارکنان صنعت برق زنجان وقزوي,60,138338,6038453700,42379,43650,43650,1271,3,43081,702,1.66,43650,43650
405,خاتم,صندوق س خاتم ايساتيس پويا-ثابت,60,879824,9835376365,11171,11175,11180,9,0.08,11179,8,0.07,11175,11181
406,لبوتان,گروه‌صنعتي‌بوتان‌,60,24562,1206210230,50730,49500,49060,-1670,-3.29,50600,-130,-0.26,49000,50000
407,تسه9807,امتياز تسهيلات مسكن مهر98,59,484,267153563,557776,547011,559000,1224,0.22,551970,-5806,-1.04,545229,560000
408,كالا,بورس كالاي ايران,58,71216,2046747840,30250,28740,28740,-1510,-4.99,30140,-110,-0.36,28740,28740
409,تسه9811,امتياز تسهيلات مسكن بهمن98,58,582,318436987,547244,525300,549999,2755,0.5,547143,-101,-0.02,519882,550000
410,ضشنا8002,اختيارخ شپنا-9000-1400/08/16,58,450,1089002000,2507,2713,2365,-142,-5.66,2420,-87,-3.47,2200,2914
411,زرين,صندوق س. سهام زرين كوروش-س,57,57638,538642474,9402,9310,9246,-156,-1.66,9345,-57,-0.61,9241,9690
412,سمگا,گروه سرمايه گذاري ميراث فرهنگي,56,232100,5672524000,25726,24440,24440,-1286,-5,25560,-166,-0.65,24440,24440
413,تسه9805,امتياز تسهيلات مسكن مرداد98,54,794,437625189,555172,547000,545200,-9972,-1.8,551165,-4007,-0.72,540010,555300
414,ضشنا8003,اختيارخ شپنا-10000-1400/08/16,54,276,530515000,2045,1998,1811,-234,-11.44,1922,-123,-6.01,1550,2350
415,دارا,صندوق س. دارا الگوريتم-د,53,1674306,16778917114,10020,10021,10021,1,0.01,10021,1,0.01,10021,10026
416,وبازار,صندوق س شاخصي بازارآشنا,52,184919,1677102420,9130,9000,9100,-30,-0.33,9070,-60,-0.66,9000,9180
417,شپاس,نفت پاسارگاد,52,308922,5323343904,18138,17232,17232,-906,-5,17846,-292,-1.61,17232,17232
418,تسه9806,امتياز تسهيلات مسكن شهريور98,51,453,251431184,557600,551310,552000,-5600,-1,555036,-2564,-0.46,545000,564790
419,خنصير,مهندسي‌نصيرماشين‌,50,28581,2777787390,107980,97190,97190,-10790,-9.99,105750,-2230,-2.07,97190,97190
420,دلر,داروسازي‌ اكسير,50,43738,1275565430,29170,29150,28760,-410,-1.41,29170,0,0,28510,29440
421,بالبر,كابل‌ البرز,49,67409,3554476570,58580,52730,52730,-5850,-9.99,57030,-1550,-2.65,52730,52730
422,ضخود4002,اختيارخ خودرو-1800-1400/04/02,49,1256,101152000,115,129,76,-39,-33.91,81,-34,-29.57,70,129
423,دارو,كارخانجات‌داروپخش‌,47,46529,1322383370,29340,27880,28350,-990,-3.37,29270,-70,-0.24,27880,29400
424,حريل,ريل پردازسير,46,1062837,5140942569,5091,4837,4837,-254,-4.99,4992,-99,-1.94,4837,4837
425,وسهرمز,شركت س استان هرمزگان,46,2156610,1850371380,903,858,858,-45,-4.98,900,-3,-0.33,858,858
426,خوساز,محورسازان‌ايران‌خودرو,45,75452,491192520,7230,6510,6510,-720,-9.96,7200,-30,-0.41,6510,6510
427,خچرخش,چرخشگر,42,123619,1506915610,13540,12190,12190,-1350,-9.97,13390,-150,-1.11,12190,12190
428,زمگسا,كشاورزي‌ ودامپروي‌ مگسال‌,41,39370,1144879600,32310,29080,29080,-3230,-10,32030,-280,-0.87,29080,29080
429,شجم,صنايع پتروشيمي تخت جمشيد,40,728804,6777877200,8804,9300,9300,496,5.63,8943,139,1.58,9300,9300
430,پاسا,ايران‌ياساتايرورابر,40,49730,1194017300,26670,24010,24010,-2660,-9.97,26430,-240,-0.9,24010,24010
431,گدنا,تهيه توزيع غذاي دنا آفرين فدك,39,420743,11686557568,29237,27776,27776,-1461,-5,27918,-1319,-4.51,27776,27776
432,شاروم,پتروشيمي اروميه,38,44430,779924220,18477,17554,17554,-923,-5,18425,-52,-0.28,17554,17554
433,چافست,افست‌,38,151232,2259406080,16590,14940,14940,-1650,-9.95,16310,-280,-1.69,14940,14940
434,سكه0112پ03,سكه تمام بهارتحويلي1روزه سامان,38,7700,8320460100,1063820,1078000,1083000,19180,1.8,1080579,16759,1.58,1077300,1083000
435,فالوم,آلومتك‌,37,30383,736787750,25000,24250,24250,-750,-3,24924,-76,-0.3,24250,24250
436,سكه0012پ04,سكه تمام بهارتحويلي1روز صادرات,37,6400,6916087200,1061562,1078000,1082990,21428,2.02,1080639,19077,1.8,1077000,1084989
437,فيروزا,صندوق بادرآمد ثابت فيروزه آسيا,36,147429,3403156821,23085,23010,23085,0,0,23083,-2,-0.01,23010,23100
438,ركيش,كارت اعتباري ايران كيش,35,1098221,23578804870,22600,21470,21470,-1130,-5,21470,-1130,-5,21470,21470
439,ساروج,بين المللي ساروج بوشهر,35,129971,2080899147,16442,16442,15949,-493,-3,16347,-95,-0.58,15949,16442
440,افق ملت,صندوق س در سهام افق ملت,34,4000,481034720,120800,122490,120150,-650,-0.54,120260,-540,-0.45,120110,122490
441,زعف0008پ16,زعفران0008نگين بيرجند(پ),29,3603,429102914,118333,116001,118999,666,0.56,119096,763,0.64,116001,119197
442,گنجين,صندوق س. گنجينه يكم آويد-د,29,286106,3703524314,12937,12936,12947,10,0.08,12945,8,0.06,12936,12947
443,بنو,بيمه تجارت نو,29,1209672,33951864024,29544,28067,28067,-1477,-5,28067,-1477,-5,28067,28067
444,انرژي3,سايراشخاص بورس انرژي,28,1487,330396530,233880,222190,222190,-11690,-5,233810,-70,-0.03,222190,222190
445,ضپال2006,اختيارخ اپال-28000-1401/02/12,28,1215,671160000,550,550,530,-20,-3.64,552,2,0.36,530,650
446,فرابورس,فرابورس ايران,27,27590,798896040,30479,28956,28956,-1523,-5,30441,-38,-0.12,28956,28956
447,ثشاهد,سرمايه‌ گذاري‌ شاهد,27,27199,402273210,15560,14790,14790,-770,-4.95,15550,-10,-0.06,14790,14790
448,هپارس102,اختيارف ت پارس-177010-01/02/05,27,104674,104674,1,1,1,0,0,1,0,0,1,1
449,اخزا911,اسنادخزانه-م11بودجه99-020906,26,45846,27501941850,601022,600581,600000,-1022,-0.17,599877,-1145,-0.19,599390,601000
450,قهكمت,قندهكمتان‌,26,11652,482742360,46030,41430,41430,-4600,-9.99,45870,-160,-0.35,41430,41430
451,توريل,توکاريل,26,66211,924636615,14700,13965,13965,-735,-5,14662,-38,-0.26,13965,13965
452,اخزا906,اسنادخزانه-م6بودجه99-020321,25,13983,10572141449,756137,730002,759000,2863,0.38,756071,-66,-0.01,730000,759000
453,ضسپا3001,اختيارخ خساپا-1600-1400/03/26,25,1257,75702000,117,67,54,-63,-53.85,60,-57,-48.72,52,67
454,زعف0008پ20,زعفران0008نگين وحدت جام(پ),25,12654,1489217785,118000,118815,118000,0,0,117688,-312,-0.26,117000,118815
455,صنوين,صندوق سرمايه‌گذاري صنوين-مختلط,24,3202,337516860,104720,105500,105110,390,0.37,105410,690,0.66,105100,107000
456,اخزا914,اسنادخزانه-م14بودجه99-021025,24,39629,23130190529,584106,584001,584000,-106,-0.02,583668,-438,-0.07,583501,584010
457,پلوله,گازلوله‌,23,413498,10385415768,25892,25116,25116,-776,-3,25116,-776,-3,25116,25116
458,سحرا021,سلف موازي برق نيروي برق حرارتي,23,3115840,903497008960,290000,289969,289969,-31,-0.01,289969,-31,-0.01,289969,289969
459,كشرق,صنعتي و معدني شمال شرق شاهرود,23,100609,7755746592,81145,77088,77088,-4057,-5,78823,-2322,-2.86,77088,77088
460,ضخود7072,اختيارخ خودرو-1400-1400/07/07,23,487,222863000,526,525,460,-66,-12.55,458,-68,-12.93,431,525
461,داريك,صندوق س.اعتماد داريك-د,23,79973,848215893,10599,10634,10606,7,0.07,10606,7,0.07,10599,10634
462,اخزا905,اسنادخزانه-م5بودجه99-020218,22,130111,87596735152,673148,673148,674000,852,0.13,673246,98,0.01,671001,674000
463,بنيرو,نيروترانس‌,22,33304,470252480,14860,14120,14120,-740,-4.98,14840,-20,-0.13,14120,14120
464,اخزا721,اسنادخزانه-م21بودجه97-000728,22,37589,34738421328,925283,923001,928116,2833,0.31,924165,-1118,-0.12,923001,928116
465,هاي وب,داده گسترعصرنوين-هاي وب,21,22266,216870840,10250,9740,9740,-510,-4.98,10250,0,0,9740,9740
466,لكما,كارخانجات‌مخابراتي‌ايران‌,21,117261,677299536,6079,5776,5776,-303,-4.98,6057,-22,-0.36,5776,5776
467,ضسپا8041,اختيارخ خساپا-1600-1400/08/26,21,1434,382771000,266,270,239,-27,-10.15,267,1,0.38,211,280
468,هنوري102,اختيارف ت نوري73761-01/02/15,21,300000,300000,1,1,1,0,0,1,0,0,1,1
469,ضصاد8030,اختيارخ وبصادر-1600-1400/08/12,21,432,182250000,435,440,422,-13,-2.99,422,-13,-2.99,376,440
470,سخند,صندوق س.سپهرخبرگان نفت-د,21,127160,1278633390,10050,10090,10047,-3,-0.03,10055,5,0.05,10020,10099
471,فراز,صندوق س.سهام فراز داريك-س,20,26864,277703789,10337,10337,10337,0,0,10337,0,0,10337,10345
472,سپر,صندوق س سپر سرمايه بيدار- ثابت,19,283897,3373292432,11878,11882,11884,6,0.05,11882,4,0.03,11882,11884
473,اخزا808,اسنادخزانه-م8بودجه98-000817,19,5298,4848846398,913395,914000,916000,2605,0.29,915222,1827,0.2,914000,916799
474,ضجار7038,اختيارخ وتجارت-1800-1400/07/21,19,247,92860000,374,350,420,46,12.3,376,2,0.53,350,420
475,چفيبر,فيبر ايران‌,18,22812,282184440,13020,12370,12370,-650,-4.99,13010,-10,-0.08,12370,12370
476,فزرين,زرين معدن آسيا,18,87807,1562174337,18727,17791,17791,-936,-5,18613,-114,-0.61,17791,17791
477,غشهداب,كشت و صنعت شهداب ناب خراسان,18,127880,457938280,3769,3581,3581,-188,-4.99,3763,-6,-0.16,3581,3581
478,اخزا815,اسنادخزانه-م15بودجه98-010406,18,11997,9713953384,807201,811000,807411,210,0.03,809699,2498,0.31,807333,811000
479,اخزا908,اسنادخزانه-م8بودجه99-020606,18,68907,43558065271,631699,633990,632128,429,0.07,632128,429,0.07,631502,633990
480,اخزا807,اسنادخزانه-م7بودجه98-000719,18,37178,34555632788,900739,928500,933200,32461,3.6,929465,28726,3.19,928500,933200
481,شصدف,صنعتي دوده فام,17,30292,900126780,31278,29715,29715,-1563,-5,31178,-100,-0.32,29715,29715
482,كبافق,معادن‌ بافق‌,17,6322,259454880,43200,41040,41040,-2160,-5,43170,-30,-0.07,41040,41040
483,ضخود7073,اختيارخ خودرو-1600-1400/07/07,17,330,95138000,327,310,283,-44,-13.46,288,-39,-11.93,275,310
484,تليسه,دامداري تليسه نمونه,17,162285,651249705,4224,4013,4013,-211,-5,4214,-10,-0.24,4013,4013
485,اخزا806,اسنادخزانه-م6بودجه98-000519,17,3338,3207914371,961660,961003,961021,-639,-0.07,961029,-631,-0.07,960650,963100
486,دمعيار,صندوق س. توازن معيار-د,16,381208,3832855962,10052,10060,10056,4,0.04,10054,2,0.02,10053,10060
487,ضشنا8005,اختيارخ شپنا-14000-1400/08/16,16,168,84260000,914,499,900,-14,-1.53,502,-412,-45.08,361,900
488,اخزا904,اسنادخزانه-م4بودجه99-011215,16,36243,25623850361,706386,706501,707000,614,0.09,707001,615,0.09,706501,707003
489,خكمك,كمك‌فنرايندامين‌,16,3542,88585420,26320,25010,25010,-1310,-4.98,26310,-10,-0.04,25010,25010
490,غگلپا,شير پاستوريزه پگاه گلپايگان,15,29586,1370127660,48747,46310,46310,-2437,-5,48490,-257,-0.53,46310,46310
491,ضسپا8039,اختيارخ خساپا-1200-1400/08/26,15,199,88918000,454,489,430,-24,-5.29,447,-7,-1.54,430,489
492,وتعاون,بيمه  تعاون,15,26556,153679572,6091,5787,5787,-304,-4.99,6086,-5,-0.08,5787,5787
493,طصاد3008,اختيارف وبصادر-6000-1400/03/12,14,1400,5863000000,4140,4190,4180,40,0.97,4188,48,1.16,4180,4190
494,سجام,مجتمع سيمان غرب آسيا,14,24354,92545200,3917,3800,3800,-117,-2.99,3916,-1,-0.03,3800,3800
495,جوين,كشت و صنعت جوين,14,69433,298353601,4429,4297,4297,-132,-2.98,4426,-3,-0.07,4297,4297
496,بكام,كارخانجات توليدي شهيد قندي,14,61615,220273625,3763,3575,3575,-188,-5,3760,-3,-0.08,3575,3575
497,ضسپا8040,اختيارخ خساپا-1400-1400/08/26,14,729,237613000,349,350,300,-49,-14.04,326,-23,-6.59,277,350
498,شصدفح,ح . صنعتي دوده فام,13,128983,3251774386,26273,27586,24960,-1313,-5,25211,-1062,-4.04,24960,27586
499,اخزا811,اسنادخزانه-م11بودجه98-001013,13,1702,1512125194,886318,886888,888000,1682,0.19,888440,2122,0.24,886888,890000
500,ريشمك,توليد و صادرات ريشمك,13,68375,3406374125,52441,49819,49819,-2622,-5,51791,-650,-1.24,49819,49819
501,سيمرغ,سيمرغ,13,18104,307405920,17870,16980,16980,-890,-4.98,17850,-20,-0.11,16980,16980
502,ولتجار,واسپاري تجارت وسرمايه ايرانيان,13,47186,319166104,6973,6764,6764,-209,-3,6966,-7,-0.1,6764,6764
503,غشان,شيرپاستوريزه‌پگاه‌خراسان‌,12,105285,566433300,5660,5380,5380,-280,-4.95,5650,-10,-0.18,5380,5380
504,بسويچ,پارس‌سويچ‌,12,16754,436441700,27420,26050,26050,-1370,-5,27390,-30,-0.11,26050,26050
505,عيار2,صندوق س. پشتوانه طلاي مفيد,12,120000,120000,26915,1,1,-26914,-100,1,-26914,-100,1,1
506,قصفها,قنداصفهان‌,12,3550,509993000,151220,143660,143660,-7560,-5,150950,-270,-0.18,143660,143660
507,اخزا820,اسنادخزانه-م20بودجه98-020806,12,44696,27299677599,610785,610790,610786,1,0,610786,1,0,610785,610791
508,سفانو,سيمان فارس نو,12,7793,193266400,26100,24800,24800,-1300,-4.98,26080,-20,-0.08,24800,24800
509,ديران,ايران‌دارو,12,20153,322851060,16860,16020,16020,-840,-4.98,16840,-20,-0.12,16020,16020
510,اخزا814,اسنادخزانه-م14بودجه98-010318,12,4878,3975673977,820789,815620,815101,-5688,-0.69,815021,-5768,-0.7,815000,815620
511,ضترا8055,اختيارخ شتران-5000-1400/08/09,12,63,209348000,2879,3500,2900,21,0.73,3323,444,15.42,2900,3555
512,سغرب,سيمان‌غرب‌,11,7594,192735720,26710,25380,25380,-1330,-4.98,26690,-20,-0.07,25380,25380
513,ختور,رادياتور ايران‌,11,7093,122921690,18240,17330,17330,-910,-4.99,18230,-10,-0.05,17330,17330
514,رافزا,رايان هم افزا,11,2886,289393650,105552,100275,100275,-5277,-5,105445,-107,-0.1,100275,100275
515,لپارس,پارس‌ الكتريك‌,11,1577,127390060,85030,80780,80780,-4250,-5,84990,-40,-0.05,80780,80780
516,بذر,صندوق س بذر اميد آفرين-سهام,11,2649,228938420,86340,85930,88000,1660,1.92,86420,80,0.09,85930,88000
517,اخزا816,اسنادخزانه-م16بودجه98-010503,11,5316,4224125542,794882,790021,794051,-831,-0.1,794606,-276,-0.03,790021,794910
518,ضترا8057,اختيارخ شتران-7000-1400/08/09,11,223,360235000,1801,1780,1600,-201,-11.16,1615,-186,-10.33,1600,1799
519,دجابر,داروسازي‌ جابرابن‌حيان‌,11,14814,222950700,15840,15050,15050,-790,-4.99,15830,-10,-0.06,15050,15050
520,دلقما,دارويي‌ لقمان‌,11,35631,812386800,23990,22800,22800,-1190,-4.96,23920,-70,-0.29,22800,22800
521,قجام,فرآوردههاي غذايي وقندتربت‌جام‌,10,29535,397216215,13723,13449,13449,-274,-2,13701,-22,-0.16,13449,13449
522,وآرين,شركت توسعه اقتصادي آرين,10,45200,147035600,3353,3253,3253,-100,-2.98,3351,-2,-0.06,3253,3253
523,ولشرق,ليزينگ ايران و شرق,10,312307,2389773164,8054,7652,7652,-402,-4.99,7985,-69,-0.86,7652,7652
524,ضصاد8031,اختيارخ وبصادر-1800-1400/08/12,10,729,224878000,445,310,300,-145,-32.58,308,-137,-30.79,300,320
525,خرينگ,رينگ‌سازي‌مشهد,10,6929,312844350,47520,45150,45150,-2370,-4.99,47470,-50,-0.11,45150,45150
526,وآيند,بانك  آينده,10,9260,147446980,16247,15923,15923,-324,-1.99,16247,0,0,15923,15923
527,وسديد,گروه ‌صنعتي‌سديد,10,177499,502144671,2886,2829,2829,-57,-1.98,2885,-1,-0.03,2829,2829
528,كسرا,سراميك‌هاي‌صنعتي‌اردكان‌,10,20016,333866880,17550,16680,16680,-870,-4.96,17530,-20,-0.11,16680,16680
529,كپارس,كاشي‌ پارس‌,10,2041,252185960,130060,123560,123560,-6500,-5,129930,-130,-0.1,123560,123560
530,مرقام,ايران‌ارقام‌,10,16012,264358120,17370,16510,16510,-860,-4.95,17350,-20,-0.12,16510,16510
531,اخزا809,اسنادخزانه-م9بودجه98-000923,10,7453,6680545410,895785,896200,896500,715,0.08,896357,572,0.06,896200,897000
532,ددام,داروسازي زاگرس فارمد پارس,10,5815,93447050,16910,16070,16070,-840,-4.97,16900,-10,-0.06,16070,16070
533,اخزا817,اسنادخزانه-م17بودجه98-010512,10,10031,7925993648,790907,790000,790156,-751,-0.09,790150,-757,-0.1,790000,791000
534,كرونا2,تامين مالي جمعي صرفا اهداي سود,9,1848,18480000,10000,10000,10000,0,0,10000,0,0,10000,10000
535,دتوزيع,توزيع دارو پخش,9,4931,219459086,46848,44506,44506,-2342,-5,46824,-24,-0.05,44506,44506
536,لخزر,پارس‌ خزر,9,612,103103640,177330,168470,168470,-8860,-5,177260,-70,-0.04,168470,168470
537,ضصاد3000,اختيارخ وبصادر-1800-1400/03/12,9,97,3805000,150,38,37,-113,-75.33,39,-111,-74,35,49
538,كطبس,ذغال‌سنگ‌ نگين‌ ط‌بس‌,9,892,55268320,65220,61960,61960,-3260,-5,65210,-10,-0.02,61960,61960
539,بالاس,مهندسي ساختمان تاسيسات راه آهن,9,141927,6805825431,50476,47953,47953,-2523,-5,49174,-1302,-2.58,47953,47953
540,كلر,كلر پارس,9,2898,352025856,127865,121472,121472,-6393,-5,127724,-141,-0.11,121472,121472
541,وثخوز,سرمايه گذاري و توسعه خوزستان,9,13095,877103100,70505,66980,66980,-3525,-5,70179,-326,-0.46,66980,66980
542,زكوثر,سرمايه گذاري كشاورزي كوثر,9,3647,67323620,19430,18460,18460,-970,-4.99,19430,0,0,18460,18460
543,ثفارس,عمران‌وتوسعه‌فارس‌,9,15157,134442590,9330,8870,8870,-460,-4.93,9330,0,0,8870,8870
544,ضفلا7003,اختيارخ فولاد-8560-1400/07/25,8,190,582671200,2474,2210,2150,-324,-13.1,2187,-287,-11.6,2110,2250
545,هكوير109,اختيارف ت كوير-19000-01/09/20,8,30473,32209961,491,1057,1057,566,115.27,1057,566,115.27,1057,1057
546,وگستر,گسترش سرمايه گذاري ايرانيان,8,5194,92603826,18767,17829,17829,-938,-5,18761,-6,-0.03,17829,17829
547,شفا,سرمايه گذاري شفادارو,8,56680,2285904400,42450,40330,40330,-2120,-4.99,42200,-250,-0.59,40330,40330
548,اخزا723,اسنادخزانه-م23بودجه97-000824,8,965,879375058,910416,916450,910900,484,0.05,911269,853,0.09,910900,916450
549,سفار,سيمان‌فارس‌,8,17000,2217140000,137280,130420,130420,-6860,-5,136160,-1120,-0.82,130420,130420
550,زماهان,مجتمع توليد گوشت مرغ ماهان,8,186634,3650374406,20588,19559,19559,-1029,-5,20324,-264,-1.28,19559,19559
551,اخزا812,اسنادخزانه-م12بودجه98-001111,8,4006,3512954700,876720,876730,876751,31,0,876923,203,0.02,876730,879999
552,اراد65,مرابحه عام دولتي65-ش.خ0210,8,56400,54624992300,955000,960000,969000,14000,1.47,968528,13528,1.42,960000,969000
553,ضملي7004,اختيارخ فملي-14000-1400/07/11,8,37,33633000,910,909,909,-1,-0.11,909,-1,-0.11,909,909
554,زعف0008پ08,زعفران0008نگين روستا(پ),8,6000,714322200,119346,119001,119000,-346,-0.29,119054,-292,-0.24,119000,119300
555,كمينا,شيشه سازي مينا,7,6850,157385600,23686,22976,22976,-710,-3,23674,-12,-0.05,22976,22976
556,تبرك,گروه كارخانجات صنعتي تبرك,7,4010,74646150,19594,18615,18615,-979,-5,19590,-4,-0.02,18615,18615
557,اخزا813,اسنادخزانه-م13بودجه98-010219,7,5797,4813830300,829236,830000,830500,1264,0.15,830400,1164,0.14,830000,831000
558,كپشيرح,ح . پشم‌شيشه‌ايران‌,7,102498,2111864700,21890,21930,20600,-1290,-5.89,20600,-1290,-5.89,20600,21930
559,سنفت007,سلف موازي استاندارد سنفت007,7,675000,1064561400000,1593523,1577128,1577128,-16395,-1.03,1577128,-16395,-1.03,1577128,1577128
560,پست0008پ08,پسته فندقي32-30مه ولات0008(پ),7,408,679339394,1699960,1680000,1647097,-52863,-3.11,1665047,-34913,-2.05,1647097,1740000
561,كوثر,بيمه كوثر,7,15400,213028200,14561,13833,13833,-728,-5,14557,-4,-0.03,13833,13833
562,تمحركه,ماشين سازي نيرو محركه,7,14234,241892596,17519,16994,16994,-525,-3,17505,-14,-0.08,16994,16994
563,بايكا,كارخانجات كابلسازي ‌ايران‌,7,4983,173468196,36644,34812,34812,-1832,-5,36610,-34,-0.09,34812,34812
564,غشهد,شهد ايران ‌,7,59071,389277890,6930,6590,6590,-340,-4.91,6920,-10,-0.14,6590,6590
565,زملارد,كشاورزي و دامپروري ملارد شير,7,1273,44027978,36406,34586,34586,-1820,-5,36400,-6,-0.02,34586,34586
566,اراد61,مرابحه عام دولت61-ش.خ0309,7,160000,160000000000,1000000,1000000,1000000,0,0,1000000,0,0,1000000,1000000
567,اعتلا,شركت سرمايه گذاري اعتلاء البرز,7,15111,102165471,7116,6761,6761,-355,-4.99,7113,-3,-0.04,6761,6761
568,قثابت,قند ثابت‌ خراسان‌,7,741,41985060,59640,56660,56660,-2980,-5,59630,-10,-0.02,56660,56660
569,باران,بيمه زندگي باران50%تاديه,7,166500,672160500,3920,4037,4037,117,2.98,3928,8,0.2,4037,4037
570,حفارس,حمل و نقل بين المللي خليج فارس,7,8558,37852034,4655,4423,4423,-232,-4.98,4654,-1,-0.02,4423,4423
571,ساربيل,سيمان آرتا اردبيل,6,1419,71503410,53040,50390,50390,-2650,-5,53030,-10,-0.02,50390,50390
572,غالبر,لبنيات‌ كالبر,6,7344,134688960,19300,18340,18340,-960,-4.97,19290,-10,-0.05,18340,18340
573,زدشت,كشت و صنعت دشت خرم دره,6,2311,60388741,27506,26131,26131,-1375,-5,27500,-6,-0.02,26131,26131
574,ضملي7002,اختيارخ فملي-10000-1400/07/11,6,58,198438000,3403,3700,3136,-267,-7.85,3421,18,0.53,3136,3700
575,الماس,صندوق س.امين تدبيرگران فردا-س,6,1557,154250305,99823,99011,100800,977,0.98,99069,-754,-0.76,99000,100800
576,نمرينو,ايران‌ مرينوس‌,6,1011,82467270,85860,81570,81570,-4290,-5,85830,-30,-0.03,81570,81570
577,غنوش,نوش‌ مازندران‌,6,1155,59725050,54430,51710,51710,-2720,-5,54420,-10,-0.02,51710,51710
578,فلوله,لوله‌وماشين‌سازي‌ايران‌,6,8056,159508800,20840,19800,19800,-1040,-4.99,20830,-10,-0.05,19800,19800
579,آسام,صندوق س.آرمان سپهر آشنا-م,6,2160,221467250,101636,102420,102685,1049,1.03,102531,895,0.88,102420,102685
580,ضغدر3003,اختيارخ وغدير-9200-1400/03/26,6,117,105000000,1000,700,1000,0,0,897,-103,-10.3,700,1000
581,ضخود4003,اختيارخ خودرو-2000-1400/04/02,6,375,4125000,12,11,11,-1,-8.33,11,-1,-8.33,11,11
582,اراد36,مرابحه عام دولت3-ش.خ 0104,6,2200,2182998300,985000,964999,999999,14999,1.52,992272,7272,0.74,964999,999999
583,اخزا720,اسنادخزانه-م20بودجه97-000324,6,72,71561700,992955,994985,993500,545,0.05,993912,957,0.1,993500,994985
584,بهپاك,صنعتي بهپاك,6,13678,87279318,6716,6381,6381,-335,-4.99,6714,-2,-0.03,6381,6381
585,سكه0111پ05,سكه تمام بهارتحويل1روزه آينده,6,1000,1078751200,1048992,1075000,1080000,31008,2.96,1078751,29759,2.84,1075000,1086500
586,زعف0008پ12,زعفران0008پوشالمعمول سحرخيز(پ),6,542,45874400,85200,88000,84000,-1200,-1.41,84639,-561,-0.66,84000,88000
587,وآذر,سرمايه‌گذاري‌توسعه‌آذربايجان‌,6,531,41009130,81290,77230,77230,-4060,-4.99,81280,-10,-0.01,77230,77230
588,اخزا821,اسنادخزانه-م21بودجه98-020906,6,1838,1102988123,601989,600111,600101,-1888,-0.31,600102,-1887,-0.31,600101,600112
589,تكنو,تكنوتار,6,52696,1055500880,21080,20030,20030,-1050,-4.98,21000,-80,-0.38,20030,20030
590,ضجار7040,اختيارخ وتجارت-2500-1400/07/21,6,391,44965000,150,120,130,-20,-13.33,115,-35,-23.33,105,130
591,اخزا810,اسنادخزانه-م10بودجه98-001006,6,2039,1816385219,890540,890800,890801,261,0.03,890822,282,0.03,890800,891000
592,كمرجان,بازرگاني و توليدي مرجان كار,6,957,133444080,146778,139440,139440,-7338,-5,146709,-69,-0.05,139440,139440
593,دامين,داروسازي‌ امين‌,6,17387,82762120,5010,4760,4760,-250,-4.99,5010,0,0,4760,4760
594,ضفلا3003,اختيارخ فولاد-7133-1400/03/19,6,190,602159000,2416,2150,2300,-116,-4.8,2261,-155,-6.42,2150,2300
595,شسم,توليد سموم‌ علف‌ كش,6,2500,241055000,94532,96422,96422,1890,2,94620,88,0.09,96422,96422
596,آكورد2,صندوق س. آرمان آتي كوثر-د,5,500000,500000,32347,1,1,-32346,-100,1,-32346,-100,1,1
597,وهنر,گروه توسعه هنر ايران,5,123835,958730570,7981,7742,7742,-239,-2.99,7957,-24,-0.3,7742,7742
598,غشصفا,شيرپاستوريزه‌پگاه‌اصفهان‌,5,2336,60268800,27150,25800,25800,-1350,-4.97,27140,-10,-0.04,25800,25800
599,خشرق,الكتريك‌ خودرو شرق‌,5,13243,181164240,14390,13680,13680,-710,-4.93,14380,-10,-0.07,13680,13680
600,غگلستا,شير پاستوريزه پگاه گلستان,5,2642,49228386,19613,18633,18633,-980,-5,19608,-5,-0.03,18633,18633
601,پارتا,مجتمع‌صنعتي‌آرتاويل‌تاير,5,2642,85022202,33176,32181,32181,-995,-3,33173,-3,-0.01,32181,32181
602,زفكا,كشت و دامداري فكا,5,3299,39251502,12524,11898,11898,-626,-5,12522,-2,-0.02,11898,11898
603,فملي2,ملي‌ صنايع‌ مس‌ ايران‌,5,249417203,3109889743760,12460,12460,12460,0,0,12469,9,0.07,12460,12550
604,زعف0008پ05,زعفران0008نگين زرين(پ),5,3342,400380938,120995,121689,120000,-995,-0.82,119803,-1192,-0.99,119500,121689
605,شگل,گلتاش‌,5,6365,60785750,10050,9550,9550,-500,-4.98,10050,0,0,9550,9550
606,اراد33,مرابحه عام دولت3-ش.خ 0303,5,4000,3519970000,855000,880000,879990,24990,2.92,879992,24992,2.92,879990,880000
607,زشريف,كشت وصنعت شريف آباد,5,5469,26825445,5163,4905,4905,-258,-5,5163,0,0,4905,4905
608,صنفت0312,صكوك منفعت نفت0312-6ماهه 18/5%,5,50000,50129000000,1002246,1002580,1002580,334,0.03,1002580,334,0.03,1002580,1002580
609,قشكر,شكرشاهرود,5,21924,77019012,3697,3513,3513,-184,-4.98,3696,-1,-0.03,3513,3513
610,رنيك,جنرال مكانيك,5,1650,34316700,21892,20798,20798,-1094,-5,21889,-3,-0.01,20798,20798
611,ثنوسا,نوسازي‌وساختمان‌تهران‌,5,13370,159905200,12580,11960,11960,-620,-4.93,12570,-10,-0.08,11960,11960
612,ضملت3003,اختيارخ وبملت-4500-1400/03/19,4,39,113000,4,5,2,-2,-50,3,-1,-25,1,5
613,غپونه,نوش پونه مشهد,4,42410,715456700,17391,16870,16870,-521,-3,17350,-41,-0.24,16870,16870
614,كهرام,توليدي گرانيت بهسرام,4,154,16950164,113470,110066,110066,-3404,-3,113464,-6,-0.01,110066,110066
615,ضپاس7029,اختيارخ وپارس-2500-1400/07/28,4,4,2020000,463,510,500,37,7.99,505,42,9.07,500,510
616,ضصاد8039,اختيارخ وبصادر-1400-1400/08/12,4,19,11372000,1,600,575,574,57400,599,598,59800,575,600
617,فلامي,لاميران‌,4,568,21731680,40270,38260,38260,-2010,-4.99,40270,0,0,38260,38260
618,ضملي7003,اختيارخ فملي-12000-1400/07/11,4,172,243386000,1604,720,1507,-97,-6.05,1415,-189,-11.78,720,2179
619,كيميا,معدني كيمياي زنجان گستران,4,4827,78153957,17043,16191,16191,-852,-5,17038,-5,-0.03,16191,16191
620,اخزا804,اسنادخزانه-م4بودجه98-000421,4,1152,1127709007,976249,976500,976501,252,0.03,978914,2665,0.27,976500,981800
621,تملي802,تسهيلات مسكن ب. ملي-ارديبهشت98,4,26,22685412,834023,792322,875723,41700,5,872516,38493,4.62,792322,875724
622,ضسپا8042,اختيارخ خساپا-1800-1400/08/26,4,22,4116000,250,190,153,-97,-38.8,187,-63,-25.2,153,191
623,قشهد,شهد,4,10613,205892200,20420,19400,19400,-1020,-5,20410,-10,-0.05,19400,19400
624,كصدف,كاشي صدف سرام استقلال آباده,4,2000,48984000,25249,24492,24492,-757,-3,25245,-4,-0.02,24492,24492
625,شدوص,دوده‌ صنعتي‌ پارس‌,4,12552,255182160,21390,20330,20330,-1060,-4.96,21370,-20,-0.09,20330,20330
626,قيستو,شركت قند بيستون,4,82901,1307348770,16091,15770,15770,-321,-1.99,16005,-86,-0.53,15770,15770
627,سخاش,سيمان‌خاش‌,4,588,74405520,133200,126540,126540,-6660,-5,133160,-40,-0.03,126540,126540
628,زنجان,صنايع كشاورزي وكود زنجان,4,2695,24392445,9330,9051,9051,-279,-2.99,9329,-1,-0.01,9051,9051
629,غبهنوش,بهنوش‌ ايران‌,4,900,58626000,68560,65140,65140,-3420,-4.99,68550,-10,-0.01,65140,65140
630,ثالوند,سرمايه گذاري مسكن الوند,4,20590,626162490,32011,30411,30411,-1600,-5,31940,-71,-0.22,30411,30411
631,وليز,ليزينگ‌ايران‌,4,3674,33029260,9460,8990,8990,-470,-4.97,9460,0,0,8990,8990
632,اخزا716,اسنادخزانه-م16بودجه97-000407,4,230,226512200,983974,984212,988997,5023,0.51,984836,862,0.09,984211,988999
633,ثباغ,شهر سازي و خانه سازي باغميشه,4,11747,133046522,11922,11326,11326,-596,-5,11916,-6,-0.05,11326,11326
634,اخزا818,اسنادخزانه-م18بودجه98-010614,4,23698,18436039550,777363,778500,775025,-2338,-0.3,777958,595,0.08,775021,778500
635,ضپنا8000,اختيارخ رمپنا-10000-1400/08/05,4,45,153500000,4000,3500,3400,-600,-15,3411,-589,-14.73,3400,3500
636,ضملت3000,اختيارخ وبملت-3000-1400/03/19,4,41,24600000,835,600,600,-235,-28.14,600,-235,-28.14,600,600
637,زقيام,كشت و دام قيام اصفهان,4,1532,41701040,28652,27220,27220,-1432,-5,28648,-4,-0.01,27220,27220
638,قشير,قند شيروان قوچان و بجنورد,4,101326,2456344892,25517,24242,24242,-1275,-5,25296,-221,-0.87,24242,24242
639,ثروتم,صندوق س. ثروت آفرين پارسيان-س,4,25680,1864884560,72979,72710,72107,-872,-1.19,72620,-359,-0.49,72107,72710
640,تملي701,تسهيلات مسكن ب. ملي-فروردين97,4,37,24234769,623805,654994,654994,31189,5,654994,31189,5,654993,654994
641,تملي707,تسهيلات مسكن ب. ملي-مهر97,4,36,32332683,855365,898131,898130,42765,5,898130,42765,5,898129,898131
642,فولاد2,فولاد مباركه اصفهان,4,142959000,1379783940000,9640,9660,9660,20,0.21,9652,12,0.12,9640,9660
643,ثنور,سرمايه گذاري كوه نور,4,6557,59780169,9398,9117,9117,-281,-2.99,9396,-2,-0.02,9117,9117
644,لابسا,آبسال‌,4,2120,98113600,48710,46280,46280,-2430,-4.99,48690,-20,-0.04,46280,46280
645,كگاز,شيشه‌ و گاز,4,1390,24269400,18370,17460,17460,-910,-4.95,18370,0,0,17460,17460
646,پلاسك,پلاسكوكار,4,3650,24783500,7140,6790,6790,-350,-4.9,7140,0,0,6790,6790
647,فن آوا,گروه فن آوا,4,2225,38574825,18249,17337,17337,-912,-5,18245,-4,-0.02,17337,17337
648,تپكو,توليدتجهيزات‌سنگين‌هپكو,3,7494,38886366,5405,5189,5189,-216,-4,5405,0,0,5189,5189
649,تملي703,تسهيلات مسكن ب. ملي-خرداد97,3,27,20529929,724163,760368,760367,36204,5,760368,36205,5,760367,760368
650,خفناور,مهندسي صنعتي روان فن آور,3,1814,84891572,48245,46798,46798,-1447,-3,48232,-13,-0.03,46798,46798
651,قنيشا,قند  نيشابور,3,483,29351910,63960,60770,60770,-3190,-4.99,63950,-10,-0.02,60770,60770
652,وسيزد,شركت س استان يزد,3,29200,35507200,1280,1216,1216,-64,-5,1280,0,0,1216,1216
653,تكشا,گسترش‌صنايع‌وخدمات‌كشاورزي‌,3,511,19009200,39150,37200,37200,-1950,-4.98,39150,0,0,37200,37200
654,كمند2,صندوق س. با درآمد ثابت كمند,3,105000000,105000000,10143,1,1,-10142,-99.99,1,-10142,-99.99,1,1
655,افران2,صندوق س افرا نماد پايدار-ثابت,3,8000000,8000000,13422,1,1,-13421,-99.99,1,-13421,-99.99,1,1
656,ضملت3004,اختيارخ وبملت-5000-1400/03/19,3,121,221000,6,2,1,-5,-83.33,2,-4,-66.67,1,2
657,وخاور2,بانك خاورميانه,3,56249994,471374949720,8380,8380,8380,0,0,8380,0,0,8380,8380
658,وبملت2,بانك ملت,3,395651811,1499799995320,3825,3700,3740,-85,-2.22,3791,-34,-0.89,3700,3825
659,اروند04,منفعت صبا اروند كاردان14001113,3,30,30000000,1000000,1000000,1000000,0,0,1000000,0,0,1000000,1000000
660,كسرام,پارس‌ سرام‌,3,2130,16379700,8090,7690,7690,-400,-4.94,8090,0,0,7690,7690
661,غفارس,شير پاستوريزه پگاه فارس,3,38492,659367960,18031,17130,17130,-901,-5,17989,-42,-0.23,17130,17130
662,برن0003پ01,برنج طارم0003تجارت مازندران(پ),3,350,96350000,278474,274000,275000,-3474,-1.25,275286,-3188,-1.14,274000,277000
663,همبين102,اختيارف ت مبين19752-01/02/10,3,62834,80427520,1262,1280,1280,18,1.43,1280,18,1.43,1280,1280
664,ضفلا3005,اختيارخ فولاد-9986-1400/03/19,3,113,29589210,193,339,190,-3,-1.55,187,-6,-3.11,185,190
665,ضترا8056,اختيارخ شتران-6000-1400/08/09,3,32,85390000,2947,2900,2200,-747,-25.35,2668,-279,-9.47,2200,2900
666,داسوه,داروسازي‌ اسوه‌,3,1135,31008200,28750,27320,27320,-1430,-4.97,28750,0,0,27320,27320
667,كابگن,توليدي و صنعتي آبگينه‌,3,42000,222348000,5191,5294,5294,103,1.98,5200,9,0.17,5294,5294
668,خمحور,توليدمحورخودرو,3,1205,63202250,55210,52450,52450,-2760,-5,55200,-10,-0.02,52450,52450
669,غديس,پاكديس,3,6829,86953657,13403,12733,12733,-670,-5,13399,-4,-0.03,12733,12733
670,زعف0008پ11,زعفران0008نگين سحرخيز(پ),3,57,6993988,120029,123489,121190,1161,0.97,122702,2673,2.23,119110,123489
671,اخزا722,اسنادخزانه-م22بودجه97-000428,3,288,281193907,973038,976900,976900,3862,0.4,976368,3330,0.34,955001,976900
672,فسا,پتروشيمي فسا,3,11600,19859200,1764,1712,1712,-52,-2.95,1764,0,0,1712,1712
673,اراد50,مرابحه عام دولت5-ش.خ0302,3,34700,34700000000,1000000,1000000,1000000,0,0,1000000,0,0,1000000,1000000
674,فبيرا,بسته‌ بندي‌ ايران‌,3,20185,60615555,3095,3003,3003,-92,-2.97,3094,-1,-0.03,3003,3003
675,غپاك,لبنيات‌ پاك‌,3,19024,541613280,29960,28470,28470,-1490,-4.97,29910,-50,-0.17,28470,28470
676,ومشان,س. فني و مهندسي مشانير,2,168,11691120,71742,69590,69590,-2152,-3,71739,-3,0,69590,69590
677,اخزا805,اسنادخزانه-م5بودجه98-000422,2,13,12710271,977000,975753,980000,3000,0.31,977713,713,0.07,975753,980000
678,خزر,فنرسازي‌زر,2,442,18422560,43870,41680,41680,-2190,-4.99,43870,0,0,41680,41680
679,ضسپا3005,اختيارخ خساپا-3000-1400/03/26,2,200,200000,2,1,1,-1,-50,1,-1,-50,1,1
680,ضخود7078,اختيارخ خودرو-3500-1400/07/07,2,20,220000,11,11,11,0,0,11,0,0,11,11
681,وسنا,سرمايه گذاري نيروگاهي ايران,2,1953,29386791,15512,15047,15047,-465,-3,15511,-1,-0.01,15047,15047
682,زشگزا,شير و گوشت زاگرس شهركرد,2,2925,22700925,8169,7761,7761,-408,-4.99,8168,-1,-0.01,7761,7761
683,اراد55,مرابحه عام دولت5-ش.خ 0209,2,1800,1718000000,969999,950000,960000,-9999,-1.03,954444,-15555,-1.6,950000,960000
684,ضمخا7075,اختيارخ اخابر-9000-1400/07/28,2,20,9000000,452,450,450,-2,-0.44,450,-2,-0.44,450,450
685,وسرمد,بيمه  سرمد,2,2921,17017746,6006,5826,5826,-180,-3,6006,0,0,5826,5826
686,هفجر102,اختيارف ت بفجر26401-01/02/11,2,5000,2385000,496,477,477,-19,-3.83,477,-19,-3.83,477,477
687,زعف0008پ15,زعفران0008پوشالمعمول طلاسرخ(پ),2,125,10870000,88348,86000,88000,-348,-0.39,86960,-1388,-1.57,86000,88000
688,تملي803,تسهيلات مسكن ب. ملي-خرداد98,2,22,19726602,900758,945795,855721,-45037,-5,896664,-4094,-0.45,855721,945795
689,ثنام,س ساختماني ب نام آوران مهندسي,2,1420,22938680,16653,16154,16154,-499,-3,16652,-1,-0.01,16154,16154
690,ضفلا3006,اختيارخ فولاد-11413-1400/03/19,2,2,16824,5,28,9,4,80,6,1,20,3,9
691,ضپيك7041,اختيارخ تاپيكو-9000-00/07/18,2,10,19000000,1940,1900,1900,-40,-2.06,1900,-40,-2.06,1900,1900
692,وايران,ليزينگ ايرانيان,2,4394,51541620,12340,11730,11730,-610,-4.94,12340,0,0,11730,11730
693,وحافظ,بيمه حافظ,2,250,15771000,65712,63084,63084,-2628,-4,65703,-9,-0.01,63084,63084
694,مفاخر,توسعه فناوري اطلاعات خوارزمي,2,1122,48462546,45466,43193,43193,-2273,-5,45457,-9,-0.02,43193,43193
695,زكشت,كشاورزي مكانيزه اصفهان كشت,2,100125,3734862750,39265,37302,37302,-1963,-5,38736,-529,-1.35,37302,37302
696,غمهرا,توليدي‌مهرام‌,2,100,11556000,121640,115560,115560,-6080,-5,121640,0,0,115560,115560
697,سصفها,سيمان‌اصفهان‌,2,95,11357250,125840,119550,119550,-6290,-5,125840,0,0,119550,119550
698,زعف0008پ09,زعفران0008نگين نوين(پ),2,1000,118830000,117624,118830,118830,1206,1.03,118830,1206,1.03,118830,118830
699,وسصفا,شركت س استان اصفهان,2,10000,10170000,1070,1017,1017,-53,-4.95,1070,0,0,1017,1017
700,نبروج,نساجي بروجرد,2,2682,15909624,5816,5932,5932,116,1.99,5816,0,0,5932,5932
701,هكوير110,اختيارف ت كوير-19200-01/10/05,2,69110,37319400,540,540,540,0,0,540,0,0,540,540
702,ضخود4000,اختيارخ خودرو-1400-1400/04/02,2,2,700000,450,350,350,-100,-22.22,350,-100,-22.22,350,350
703,ثرود,سرمايه‌گذاري مسكن زاينده رود,2,20506,394904548,20271,19258,19258,-1013,-5,20242,-29,-0.14,19258,19258
704,آ س پ,آ.س.پ,2,677,10370286,16124,15318,15318,-806,-5,16123,-1,-0.01,15318,15318
705,ضخود4004,اختيارخ خودرو-2500-1400/04/02,2,4,48000,10,39,3,-7,-70,12,2,20,3,39
706,كپرور,فرآوري زغال سنگ پروده طبس,2,490,15058190,32348,30731,30731,-1617,-5,32346,-2,-0.01,30731,30731
707,تملي808,تسهيلات مسكن ب. ملي-آبان98,2,20,4825620,229792,241281,241281,11489,5,241281,11489,5,241281,241281
708,حتوكا,حمل‌ونقل‌توكا,2,750,15232500,21370,20310,20310,-1060,-4.96,21370,0,0,20310,20310
709,كتوكا,توليدي و خدمات صنايع نسوز توكا,2,430,13984030,34232,32521,32521,-1711,-5,34230,-2,-0.01,32521,32521
710,نطرين,عطرين نخ قم,2,1500,17056500,11969,11371,11371,-598,-5,11968,-1,-0.01,11371,11371
711,خكاوه,سايپا ديزل,2,82650,284563950,3549,3443,3443,-106,-2.99,3546,-3,-0.08,3443,3443
712,ولانا,شركت ليزينگ آريا دانا,2,4700,157703800,34591,33554,33554,-1037,-3,34574,-17,-0.05,33554,33554
713,اخزا718,اسنادخزانه-م18بودجه97-000525,2,24,22944120,959777,956005,956005,-3772,-0.39,956005,-3772,-0.39,956005,956005
714,غبهار,كشت وصنعت بهاران گلبهار خراسان,2,404,13110204,34158,32451,32451,-1707,-5,34156,-2,-0.01,32451,32451
715,دبالك,مواد اوليه دارويي البرز بالك,2,10339,201538127,20518,19493,19493,-1025,-5,20503,-15,-0.07,19493,19493
716,بشهاب,لامپ‌  پارس‌ شهاب‌,2,78,11020620,148720,141290,141290,-7430,-5,148710,-10,-0.01,141290,141290
717,سميعا002,سلف موازي استاندارد سميعا002,2,153680,201715603920,1312005,1312569,1312569,564,0.04,1312569,564,0.04,1312569,1312569
718,وصندوق2,سرمايه‌گذاري‌صندوق‌بازنشستگي‌,2,135000000,1742000000000,12900,13000,12900,0,0,12904,4,0.03,12900,13000
719,غشاذر,پگاه‌آذربايجان‌غربي‌,2,2780,26048600,9860,9370,9370,-490,-4.97,9860,0,0,9370,9370
720,دارا4,صندوق س. دارا الگوريتم-د,2,14486000,145164206000,10020,10021,10021,1,0.01,10021,1,0.01,10021,10021
721,سخواف,سيمان مجد خواف,2,10312,167631872,16758,16256,16256,-502,-3,16749,-9,-0.05,16256,16256
722,اخزا713,اسنادخزانه-م13بودجه97-000518,2,17,16407070,962091,968000,961010,-1081,-0.11,965122,3031,0.32,961010,968000
723,تملي807,تسهيلات مسكن ب. ملي-مهر98,2,23,14688421,608217,638627,638627,30410,5,638627,30410,5,638627,638627
724,ثپرديس,سرمايه گذاري مسكن پرديس,2,20647,197880848,10088,9584,9584,-504,-5,10081,-7,-0.07,9584,9584
725,زبينا,كشاورزي و دامپروري بينالود,2,2918,10755748,3880,3686,3686,-194,-5,3880,0,0,3686,3686
726,كفرآور,فرآورده هاي سيمان شرق,2,440,10067640,23588,22881,22881,-707,-3,23587,-1,0,22881,22881
727,جهرم,پتروشيمي جهرم,1,2750,4719000,1769,1716,1716,-53,-3,1769,0,0,1716,1716
728,كيسون,شركت كيسون,1,11606,129534566,11388,11161,11161,-227,-1.99,11387,-1,-0.01,11161,11161
729,اراد504,مرابحه عام دولت5-ش.خ0302,1,1000000,1000000000000,1000000,1000000,1000000,0,0,1000000,0,0,1000000,1000000
730,جم پيلن2,پلي پروپيلن جم - جم پيلن,1,1700000,116246000000,68310,68380,68380,70,0.1,68380,70,0.1,68380,68380
731,ضمخا7078,اختيارخ اخابر-8000-1400/07/28,1,4,2200000,644,550,550,-94,-14.6,550,-94,-14.6,550,550
732,لازما,كارخانه هاي صنعتي آزمايش,1,152,5007488,33962,32944,32944,-1018,-3,33961,-1,0,32944,32944
733,تكنار,مجتمع معادن مس تكنار,1,45,5117265,117233,113717,113717,-3516,-3,117231,-2,0,113717,113717
734,طمخا7072,اختيارف اخابر-28000-1400/07/28,1,1,18987000,17651,18987,18987,1336,7.57,18987,1336,7.57,18987,18987
735,كباده,توليد خاك نسوزاستقلال آباده,1,548,5086536,8840,9282,9282,442,5,8840,0,0,9282,9282
736,ضبدر3002,اختيارخ شبندر-18000-1400/03/30,1,1,3800000,3130,3800,3800,670,21.41,3800,670,21.41,3800,3800
737,حاريا,كشتيراني آريا,1,180,5047380,28908,28041,28041,-867,-3,28908,0,0,28041,28041
738,قلرست,قند لرستان‌,1,300,10206000,35810,34020,34020,-1790,-5,35810,0,0,34020,34020
739,فنفت,صنايع تجهيزات نفت,1,400,12809600,33014,32024,32024,-990,-3,33013,-1,0,32024,32024
740,فايرا2,آلومينيوم‌ايران‌,1,44090712,791869187520,18010,17960,17960,-50,-0.28,17960,-50,-0.28,17960,17960
741,ضمخا7067,اختيارخ اخابر-14000-1400/07/28,1,1,300000,350,300,300,-50,-14.29,300,-50,-14.29,300,300
742,كگل2,معدني و صنعتي گل گهر,1,7200000,104544000000,14520,14520,14520,0,0,14520,0,0,14520,14520
743,ضملت8041,اختيارخ وبملت-3500-1400/08/19,1,1,800000,1,800,800,799,79900,800,799,79900,800,800
744,اپرداز,آتيه داده پرداز,1,250,5041000,21225,20164,20164,-1061,-5,21225,0,0,20164,20164
745,افاد82,منفعت دولت8-ش.خاص لوتوس0205,1,2500,2400000000,965000,960000,960000,-5000,-0.52,960000,-5000,-0.52,960000,960000
746,فلات,گروه صنايع معادن فلات ايرانيان,1,1000,14781000,15238,14781,14781,-457,-3,15237,-1,-0.01,14781,14781
747,شپارس,بين‌ المللي‌ محصولات‌  پارس‌,1,240,5020800,22020,20920,20920,-1100,-5,22020,0,0,20920,20920
748,شخارك2,پتروشيمي‌ خارك‌,1,1400000,58660000000,41820,41900,41900,80,0.19,41900,80,0.19,41900,41900
749,انرژي12,نهادهاي مالي بورس انرژي,1,2200000,514536000000,233880,233880,233880,0,0,233880,0,0,233880,233880
750,بكاب,صنايع‌جوشكاب‌يزد,1,15,5124900,359640,341660,341660,-17980,-5,359630,-10,0,341660,341660
751,ضفلا7004,اختيارخ فولاد-9986-1400/07/25,1,10,23834000,1500,1700,1700,200,13.33,1700,200,13.33,1700,1700
752,ولصنم,ليزينگ‌صنعت‌ومعدن‌,1,500,5225000,10990,10450,10450,-540,-4.91,10990,0,0,10450,10450
753,ثامان,سامان‌ گستراصفهان‌,1,250,5392500,22700,21570,21570,-1130,-4.98,22700,0,0,21570,21570
754,ضملي7001,اختيارخ فملي-9000-1400/07/11,1,1,4060000,4250,4060,4060,-190,-4.47,4060,-190,-4.47,4060,4060
755,ضغدر3000,اختيارخ وغدير-6200-1400/03/26,1,3,9900000,3350,3300,3300,-50,-1.49,3300,-50,-1.49,3300,3300
756,اطلس2,صندوق س.توسعه اندوخته آينده-س,1,10000,10000,196454,1,1,-196453,-100,1,-196453,-100,1,1
757,ساذري,آذريت‌,1,300,1914900,6198,6383,6383,185,2.98,6198,0,0,6383,6383
758,وسكرمان,س.سهام عدالت استان كرمان,1,5600,5482400,1030,979,979,-51,-4.95,1030,0,0,979,979
759,البرز2,بيمه البرز,1,120000000,440280000000,3669,3669,3669,0,0,3669,0,0,3669,3669
760,ضمخا7074,اختيارخ اخابر-36000-1400/07/28,1,1,375000,350,375,375,25,7.14,375,25,7.14,375,375
761,نتوس,پشم‌ بافي‌ توس,1,3794,75978644,21080,20026,20026,-1054,-5,21072,-8,-0.04,20026,20026
762,خفولا,خدمات فني فولاد يزد,1,125,5149750,42472,41198,41198,-1274,-3,42471,-1,0,41198,41198
763,پست0008پ04,پسته فندقي32-30سبزدانه0008(پ),1,4,6588388,1734242,1647097,1647097,-87145,-5.02,1647097,-87145,-5.02,1647097,1647097
764,كترام,توليدي‌ كاشي‌ تكسرام‌,1,454,20874920,48400,45980,45980,-2420,-5,48400,0,0,45980,45980
765,سنفت001,سلف موازي استاندارد سنفت001,1,17200,20049438000,1165665,1165665,1165665,0,0,1165665,0,0,1165665,1165665
766,زير0003پ04,زيره سبز0003شركت مينوبذر(پ),1,1,566354,555282,566354,566354,11072,1.99,566354,11072,1.99,566354,566354
767,اراد22,مرابحه عام دولت2-ش.خ لوتوس0212,1,2500,2400000000,970000,960000,960000,-10000,-1.03,960000,-10000,-1.03,960000,960000
768,نهال2,صندوق س. طلاي سرخ نوويرا,1,100000,100000,8389,1,1,-8388,-99.99,1,-8388,-99.99,1,1
769,ضجار7039,اختيارخ وتجارت-2000-1400/07/21,1,1,280000,272,280,280,8,2.94,280,8,2.94,280,280
770,ثعمرا,عمران و توسعه شاهد,1,804,9959952,13039,12388,12388,-651,-4.99,13039,0,0,12388,12388
771,گواهي ظرفيت,گواهي ظرفيت نقدي,1,6679000,127555542000,18189,19098,19098,909,5,19098,909,5,19098,19098
772,آينده,بازرگاني آينده سازان بهشت پارس,1,300,5772900,19838,19243,19243,-595,-3,19838,0,0,19243,19243
773,ثغرب,شركت سرمايه گذاري مسكن شمالغرب,1,20000,150940000,7944,7547,7547,-397,-5,7940,-4,-0.05,7547,7547
774,ولراز,ليزينگ رازي,1,100,5437900,56060,54379,54379,-1681,-3,56059,-1,0,54379,54379
775,فخوز2,فولاد  خوزستان,1,6700000,104788000000,15590,15640,15640,50,0.32,15640,50,0.32,15640,15640
776,شپديس2,پتروشيمي پرديس,1,5806443,568450769700,98030,97900,97900,-130,-0.13,97900,-130,-0.13,97900,97900
777,وايرا,سرمايه گذاري صنايع ايران,1,2000,23634000,12182,11817,11817,-365,-3,12181,-1,-0.01,11817,11817
778,آبين,كشت و صنعت آبشيرين,1,5500,22671000,4206,4122,4122,-84,-2,4206,0,0,4122,4122
779,اراد374,مرابحه عام دولت3-ش.خ 0005,1,1000000,1000000000000,1000000,1000000,1000000,0,0,1000000,0,0,1000000,1000000
780,ثشرق,سرمايه گذاري مسكن شمال شرق,1,20000,130800000,6880,6540,6540,-340,-4.94,6880,0,0,6540,6540
781,ثاصفا,شركت‌ ساختمان‌ اصفهان‌,1,724,18997760,27621,26240,26240,-1381,-5,27618,-3,-0.01,26240,26240
782,ضپاس7030,اختيارخ وپارس-3000-1400/07/28,1,12,4500000,341,375,375,34,9.97,375,34,9.97,375,375
783,فنوال2,نورد آلومينيوم‌,1,32200000,793408000000,24440,24640,24640,200,0.82,24640,200,0.82,24640,24640
784,ارمغان2,ص سرمايه گذاري ارمغان ايرانيان,1,10837438,10837438,10145,1,1,-10144,-99.99,1,-10144,-99.99,1,1
785,اراد854,مرابحه عام دولت85-ش.خ010704,1,16467300,15591239640000,946000,946800,946800,800,0.08,946800,800,0.08,946800,946800
786,ضمخا7079,اختيارخ اخابر-5000-1400/07/28,1,1,4000000,1,4000,4000,3999,399900,4000,3999,399900,4000,4000
787,رتكو,كنترل‌خوردگي‌تكين‌كو,1,1745,28548200,17220,16360,16360,-860,-4.99,17220,0,0,16360,16360
788,داوه,داروسازي آوه سينا,1,1200,22978800,20156,19149,19149,-1007,-5,20154,-2,-0.01,19149,19149
789,اراد454,مرابحه عام دولت4-ش.خ 0107,1,47700,47700000000,988000,1000000,1000000,12000,1.21,1000000,12000,1.21,1000000,1000000
790,شستان,پتروشيمي گلستان,1,1382,5030480,3791,3640,3640,-151,-3.98,3791,0,0,3640,3640
791,ضپاس7028,اختيارخ وپارس-2000-1400/07/28,1,9,8730000,912,970,970,58,6.36,970,58,6.36,970,970
792,قنقش,قند نقش جهان,1,130,9138220,71728,70294,70294,-1434,-2,71725,-3,0,70294,70294
793,ضفلا3002,اختيارخ فولاد-6420-1400/03/19,1,9,36592200,2900,2900,2900,0,0,2900,0,0,2900,2900
794,غدام,خوراك‌  دام‌ پارس‌,1,52,19437600,393470,373800,373800,-19670,-5,393440,-30,-0.01,373800,373800
795,حپارسا,توسعه حمل و نقل ريلي پارسيان,1,3000,100293000,35190,33431,33431,-1759,-5,35178,-12,-0.03,33431,33431
796,وسگلستا,شركت س استان گلستان,1,500,588000,1237,1176,1176,-61,-4.93,1237,0,0,1176,1176
797,لپيام,گسترش صنايع پيام,1,1500,79693500,54772,53129,53129,-1643,-3,54758,-14,-0.03,53129,53129
798,تپمپي,پمپ‌ سازي‌ ايران‌,1,3000,51690000,18130,17230,17230,-900,-4.96,18130,0,0,17230,17230
799,صخابر102,صكوك اجاره مخابرات-3 ماهه 16%,1,2500,2400250000,965000,960100,960100,-4900,-0.51,960100,-4900,-0.51,960100,960100
800,فارس2,صنايع پتروشيمي خليج فارس,1,52742000,499994160000,9480,9480,9480,0,0,9480,0,0,9480,9480
801,زاگرس2,پتروشيمي زاگرس,1,200000,42307000000,211535,211535,211535,0,0,211535,0,0,211535,211535
802,فرآور2,فرآوري‌موادمعدني‌ايران‌,1,2000000,50080000000,26350,25040,25040,-1310,-4.97,25040,-1310,-4.97,25040,25040
803,حآسا,آسيا سير ارس,1,154,5802566,39662,37679,37679,-1983,-5,39661,-1,0,37679,37679
804,آگاس2,صندوق س.هستي بخش آگاه-س,1,100000,100000,64313,1,1,-64312,-100,1,-64312,-100,1,1
805,ضگل8072,اختيار خ كگل-10000-1400/08/23,1,10,70000000,1,7000,7000,6999,699900,7000,6999,699900,7000,7000
806,شغدير2,پتروشيمي غدير,1,1400000,96600000000,70710,69000,69000,-1710,-2.42,69000,-1710,-2.42,69000,69000
807,طمخا7068,اختيارف اخابر-16000-1400/07/28,1,2,15248000,7314,7624,7624,310,4.24,7624,310,4.24,7624,7624
808,سدشت,صنايع سيمان دشتستان,1,80,5043200,66350,63040,63040,-3310,-4.99,66350,0,0,63040,63040
809,پارس2,پتروشيمي پارس,1,900000,134217000000,148990,149130,149130,140,0.09,149130,140,0.09,149130,149130
810,سپرمي,پرميت‌,1,300,2708700,8940,9029,9029,89,1,8940,0,0,9029,9029
811,اراد484,مرابحه عام دولت4-ش.خ 0009,1,107200,107200000000,999998,1000000,1000000,2,0,1000000,2,0,1000000,1000000
812,كساوه,صنايع‌ كاشي‌ و سراميك‌ سينا,1,400,26488000,69700,66220,66220,-3480,-4.99,69690,-10,-0.01,66220,66220
813,زير0003پ01,زيره سبز0003كيميابذر(پ),1,1,566354,536864,566354,566354,29490,5.49,566354,29490,5.49,566354,566354
814,كاسپين,داروسازي كاسپين تامين,1,1000,24453000,25739,24453,24453,-1286,-5,25737,-2,-0.01,24453,24453
815,شبهرن2,نفت‌ بهران‌,1,7315000,78343650000,10810,10710,10710,-100,-0.93,10710,-100,-0.93,10710,10710
816,اخابر2,مخابرات ايران,1,25000000,185500000000,7420,7420,7420,0,0,7420,0,0,7420,7420
817,ثجوان,تامين مسكن جوانان,1,12728,130105616,10538,10222,10222,-316,-3,10534,-4,-0.04,10222,10222
818,ثزاگرس,سرمايه گذاري توسعه عمران زاگرس,1,121,6550456,56985,54136,54136,-2849,-5,56983,-2,0,54136,54136
819,زعف0008پ10,زعفران0008نگين طلاي سرخ(پ),1,42,5082000,120381,121000,121000,619,0.51,121000,619,0.51,121000,121000
820,وبشهر2,توسعه‌ صنايع‌ بهشهر(هلدينگ,1,9931865,93756805600,9440,9440,9440,0,0,9440,0,0,9440,9440
821,شسينا,صنايع‌شيميايي‌سينا,1,60,7347600,128900,122460,122460,-6440,-5,128900,0,0,122460,122460
822,تكمبا,كمباين‌ سازي‌ ايران‌,1,1000,7220000,7600,7220,7220,-380,-5,7600,0,0,7220,7220
823,فجام,جام‌دارو,1,550,5071000,9700,9220,9220,-480,-4.95,9700,0,0,9220,9220
824,ضسپا3000,اختيارخ خساپا-1400-1400/03/26,1,2,280000,239,140,140,-99,-41.42,140,-99,-41.42,140,140
825,ونوين2,بانك‌اقتصادنوين‌,1,25000000,103300000000,4132,4132,4132,0,0,4132,0,0,4132,4132
