,نماد,نام,تعداد,حجم,ارزش,دیروز,اولین,آخرین معامله - مقدار,آخرین معامله - تغییر,آخرین معامله - درصد,قیمت پایانی - مقدار,قیمت پایانی - تغییر,قیمت پایانی - درصد,کمترین,بیشترین
2,پالايش,صندوق پالايشي يکم-سهام,32817,31306160,2553721022480,81440,80500,81300,-140,-0.17,81570,130,0.16,79090,83430
3,شپنا,پالايش نفت اصفهان,25980,162908660,2288555785720,14140,13860,13900,-240,-1.7,14050,-90,-0.64,13860,14570
4,شستا,سرمايه گذاري تامين اجتماعي,24807,83528311,961348742900,11440,11520,11440,0,0,11510,70,0.61,11220,11770
5,سپيدار,سپيدار سيستم آسيا,22322,2070784,133043763409,65403,64510,65340,-63,-0.1,64248,-1155,-1.77,64095,65960
6,شتران,پالايش نفت تهران,21418,179232061,1842881877510,10050,9900,10330,280,2.79,10280,230,2.29,9850,10590
7,دارا يكم,صندوق واسطه گري مالي يكم-سهام,18461,10645997,1545689341020,145340,144100,143980,-1360,-0.94,145190,-150,-0.1,143220,147250
8,اپال,فرآوري معدني اپال كاني پارس,16782,24209820,438341590800,17380,17450,18240,860,4.95,18110,730,4.2,17450,18290
9,زملارد,كشاورزي و دامپروري ملارد شير,16269,4503175,177657700682,37711,38420,39973,2262,6,39452,1741,4.62,36960,39973
10,فملي,ملي‌ صنايع‌ مس‌ ايران‌,14067,56622241,738306083250,13230,12990,13010,-220,-1.66,13040,-190,-1.44,12970,13400
11,فولاد,فولاد مباركه اصفهان,11833,55662597,777505009350,13800,13640,13930,130,0.94,13970,170,1.23,13600,14300
12,شاروم,پتروشيمي اروميه,11744,9683276,189755746177,18785,18800,19912,1127,6,19596,811,4.32,18630,19912
13,بترانس,ايران‌ ترانسفو,10931,225573094,710133889920,3000,3040,3120,120,4,3150,150,5,3000,3180
14,رافزا,رايان هم افزا,10005,2697068,276222360001,96991,102810,102810,5819,6,102416,5425,5.59,97000,102810
15,خساپا,سايپا,9664,357589439,875005528720,2480,2470,2440,-40,-1.61,2450,-30,-1.21,2440,2480
16,بوعلي,پتروشيمي بوعلي سينا,9512,3200895,143455628430,44680,44500,45300,620,1.39,44820,140,0.31,43800,45550
17,شگويا,پتروشيمي تندگويان,9307,92671680,947833384304,9715,9523,10297,582,5.99,10228,513,5.28,9523,10297
18,ثبهساز,بهساز كاشانه تهران,9251,93889959,226044838750,2410,2450,2370,-40,-1.66,2410,0,0,2370,2470
19,پترول,گروه پتروشيمي س. ايرانيان,9054,69829473,750281771120,10920,10710,10710,-210,-1.92,10740,-180,-1.65,10710,11000
20,كزغال,زغال سنگ پروده طبس,8751,6150290,227581220661,37680,37499,36927,-753,-2,37003,-677,-1.8,36927,37800
21,شبندر,پالايش نفت بندرعباس,7927,22743646,629069815490,28000,27440,27440,-560,-2,27660,-340,-1.21,27440,28490
22,وكبهمن,مديريت سرمايه گذاري كوثربهمن,7184,1772450,21324184438,12173,12033,11997,-176,-1.45,12112,-61,-0.5,11960,12200
23,ثاميد,توسعه و عمران اميد,6310,61350199,101689379570,1660,1670,1650,-10,-0.6,1660,0,0,1630,1690
24,آبادا,توليد نيروي برق آبادان,5993,2170996,30994613010,14300,14350,14180,-120,-0.84,14290,-10,-0.07,14130,14460
25,خگستر,گسترش‌سرمايه‌گذاري‌ايران‌خودرو,5755,129292120,391357495150,3080,3060,3020,-60,-1.95,3030,-50,-1.62,3020,3070
26,ذوب,سهامي ذوب آهن  اصفهان,5742,83223764,345779768216,4138,4100,4133,-5,-0.12,4155,17,0.41,4074,4235
27,زنگان,صنعت روي زنگان,5618,3580648,371630579925,105089,102988,104980,-109,-0.1,103789,-1300,-1.24,102988,106800
28,بپيوند,برق و انرژي پيوندگستر پارس,5495,2798222,39953149319,14205,14121,14211,6,0.04,14264,59,0.42,14121,14470
29,خپارس,پارس‌ خودرو,5216,61489110,380866600960,6250,6210,6210,-40,-0.64,6190,-60,-0.96,6130,6350
30,ولپارس,ليزينگ پارسيان,5186,6978358,35801956960,5220,5250,5120,-100,-1.92,5160,-60,-1.15,5120,5260
31,آريا,پليمر آريا ساسول,5146,1614845,146327356056,90278,90370,91300,1022,1.13,90614,336,0.37,89011,91770
32,خودرو,ايران‌ خودرو,5127,123895903,322767657850,2650,2640,2600,-50,-1.89,2610,-40,-1.51,2600,2640
33,تبرك,گروه كارخانجات صنعتي تبرك,5032,25966178,519370285588,19329,20488,19497,168,0.87,20002,673,3.48,19100,20488
34,سيتا,سرمايه گذاري سيمان تامين,4756,5436537,82998054870,15540,15570,15250,-290,-1.87,15270,-270,-1.74,15230,15570
35,وخارزم,سرمايه گذاري خوارزمي,4729,26445387,160827919150,5950,6140,6090,140,2.35,6080,130,2.18,5900,6200
36,بگيلان,توسعه مسير برق گيلان,4678,1572994,35108011998,22515,22220,22140,-375,-1.67,22381,-134,-0.6,22070,23000
37,غپاك,لبنيات‌ پاك‌,4669,17778074,476784135370,26850,26320,27350,500,1.86,26820,-30,-0.11,26320,27930
38,سمگا,گروه سرمايه گذاري ميراث فرهنگي,4460,15673043,480822340476,29065,29100,30808,1743,6,30678,1613,5.55,29100,30808
39,خزاميا,زامياد,4336,37097113,310248754050,8340,8350,8590,250,3,8360,20,0.24,8180,8610
40,كلر,كلر پارس,4164,2672909,381983662674,135849,139980,143999,8150,6,142909,7060,5.2,137332,143999
41,كرمان,س. توسعه و عمران استان كرمان,4067,5210410,254671250130,49828,49010,48832,-996,-2,48877,-951,-1.91,48832,50100
42,حكشتي,كشتيراني جمهوري اسلامي ايران,4049,14724444,291983467230,20090,19900,19690,-400,-1.99,19830,-260,-1.29,19690,20250
43,فارس,صنايع پتروشيمي خليج فارس,3970,29685952,306000488810,10460,10260,10260,-200,-1.91,10310,-150,-1.43,10260,10490
44,پيزد,مجتمع صنايع لاستيك يزد,3950,470465,32417035820,67932,67700,69500,1568,2.31,68545,613,0.9,67600,69904
45,زكوثر,سرمايه گذاري كشاورزي كوثر,3856,6771415,140765602960,21810,20530,21030,-780,-3.58,20790,-1020,-4.68,20140,21360
46,ثامان,سامان‌ گستراصفهان‌,3814,12200834,290737401900,22890,22440,24260,1370,5.99,23830,940,4.11,22440,24260
47,سصوفي,سيمان‌ صوفيان‌,3687,11357411,238825194090,20810,21200,21570,760,3.65,21030,220,1.06,20400,21970
48,دتوليد,داروسازي توليد دارو,3559,7452793,205592043529,27034,26494,28200,1166,4.31,27586,552,2.04,26494,28500
49,فروي,ذوب روي اصفهان,3551,2335419,145938410767,62625,61373,63000,375,0.6,62489,-136,-0.22,61373,63720
50,وپارس,بانك‌پارسيان‌,3288,89799886,272093160020,3070,3030,3030,-40,-1.3,3030,-40,-1.3,3010,3110
51,غگل,گلوكوزان‌,3279,30619475,107118976140,3550,3550,3480,-70,-1.97,3500,-50,-1.41,3480,3600
52,زبينا,كشاورزي و دامپروري بينالود,3165,32976243,132814970071,3852,3930,4083,231,6,4028,176,4.57,3885,4083
53,كاما,باما,3042,14156820,198440301910,14280,14270,14000,-280,-1.96,14020,-260,-1.82,14000,14270
54,لابسا,آبسال‌,2979,4228840,237261449280,53080,54810,56220,3140,5.92,56110,3030,5.71,54000,56260
55,وسينا,بانك سينا,2974,59552284,213437973090,3540,3690,3530,-10,-0.28,3580,40,1.13,3480,3690
56,مرقام,ايران‌ارقام‌,2893,7600200,154354873980,19430,19790,20000,570,2.93,20310,880,4.53,19790,20590
57,كمند,صندوق س. با درآمد ثابت كمند,2820,112011338,1135548566111,10128,10137,10138,10,0.1,10138,10,0.1,10137,10141
58,فخوز,فولاد  خوزستان,2778,15291412,234467712230,15170,14910,15300,130,0.86,15330,160,1.05,14900,15700
59,سغرب,سيمان‌غرب‌,2731,5221508,197027981860,37230,36490,38770,1540,4.14,37730,500,1.34,36490,39460
60,شپارس,بين‌ المللي‌ محصولات‌  پارس‌,2715,11664990,277685426440,23360,23500,24160,800,3.42,23810,450,1.93,23000,24730
61,ماديرا,صنايع ماشين هاي اداري ايران,2652,14200476,123588444262,8848,8710,8770,-78,-0.88,8703,-145,-1.64,8672,8921
62,ولغدر,ليزينگ‌خودروغدير,2626,7432145,181837574650,23280,23930,24670,1390,5.97,24470,1190,5.11,23600,24670
63,فايرا,آلومينيوم‌ايران‌,2582,20847985,343096482400,16030,16700,16600,570,3.56,16460,430,2.68,15750,16750
64,وغدير,سرمايه‌گذاري‌غدير(هلدينگ‌,2543,12744256,151486038940,11980,11780,11780,-200,-1.67,11890,-90,-0.75,11750,12200
65,غالبر,لبنيات‌ كالبر,2529,6568310,127014853450,18630,19000,19740,1110,5.96,19340,710,3.81,18700,19740
66,شپترو,پتروشيمي آبادان,2510,26009111,162192725783,6184,6070,6171,-13,-0.21,6236,52,0.84,6070,6369
67,صبا,سرمايه گذاري صبا تامين,2478,5638974,45648396349,8073,8140,8019,-54,-0.67,8082,9,0.11,7970,8290
68,غبهنوش,بهنوش‌ ايران‌,2477,1830743,132825435500,72230,70790,72480,250,0.35,72550,320,0.44,70790,75200
69,شبريز,پالايش نفت تبريز,2475,4933277,156239091000,31960,31340,31400,-560,-1.75,31670,-290,-0.91,31330,32990
70,والبر,سرمايه‌ گذاري‌ البرز(هلدينگ‌,2419,8829990,163417065770,17900,18190,18970,1070,5.98,18510,610,3.41,17920,18970
71,بجهرم,توسعه مولد نيروگاهي جهرم,2413,25297863,77350674671,2979,3000,3080,101,3.39,3058,79,2.65,2965,3130
72,رمپنا,گروه مپنا (سهامي عام),2370,11627562,217117864600,18790,18600,18820,30,0.16,18670,-120,-0.64,18420,19190
73,وبملت,بانك ملت,2349,52228275,223835149490,4340,4340,4260,-80,-1.84,4290,-50,-1.15,4260,4400
74,نطرين,عطرين نخ قم,2339,14799993,178603892377,11556,11330,12249,693,6,12068,512,4.43,11330,12249
75,زشگزا,شير و گوشت زاگرس شهركرد,2308,13499488,116151120870,8315,8500,8680,365,4.39,8604,289,3.48,8149,8810
76,فرابورس,فرابورس ايران,2277,3267119,106408124694,32937,32900,32279,-658,-2,32569,-368,-1.12,32279,33490
77,چكاپا,گروه صنايع كاغذ پارس,2195,17651201,89208526650,5150,5050,5050,-100,-1.94,5050,-100,-1.94,5050,5130
78,نوري,پتروشيمي نوري,2192,1742270,110866200210,63240,61980,63300,60,0.09,63630,390,0.62,61980,65000
79,ثاخت,بين‌المللي‌توسعه‌ساختمان,2111,29414377,80379356410,2770,2740,2720,-50,-1.81,2730,-40,-1.44,2720,2810
80,تليسه,دامداري تليسه نمونه,2107,14876927,66590112374,4474,4450,4478,4,0.09,4476,2,0.04,4403,4599
81,ونوين,بانك‌اقتصادنوين‌,2071,43187646,196747361890,4640,4550,4550,-90,-1.94,4560,-80,-1.72,4550,4670
82,قنيشا,قند  نيشابور,2028,1852474,126788319490,68360,69450,67000,-1360,-1.99,68440,80,0.12,67000,71000
83,امين يكم,صندوق درآمد ثابت امين يكم فردا,1985,50065593,507226610772,10125,10130,10133,8,0.08,10131,6,0.06,10126,10140
84,دزهراوي,داروسازي‌زهراوي‌,1964,8341608,73389608190,8840,9020,8670,-170,-1.92,8800,-40,-0.45,8670,9080
85,حفاري,حفاري شمال,1957,16680507,127660763000,7760,7720,7730,-30,-0.39,7650,-110,-1.42,7610,7880
86,وبصادر,بانك صادرات ايران,1950,46308270,122767186530,2680,2690,2640,-40,-1.49,2650,-30,-1.12,2640,2700
87,واتي,سرمايه‌ گذاري‌ آتيه‌ دماوند,1950,21117116,268830950080,12070,12460,12790,720,5.97,12730,660,5.47,12090,12790
88,آوا,صندوق س.سهام آواي معيار-س,1950,17560196,121488664496,6931,6870,6906,-25,-0.36,6918,-13,-0.19,6812,7010
89,خودكفا,اقتصادي و خودكفايي آزادگان,1938,6908771,154710395160,22642,22190,22670,28,0.12,22393,-249,-1.1,22190,23000
90,خكاوه,سايپا ديزل,1912,36592046,136396666271,3662,3771,3651,-11,-0.3,3727,65,1.77,3606,3771
91,كمنگنز,معادن‌منگنزايران‌,1892,1424356,129159860100,90510,92430,88700,-1810,-2,90680,170,0.19,88700,93720
92,سشمال,سيمان‌ شمال‌,1887,8122179,95049474830,11910,11680,11800,-110,-0.92,11700,-210,-1.76,11680,11900
93,شيران,س. صنايع‌شيميايي‌ايران,1876,5070887,148553206750,28440,27970,29310,870,3.06,29300,860,3.02,27970,29800
94,كماسه,تامين‌ ماسه‌ ريخته‌گري‌,1875,2865666,130332548040,43190,44000,45780,2590,6,45480,2290,5.3,43910,45780
95,سرو,صندوق س سروسودمند مدبران-سهام,1862,2426061,175043496190,72410,71850,71990,-420,-0.58,72150,-260,-0.36,70050,73250
96,چدن,توليدي چدن سازان,1813,3650690,91103120640,25280,24780,25210,-70,-0.28,24960,-320,-1.27,24780,25690
97,كچاد,معدني‌وصنعتي‌چادرملو,1801,5354815,127150203590,23870,23510,23800,-70,-0.29,23750,-120,-0.5,23400,24100
98,كسرا,سراميك‌هاي‌صنعتي‌اردكان‌,1791,4623996,98524578360,20950,21400,21190,240,1.15,21310,360,1.72,20830,21810
99,ومعلم,بيمه معلم,1761,12967935,63091512904,4728,4654,4918,190,4.02,4865,137,2.9,4654,4980
100,وپست,پست بانك ايران,1760,15688900,364547280430,22040,22400,23360,1320,5.99,23240,1200,5.44,22000,23360
101,سبزوا,سيمان لار سبزوار,1753,16506778,60176728853,3507,3560,3717,210,5.99,3646,139,3.96,3480,3717
102,سفارس,سيمان فارس و خوزستان,1739,6839091,136281690070,20240,19860,19840,-400,-1.98,19930,-310,-1.53,19840,20160
103,كي بي سي,شركت كي بي سي,1730,3520916,100095467662,27972,27413,28870,898,3.21,28429,457,1.63,27413,29570
104,ومعادن,توسعه‌معادن‌وفلزات‌,1727,8515740,111105047860,13250,12990,12990,-260,-1.96,13050,-200,-1.51,12990,13440
105,حتايد,تايدواترخاورميانه,1719,4517588,127106038280,28290,28300,28520,230,0.81,28140,-150,-0.53,27740,28770
106,وساپا,سرمايه‌گذاري‌ سايپا,1704,16950760,101632732430,6090,6000,5970,-120,-1.97,6000,-90,-1.48,5970,6110
107,سمازن,سيمان‌مازندران‌,1704,9914354,127514346320,13000,12740,13040,40,0.31,12860,-140,-1.08,12740,13190
108,حريل,ريل پردازسير,1684,15249615,89222236208,5944,6020,5830,-114,-1.92,5851,-93,-1.56,5826,6020
109,اخابر,مخابرات ايران,1670,14026140,149263670960,10820,10610,10610,-210,-1.94,10640,-180,-1.66,10610,10920
110,غپينو,پارس‌ مينو,1654,10755353,72957861530,6870,6800,6750,-120,-1.75,6780,-90,-1.31,6740,6950
111,رنيك,جنرال مكانيك,1626,3321295,80018788206,22973,23360,24351,1378,6,24093,1120,4.88,23360,24351
112,اعتلا,شركت سرمايه گذاري اعتلاء البرز,1615,10835778,88738337928,8279,8114,8360,81,0.98,8189,-90,-1.09,8114,8470
113,وشهر,بانك شهر,1580,10570736,73408668802,6819,7091,6833,14,0.21,6945,126,1.85,6700,7091
114,فسپا,گروه‌صنعتي‌سپاهان‌,1568,3404174,136765853110,39260,38520,40760,1500,3.82,40180,920,2.34,38520,41190
115,تاپيكو,س. نفت و گاز و پتروشيمي تأمين,1566,11923893,150371284160,12780,12600,12570,-210,-1.64,12610,-170,-1.33,12530,12990
116,ولساپا,ليزينگ رايان‌ سايپا,1555,24559032,87586112440,3630,3590,3560,-70,-1.93,3570,-60,-1.65,3560,3640
117,وثوق,سرمايه گذاري وثوق امين,1540,4574580,95070274185,21167,20744,20744,-423,-2,20782,-385,-1.82,20744,21158
118,كرازي,كارخانجات‌توليدي‌شيشه‌رازي‌,1522,2931547,68878806160,23270,23030,24020,750,3.22,23500,230,0.99,22810,24300
119,آگاس,صندوق س.هستي بخش آگاه-س,1520,1178051,84451711480,72124,71309,71117,-1007,-1.4,71688,-436,-0.6,70756,72750
120,زاگرس,پتروشيمي زاگرس,1503,735805,158358260403,218979,214600,216460,-2519,-1.15,215218,-3761,-1.72,214600,220000
121,كالا,بورس كالاي ايران,1500,2104978,71695855200,34010,34980,33810,-200,-0.59,34060,50,0.15,33700,34980
122,بورس,بورس اوراق بهادار تهران,1497,1862861,69777024070,37520,38240,36950,-570,-1.52,37460,-60,-0.16,36850,38300
123,شلرد,كود شيميايي اوره لردگان,1486,13237722,99013608337,7609,7457,7460,-149,-1.96,7480,-129,-1.7,7457,7590
124,غشهداب,كشت و صنعت شهداب ناب خراسان,1485,20530217,84925896245,4220,4137,4140,-80,-1.9,4137,-83,-1.97,4136,4195
125,آسيا,بيمه آسيا,1483,23817362,56763360850,2420,2400,2380,-40,-1.65,2380,-40,-1.65,2380,2430
126,وتجارت,بانك تجارت,1483,27028087,77604291360,2900,2900,2850,-50,-1.72,2880,-20,-0.69,2850,2900
127,ولتجار,واسپاري تجارت وسرمايه ايرانيان,1479,8461986,73769833612,8533,8787,8688,155,1.82,8718,185,2.17,8363,8788
128,وپاسار,بانك  پاسارگاد,1479,9470132,123415959520,13000,13100,13020,20,0.15,13030,30,0.23,12950,13150
129,كيان,صندوق س. با درآمد ثابت كيان,1472,18230254,505937599860,27725,27752,27753,28,0.1,27753,28,0.1,27751,27756
130,كحافظ,كاشي‌ وسراميك‌ حافظ‌,1452,8663423,107030843480,11740,12010,12440,700,5.96,12350,610,5.2,11960,12440
131,وملل,اعتباري ملل,1450,33420588,456445279322,13934,13656,13656,-278,-2,13658,-276,-1.98,13656,13800
132,ستران,سيمان‌ تهران‌,1422,2058127,52754408990,25750,25840,25460,-290,-1.13,25630,-120,-0.47,25330,26230
133,دسانكو,داروسازي سبحان انكولوژي,1379,2920569,43267297201,14681,14388,15070,389,2.65,14796,115,0.78,14388,15100
134,ومهان,گروه توسعه مالي مهر آيندگان,1379,8017010,114994342688,14484,14260,14195,-289,-2,14344,-140,-0.97,14195,14840
135,اعتماد,صندوق س.اعتماد آفرين پارسيان-د,1367,24424690,869890998110,35590,35614,35619,29,0.08,35615,25,0.07,35613,35619
136,خكرمان,گروه اقتصادي كرمان خودرو,1352,15545540,66221723969,4271,4300,4187,-84,-1.97,4260,-11,-0.26,4186,4389
137,غسالم,سالمين‌,1352,8753909,38655821800,4440,4480,4380,-60,-1.35,4420,-20,-0.45,4360,4490
138,ثباغ,شهر سازي و خانه سازي باغميشه,1337,3138598,50267416014,15690,15382,16360,670,4.27,15997,307,1.96,15377,16490
139,دسينا,داروسازي‌ سينا,1328,2431851,62695106690,25290,26650,25840,550,2.17,25780,490,1.94,25290,26650
140,فولاژ,فولاد آلياژي ايران,1324,7099650,144658147990,20740,20810,20330,-410,-1.98,20380,-360,-1.74,20330,21000
141,دكپسول,توليد ژلاتين كپسول ايران,1309,1940122,66315043652,34073,35750,35200,1127,3.31,34181,108,0.32,33392,35750
142,فوكا,فولاد كاويان,1301,7059103,88854814691,12302,12360,12671,369,3,12587,285,2.32,12070,12671
143,رتاپ,تجارت الكترونيك  پارسيان,1298,6902639,51047744600,7240,7100,7470,230,3.18,7400,160,2.21,7100,7540
144,سيستم,همكاران سيستم,1281,4400537,128931812280,29850,30080,29260,-590,-1.98,29300,-550,-1.84,29260,30080
145,بركت,گروه دارويي بركت,1256,3053041,98033146510,32760,32110,32110,-650,-1.98,32110,-650,-1.98,32110,32110
146,كپارس,كاشي‌ پارس‌,1254,682891,109500351620,153770,155000,162990,9220,6,160350,6580,4.28,155000,162990
147,غفارس,شير پاستوريزه پگاه فارس,1246,3469913,64847172752,18749,18477,18375,-374,-1.99,18688,-61,-0.33,18375,19457
148,بسويچ,پارس‌سويچ‌,1240,1446832,78896828620,52420,53240,55370,2950,5.63,54530,2110,4.03,51500,55560
149,خمحركه,نيرو محركه‌,1229,7626459,35957859580,4770,4710,4680,-90,-1.89,4730,-40,-0.84,4680,4830
150,فروس,فروسيليس‌ ايران‌,1222,12465096,65886349000,5010,5200,5310,300,5.99,5290,280,5.59,5090,5310
151,قرن,پديده شيمي قرن,1210,520774,34702726490,66440,65140,66490,50,0.08,66580,140,0.21,65140,67900
152,دماوند,توليد نيروي برق دماوند,1205,1384117,67001865566,49315,48600,48329,-986,-2,48408,-907,-1.84,48329,50000
153,ونيرو,سرمايه‌گذاري‌نيرو,1183,15507307,44333418120,2850,2880,2850,0,0,2860,10,0.35,2830,2890
154,تكمبا,كمباين‌ سازي‌ ايران‌,1182,8904753,72668046490,8310,8370,8180,-130,-1.56,8160,-150,-1.81,8150,8370
155,تملت,تامين سرمايه بانك ملت,1154,8084073,47878730200,6030,5910,5910,-120,-1.99,5920,-110,-1.82,5910,6040
156,فباهنر,مس‌ شهيدباهنر,1150,2509468,62649633930,25120,25190,25300,180,0.72,24970,-150,-0.6,24620,25470
157,رانفور,خدمات‌انفورماتيك‌,1124,2335879,54060384370,23490,23890,23040,-450,-1.92,23250,-240,-1.02,23030,23890
158,ثشاهد,سرمايه‌ گذاري‌ شاهد,1122,3248162,58543862310,18360,18010,18000,-360,-1.96,18020,-340,-1.85,18000,18260
159,وسنا,سرمايه گذاري نيروگاهي ايران,1115,4660021,77505921580,16290,17104,16010,-280,-1.72,16632,342,2.1,15700,17104
160,غبشهر,صنعتي‌ بهشهر,1085,4523222,104185866280,21760,22850,23060,1300,5.97,23030,1270,5.84,22210,23060
161,وصنعت,سرمايه گذاري توسعه صنعت وتجارت,1065,7091973,48475919380,6950,6890,6820,-130,-1.87,6840,-110,-1.58,6820,6980
162,كاوه,فولاد كاوه جنوب كيش,1056,4295642,92443924070,21380,21010,21530,150,0.7,21510,130,0.61,20970,21880
163,ختوقا,قطعات‌ اتومبيل‌ ايران‌,1054,16022422,41738408820,2650,2650,2600,-50,-1.89,2610,-40,-1.51,2600,2650
164,زشريف,كشت وصنعت شريف آباد,1054,13730630,76212988468,5237,5551,5551,314,6,5551,314,6,5451,5551
165,لبوتان,گروه‌صنعتي‌بوتان‌,1051,754287,50747015160,67810,68220,66490,-1320,-1.95,67320,-490,-0.72,66460,71200
166,وملي,گروه‌ صنعتي‌ ملي‌ (هلدينگ‌,1043,414551,76042993620,187060,183400,183320,-3740,-2,183430,-3630,-1.94,183320,186500
167,كفرآور,فرآورده هاي سيمان شرق,1038,3517621,92204135565,26120,26160,25598,-522,-2,26212,92,0.35,25598,26900
168,سجامح,ح.مجتمع سيمان غرب آسيا,1027,7261352,14686064046,2028,2080,2050,22,1.08,2022,-6,-0.3,1988,2080
169,سشرق,سيمان‌ شرق‌,1015,5912357,43109302780,7380,7240,7260,-120,-1.63,7300,-80,-1.08,7240,7440
170,بموتو,موتوژن‌,998,951976,58391006630,61980,61990,60770,-1210,-1.95,61340,-640,-1.03,60750,62940
171,آپ,آسان پرداخت پرشين,998,2775615,48824543140,17880,17630,17530,-350,-1.96,17590,-290,-1.62,17530,18100
172,وتوكا,سرمايه‌گذاري‌توكافولاد(هلدينگ,992,5386232,65218902560,12210,11970,12000,-210,-1.72,12110,-100,-0.82,11970,12490
173,كگاز,شيشه‌ و گاز,983,2400759,45851693850,18240,18910,19330,1090,5.98,18990,750,4.11,18250,19330
174,البرز,بيمه البرز,973,14510037,58773598290,4130,4050,4050,-80,-1.94,4050,-80,-1.94,4050,4090
175,بكهنوج,توليد برق ماهتاب كهنوج,973,15763636,27329838830,1736,1740,1730,-6,-0.35,1735,-1,-0.06,1720,1775
176,ونيكي,سرمايه‌گذاري‌ ملي‌ايران‌,963,3969949,43696960970,11190,11100,10970,-220,-1.97,11090,-100,-0.89,10970,11190
177,وتوصا,گروه س توسعه صنعتي ايران,960,4226422,53782668980,12930,13030,12680,-250,-1.93,12730,-200,-1.55,12680,13180
178,اپرداز,آتيه داده پرداز,959,1814974,39910594211,21377,22400,21801,424,1.98,21837,460,2.15,21500,22400
179,فلوله,لوله‌وماشين‌سازي‌ايران‌,948,3474204,76591113400,21350,20940,22550,1200,5.62,22050,700,3.28,20930,22560
180,كهمدا,شيشه‌ همدان‌,945,3088334,32074792400,10140,10120,10480,340,3.35,10290,150,1.48,10120,10640
181,گكوثر,هتل پارسيان كوثر اصفهان,940,15981005,40283845902,2569,2521,2518,-51,-1.99,2531,-38,-1.48,2518,2578
182,خرينگ,رينگ‌سازي‌مشهد,940,1680217,88132156440,49600,52560,52570,2970,5.99,52450,2850,5.75,50000,52570
183,پكوير,كوير تاير,929,3169361,43637933900,13620,13930,13600,-20,-0.15,13740,120,0.88,13550,13980
184,وساخت,سرمايه‌ گذاري‌ ساختمان‌ايران‌,906,1023685,52344380240,51150,52700,50130,-1020,-1.99,51130,-20,-0.04,50130,52700
185,غگلپا,شير پاستوريزه پگاه گلپايگان,895,474018,35032979818,72924,71900,74400,1476,2.02,73620,696,0.95,71466,75980
186,وبانك,سرمايه گذاري گروه توسعه ملي,887,3376172,30111854830,8980,8840,9050,70,0.78,8960,-20,-0.22,8810,9080
187,وبوعلي,سرمايه‌گذاري‌بوعلي‌,875,4940481,29672542840,6070,5970,5990,-80,-1.32,6030,-40,-0.66,5950,6190
188,ومشان,س. فني و مهندسي مشانير,869,562477,44123053757,76350,77754,78640,2290,3,78444,2094,2.74,75781,78640
189,شسپا,نفت سپاهان,861,2009405,31285196350,15730,15880,15460,-270,-1.72,15650,-80,-0.51,15430,15880
190,دروز,داروسازي‌ روزدارو,854,1984052,67187958710,34360,33690,33700,-660,-1.92,33860,-500,-1.46,33680,35450
191,وآرين,شركت توسعه اقتصادي آرين,852,8274211,33856173101,4052,4025,4173,121,2.99,4092,40,0.99,3971,4173
192,چكارن,كارتن‌ ايران‌,852,8930540,31111974720,3540,3480,3490,-50,-1.41,3510,-30,-0.85,3470,3580
193,ودي,بيمه  دي,848,3253966,72490635794,22730,22330,22276,-454,-2,22278,-452,-1.99,22276,22340
194,افق,فروشگاههاي زنجيره اي افق كوروش,839,1258991,89953136780,72570,71120,71120,-1450,-2,71450,-1120,-1.54,71120,72470
195,وصنا,گروه‌صنايع‌بهشهرايران‌,834,5223482,29810927880,5730,5670,5710,-20,-0.35,5720,-10,-0.17,5620,5900
196,سرود,سيمان‌شاهرود,833,1589619,32328535500,19980,20440,20720,740,3.7,20200,220,1.1,19800,20750
197,شغدير,پتروشيمي غدير,832,1181581,83092402812,69705,70000,70830,1125,1.61,70323,618,0.89,68470,71880
198,همراه,شركت ارتباطات سيار ايران,832,1962282,54526093550,28170,27800,27780,-390,-1.38,27970,-200,-0.71,27630,28000
199,شكلر,نيروكلر,832,718618,35988370440,50800,51890,50110,-690,-1.36,50280,-520,-1.02,49790,51890
200,قشرين,قند شيرين خراسان,827,3521374,57069279944,15814,16250,16288,474,3,16207,393,2.49,15601,16288
201,فجر,فولاد اميركبيركاشان,814,2105304,132880791430,64320,63040,63040,-1280,-1.99,63120,-1200,-1.87,63040,64190
202,لسرما,سرما آفرين‌,810,1905959,47484787330,25300,25480,24800,-500,-1.98,24920,-380,-1.5,24800,25500
203,طلا,صندوق س.پشتوانه طلاي لوتوس,805,419398,33329170494,80228,80010,79112,-1116,-1.39,79469,-759,-0.95,78700,80200
204,سرچشمه,سرمايه گذاري مس سرچشمه,801,3737509,25524571257,6902,6764,6890,-12,-0.17,6864,-38,-0.55,6764,7040
205,ورنا,سرمايه‌گذاري‌ رنا(هلدينگ‌,769,6790442,38911613370,5830,5800,5720,-110,-1.89,5750,-80,-1.37,5720,5810
206,ثرود,سرمايه‌گذاري مسكن زاينده رود,768,4432705,97404259670,20731,21974,21974,1243,6,21974,1243,6,21974,21974
207,ريشمك,توليد و صادرات ريشمك,766,1217705,66534226795,51757,52350,54862,3105,6,54639,2882,5.57,52350,54862
208,فاذر,صنايع‌ آذرآب‌,759,1984281,50716121730,26010,25490,25490,-520,-2,25570,-440,-1.69,25490,26270
209,وهور,مديريت انرژي اميد  تابان هور,753,17081182,37036902611,2206,2164,2195,-11,-0.5,2182,-24,-1.09,2162,2218
210,ارزش,صندوق س ارزش آفرين بيدار-سهام,735,7066245,71947700980,10020,9970,10150,130,1.3,10180,160,1.6,9960,10270
211,وسكاب,س.ص.بازنشستگي كاركنان بانكها,726,9574677,52271661500,5530,5450,5450,-80,-1.45,5460,-70,-1.27,5420,5570
212,ارفع,شركت آهن و فولاد ارفع,725,1841832,27713450989,15195,14913,15000,-195,-1.28,15138,-57,-0.38,14892,15450
213,فسرب,ملي‌ سرب‌وروي‌ ايران‌,721,299332,23897373200,81230,81580,79610,-1620,-1.99,80550,-680,-0.84,79610,81580
214,زپارس,ملي كشت و صنعت و دامپروري پارس,717,568102,100464577010,167370,177000,177410,10040,6,176840,9470,5.66,171130,177410
215,خشرق,الكتريك‌ خودرو شرق‌,714,2952101,45357596660,15670,15360,15360,-310,-1.98,15380,-290,-1.85,15360,15600
216,شپديس,پتروشيمي پرديس,705,521927,52945784940,102270,103000,100630,-1640,-1.6,101820,-450,-0.44,100250,103370
217,زقيام,كشت و دام قيام اصفهان,687,1219197,35426095942,29620,29028,29028,-592,-2,29202,-418,-1.41,29028,29600
218,سامان,بانك سامان,674,4718122,50760103315,10765,10880,10800,35,0.33,10759,-6,-0.06,10550,10925
219,قچار,فراوردههاي غذايي وقند چهارمحال,673,576535,53099436502,91195,89520,90231,-964,-1.06,92101,906,0.99,89520,93500
220,كاسپين,داروسازي كاسپين تامين,656,2234505,57739877997,24573,24082,26047,1474,6,25840,1267,5.16,24082,26047
221,سيمرغ,سيمرغ,656,3403383,57694502370,17260,16920,16920,-340,-1.97,16950,-310,-1.8,16920,17240
222,انرژي3,سايراشخاص بورس انرژي,651,112708,29026818320,262790,257540,257540,-5250,-2,260320,-2470,-0.94,257540,257540
223,شجم,صنايع پتروشيمي تخت جمشيد,641,7772499,85555703092,10693,11013,11013,320,2.99,11007,314,2.94,10800,11013
224,ضخود2007,اختيارخ خودرو-3000-1400/02/08,637,31144,3149421000,121,114,98,-23,-19.01,101,-20,-16.53,95,117
225,ونفت,سرمايه‌گذاري‌ صنعت‌ نفت‌,630,1833778,31954086290,17440,17100,17150,-290,-1.66,17430,-10,-0.06,17100,17900
226,پارند,صندوق س. پارند پايدار سپهر,624,19288762,219027673103,11341,11355,11360,19,0.17,11355,14,0.12,11354,11360
227,زر,صندوق س.پشتوانه سكه طلاي زر,623,627755,29717381993,48023,48001,47050,-973,-2.03,47339,-684,-1.42,46963,48180
228,پلاسك,پلاسكوكار,619,3166922,24548714390,7830,7880,7720,-110,-1.4,7790,-40,-0.51,7700,7980
229,فنوال,نورد آلومينيوم‌,618,943577,26768932410,27990,28290,28310,320,1.14,28180,190,0.68,27760,28710
230,دعبيد,لابراتوارداروسازي‌  دكترعبيدي‌,615,1112584,27145333940,24730,24260,24750,20,0.08,24550,-180,-0.73,24240,25070
231,سپ,پرداخت الكترونيك سامان كيش,614,2303435,44144032380,18120,19180,19200,1080,5.96,18990,870,4.8,18120,19200
232,جم,پتروشيمي جم,613,1855144,69020655900,37500,36750,37000,-500,-1.33,37290,-210,-0.56,36750,38800
233,هرمز,فولاد هرمزگان جنوب,612,2624399,37967924917,14550,14350,14400,-150,-1.03,14523,-27,-0.19,14260,14850
234,مدير,ص.س.مديريت ثروت ص.بازنشستگي-س,608,2214448,20051270810,9102,9085,9020,-82,-0.9,9055,-47,-0.52,8969,9149
235,بكام,كارخانجات توليدي شهيد قندي,600,8964171,35318833740,3720,3940,3940,220,5.91,3860,140,3.76,3940,3940
236,ميدكو,هلدينگ صنايع  معدني خاورميانه,597,4407431,138938939856,31237,31238,31570,333,1.07,31524,287,0.92,31238,31600
237,دالبرح,ح . البرزدارو,596,700911,8009831230,11830,11450,11360,-470,-3.97,11430,-400,-3.38,11360,11790
238,دكپسولح,ح .توليد ژلاتين كپسول ايران,595,965101,25555645323,26523,27000,27425,902,3.4,26480,-43,-0.16,25993,27840
239,پارسان,گسترش نفت و گاز پارسيان,593,2696164,57367707400,21520,21090,21090,-430,-2,21400,-120,-0.56,21090,21670
240,خريخت,صنايع‌ريخته‌گري‌ايران‌,586,8451504,29354356020,3540,3520,3470,-70,-1.98,3500,-40,-1.13,3470,3570
241,فسازان,غلتك سازان سپاهان,581,940631,34812843600,36460,36000,36760,300,0.82,36840,380,1.04,35840,37900
242,شكربن,كربن‌ ايران‌,577,384163,36084208800,93370,94800,95400,2030,2.17,93760,390,0.42,91510,95500
243,فاما,صنعتي‌ آما,577,1628050,32444499600,20180,20180,19880,-300,-1.49,20010,-170,-0.84,19780,20390
244,خكمك,كمك‌فنرايندامين‌,571,1666036,45944599050,28110,27550,27550,-560,-1.99,27620,-490,-1.74,27550,28390
245,ثنور,سرمايه گذاري كوه نور,567,4515433,45695915441,9834,10000,10129,295,3,10120,286,2.91,9929,10129
246,ورازي,بيمه رازي,548,4861399,43283117820,8877,9100,8930,53,0.6,8903,26,0.29,8710,9100
247,ختراك,ريخته‌گري‌ تراكتورسازي‌ ايران‌,547,2496510,39026918450,15880,15590,15570,-310,-1.95,15680,-200,-1.26,15570,16180
248,زدشت,كشت و صنعت دشت خرم دره,547,1143861,34189400724,30466,30950,29857,-609,-2,30096,-370,-1.21,29857,30950
249,سخوز,سيمان خوزستان,539,1266351,29731373640,23710,23280,23490,-220,-0.93,23580,-130,-0.55,23250,24320
250,ثمسكن,سرمايه‌گذاري‌ مسكن‌,534,2946558,16550421800,5540,5600,5580,40,0.72,5570,30,0.54,5430,5730
251,حسينا,توسعه خدمات دريايي وبندري سينا,534,292540,21336521105,72603,73998,73000,397,0.55,72743,140,0.19,72000,73998
252,سكرما,سيمان‌ كرمان‌,530,1632419,27662673590,16500,17240,16780,280,1.7,16760,260,1.58,16770,17250
253,حبندر,دريايي و کشتيراني خط دريابندر,523,982048,33899400080,35184,35184,34481,-703,-2,34519,-665,-1.89,34481,35820
254,دلقما,دارويي‌ لقمان‌,518,1810780,47522196700,24890,26360,26380,1490,5.99,26070,1180,4.74,25510,26380
255,آريان,سرمايه گذاري پارس آريان,517,1887672,23318715704,12215,12390,12350,135,1.11,12248,33,0.27,11972,12500
256,بنيرو,نيروترانس‌,515,1251029,18685457790,15210,14910,14910,-300,-1.97,15110,-100,-0.66,14910,15350
257,شفن,پتروشيمي فناوران,513,69668,23053268830,328500,323700,330810,2310,0.7,329050,550,0.17,323700,333000
258,وسپه,سرمايه‌گذاري‌ سپه‌,509,1955104,13610244730,7060,6930,6940,-120,-1.7,7030,-30,-0.42,6920,7090
259,غمينو,شركت صنايع غذايي مينو شرق,501,1546046,17789031023,11715,11500,11481,-234,-2,11639,-76,-0.65,11481,11849
260,وتوس,توسعه‌شهري‌توس‌گستر,500,927018,13242702470,14080,14490,14270,190,1.35,14130,50,0.36,14130,14490
261,وتوسم,سرمايه‌گذاري‌توسعه‌ملي‌,486,3005332,28075483480,9530,9500,9340,-190,-1.99,9420,-110,-1.15,9340,9500
262,پكرمان,گروه‌ صنعتي‌ بارز,485,1964807,54072081000,28060,27500,27500,-560,-2,27520,-540,-1.92,27500,27940
263,تنوين,تامين سرمايه نوين,485,4728361,36516088490,7700,7730,7720,20,0.26,7720,20,0.26,7690,7900
264,اتكاي,بيمه اتكايي ايرانيان,480,1949789,34943121746,17650,17680,18000,350,1.98,17830,180,1.02,17640,18189
265,وبازار,صندوق س شاخصي بازارآشنا,478,3342509,33896110620,10110,10150,10150,40,0.4,10140,30,0.3,10060,10200
266,غشهد,شهد ايران ‌,473,2433173,17599243110,7360,7400,7220,-140,-1.9,7310,-50,-0.68,7220,7400
267,شفارا,پتروشيمي فارابي,470,3575770,14830698522,4211,4290,4160,-51,-1.21,4165,-46,-1.09,4127,4290
268,سپاها,سيمان‌سپاهان‌,470,2282765,19998781800,8900,8730,8860,-40,-0.45,8840,-60,-0.67,8730,8910
269,شصفها,پتروشيمي‌ اصفهان‌,458,268699,38121592337,139147,141929,140540,1393,1,141875,2728,1.96,140538,141929
270,افرا,افرانت,458,1100986,38187157870,35390,34683,34683,-707,-2,34840,-550,-1.55,34683,34839
271,تايرا,تراكتورسازي‌ايران‌,455,2214330,62917897700,28980,28410,28410,-570,-1.97,28410,-570,-1.97,28410,28900
272,وگردش,بانك گردشگري,448,1571824,27680016530,17567,18080,17700,133,0.76,17579,12,0.07,17301,18080
273,دفرا,فرآورده‌هاي‌ تزريقي‌ ايران‌,447,405404,10680490110,25910,25420,26600,690,2.66,26000,90,0.35,25400,26800
274,پتاير,ايران‌ تاير,443,11567723,43725992940,3850,3780,3780,-70,-1.82,3790,-60,-1.56,3780,3780
275,قپيرا,فرآورده‌هاي‌غدايي‌وقندپيرانشهر,442,154664,16777460710,106800,113170,106390,-410,-0.38,107330,530,0.5,105000,113170
276,سمتاز,سيمان ممتازان كرمان,441,1488494,31321842574,20531,21146,21146,615,3,21043,512,2.49,20331,21146
277,وارس,سرمايه گذاري ارس صبا,439,5129380,76228464210,15155,14862,14852,-303,-2,14861,-294,-1.94,14852,15220
278,شاراك,پتروشيمي شازند,439,1173792,30138723300,25450,25300,25400,-50,-0.2,25530,80,0.31,25200,26070
279,غپونه,نوش پونه مشهد,436,1197572,24197179364,19770,19930,20363,593,3,20205,435,2.2,19900,20363
280,جم پيلن,پلي پروپيلن جم - جم پيلن,432,522207,42650233740,80920,79320,82500,1580,1.95,81410,490,0.61,79310,83000
281,آكورد,صندوق س. آرمان آتي كوثر-د,431,8869929,278091845790,31322,31352,31352,30,0.1,31352,30,0.1,31351,31356
282,خصدرا,صنعتي‌ دريايي‌ ايران‌,431,10548998,33788440594,3110,3203,3203,93,2.99,3203,93,2.99,3203,3203
283,وپترو,سرمايه‌گذاري صنايع پتروشيمي‌,427,769149,11417700630,14740,14530,14720,-20,-0.14,14760,20,0.14,14530,14980
284,اميد,تامين سرمايه اميد,417,1411577,11160590720,7860,7740,7850,-10,-0.13,7870,10,0.13,7740,8240
285,مبين,مبين انرژي خليج فارس,411,1544895,26910000610,17560,17510,17330,-230,-1.31,17530,-30,-0.17,17210,17990
286,شپاكسا,پاكسان‌,410,1361664,38687469960,28810,28700,28540,-270,-0.94,28490,-320,-1.11,28240,29000
287,وصندوق,سرمايه‌گذاري‌صندوق‌بازنشستگي‌,405,2773789,41577755070,15150,15100,15100,-50,-0.33,15090,-60,-0.4,14850,15190
288,فافزا,فولاد افزا سپاهان,402,493013,27180380985,53634,55242,55243,1609,3,55131,1497,2.79,52900,55243
289,شرانل,نفت ايرانول,399,875675,34083414154,39635,38844,39020,-615,-1.55,39137,-498,-1.26,38843,39987
290,سكه0012پ01,سكه تمام بهارتحويلي 1روزه رفاه,389,138000,153084957200,1119773,1115554,1109900,-9873,-0.88,1109311,-10462,-0.93,1101112,1115554
291,كپرور,فرآوري زغال سنگ پروده طبس,388,418182,15575993062,37874,37221,37117,-757,-2,37673,-201,-0.53,37117,37980
292,ضخود2006,اختيارخ خودرو-2500-1400/02/08,388,16171,3488670000,259,250,213,-46,-17.76,216,-43,-16.6,202,256
293,تسه9911,امتياز تسهيلات مسكن بهمن99,388,7046,4212741337,596665,600000,566832,-29833,-5,597891,1226,0.21,566832,609997
294,وحكمت,بيمه حكمت صبا,384,2935541,11555230379,3924,3870,3910,-14,-0.36,3931,7,0.18,3870,4000
295,تصميم,صندوق س با درآمد ثابت تصميم,384,2281609,36498612881,15973,15997,15998,25,0.16,15997,24,0.15,15991,15998
296,پرديس,سرمايه گذاري پرديس,383,2173760,11970953920,5520,5620,5490,-30,-0.54,5520,0,0,5430,5620
297,دامين,داروسازي‌ امين‌,379,1084989,14854104300,13910,13820,13640,-270,-1.94,13840,-70,-0.5,13640,13980
298,جمح,ح . پتروشيمي جم,376,807614,23243962600,29640,29400,28550,-1090,-3.68,28780,-860,-2.9,28470,29900
299,پارس,پتروشيمي پارس,370,230035,36167709780,158700,155800,155600,-3100,-1.95,158150,-550,-0.35,155530,161650
300,وسين,بيمه سينا,370,952838,14279087338,15225,15000,15000,-225,-1.48,15060,-165,-1.08,14921,15210
301,كيسون,شركت كيسون,361,21287257,255447084000,14700,12000,12000,-2700,-18.37,12000,-2700,-18.37,12000,12000
302,خمحور,توليدمحورخودرو,360,268925,17956785930,67570,67590,66220,-1350,-2,67270,-300,-0.44,66220,69750
303,شگلح,ح . گلتاش‌,360,1611427,11403195930,7300,7050,7020,-280,-3.84,7080,-220,-3.01,7010,7380
304,تيپيكو,سرمايه گذاري دارويي تامين,360,265408,11300348990,43270,43000,42470,-800,-1.85,43160,-110,-0.25,42410,43270
305,كشرق,صنعتي و معدني شمال شرق شاهرود,356,321107,29400475006,93388,91530,91521,-1867,-2,92273,-1115,-1.19,91521,93350
306,واعتبار,سرمايه گذاري اعتبار ايران,355,2650872,25997228330,9720,9760,9840,120,1.23,9760,40,0.41,9570,9970
307,جهرم,پتروشيمي جهرم,351,3387423,6049480220,1819,1784,1783,-36,-1.98,1808,-11,-0.6,1783,1850
308,وخاور,بانك خاورميانه,349,1507502,14019521190,9460,9300,9320,-140,-1.48,9420,-40,-0.42,9280,9540
309,پارسيان,بيمه پارسيان,348,1577889,17223358750,11020,11000,10850,-170,-1.54,10980,-40,-0.36,10800,11230
310,ولانا,شركت ليزينگ آريا دانا,346,1000693,39409168993,38617,38230,39775,1158,3,39382,765,1.98,37950,39775
311,اطلس,صندوق س.توسعه اندوخته آينده-س,337,51026,11118107715,216289,217050,217024,735,0.34,217891,1602,0.74,215002,220001
312,درازك,دارويي‌ رازك‌,337,411511,14181307480,34240,34000,34390,150,0.44,34300,60,0.18,34000,34800
313,خديزل,بهمن  ديزل,337,358210,14619960393,41471,42995,40725,-746,-1.8,41281,-190,-0.46,40642,42995
314,بمپنا,توليد برق عسلويه  مپنا,333,285156,20415074549,72908,71600,72010,-898,-1.23,72357,-551,-0.76,71450,72190
315,فالوم,آلومتك‌,327,634737,25294587115,39200,40376,40365,1165,2.97,39850,650,1.66,39203,40376
316,وكار,بانك‌ كارآفرين‌,327,4545583,11558588160,2590,2590,2540,-50,-1.93,2580,-10,-0.39,2540,2600
317,شوينده,مديريت صنعت شوينده ت.ص.بهشهر,324,362023,10949123900,30470,29950,30140,-330,-1.08,30420,-50,-0.16,29950,30890
318,عيار,صندوق س. پشتوانه طلاي مفيد,320,416068,11667429680,28139,28647,28150,11,0.04,28042,-97,-0.34,27820,28647
319,كنور,توسعه معدني و صنعتي صبانور,319,269774,13202292390,49420,49000,48750,-670,-1.36,49310,-110,-0.22,48520,49800
320,آساس,صندوق س.آسمان آرماني سهام-س,319,111348,19770064241,177419,177500,177170,-249,-0.14,177552,133,0.07,176110,178900
321,دارو,كارخانجات‌داروپخش‌,315,386904,13426736970,34380,33720,35170,790,2.3,34470,90,0.26,33700,35730
322,وجامي,سرمايه گذاري جامي,311,935539,14146697910,15405,15097,15097,-308,-2,15200,-205,-1.33,15097,15710
323,شبصير,توليدات پتروشيمي قائد بصير,309,456367,32819030497,73274,71809,71809,-1465,-2,72335,-939,-1.28,71809,73230
324,سپاس,صندوق س. پاداش سهامداري توسعه1,305,10273920,104033044860,10115,10141,10126,11,0.11,10126,11,0.11,10124,10141
325,شخارك,پتروشيمي‌ خارك‌,301,260756,12070522540,46390,45500,46000,-390,-0.84,46380,-10,-0.02,45470,46900
326,دشيري,شيرين دارو,300,99350,22417331804,219614,226200,226202,6588,3,225640,6026,2.74,220000,226202
327,كاردان,صندوق س تجارت شاخصي كاردان,297,95149,16194891530,171730,169030,168500,-3230,-1.88,170210,-1520,-0.89,168340,172490
328,دشيميح,ح . شيمي‌ داروئي‌ داروپخش‌,296,473292,9550239000,20850,20760,20020,-830,-3.98,20180,-670,-3.21,20020,21270
329,لوتوس,تامين سرمايه لوتوس پارسيان,295,2377280,25261878690,10630,10630,10580,-50,-0.47,10630,0,0,10530,10780
330,زفكاح,ح . كشت و دامداري فكا,286,1489135,12162200025,8274,8339,8140,-134,-1.62,8167,-107,-1.29,8109,8339
331,ما,بيمه  ما,286,1833122,13799941270,7550,7420,7470,-80,-1.06,7540,-10,-0.13,7400,7740
332,خمهر,مهركام‌پارس‌,285,5140265,12452641210,2460,2420,2420,-40,-1.63,2450,-10,-0.41,2420,2470
333,وبشهر,توسعه‌ صنايع‌ بهشهر(هلدينگ,285,1503136,18335354790,12430,12210,12360,-70,-0.56,12340,-90,-0.72,12190,12360
334,نوين,بيمه نوين,284,4495853,28368832430,6438,6310,6310,-128,-1.99,6368,-70,-1.09,6310,6310
335,شاوان,پالايش نفت لاوان,283,203186,18453087401,91189,89425,89700,-1489,-1.63,91048,-141,-0.15,89366,93800
336,نهال,صندوق س. طلاي سرخ نوويرا,283,825531,7664473186,9303,9113,9267,-36,-0.39,9284,-19,-0.2,9113,9329
337,كوثر,بيمه كوثر,281,838700,12203987894,14842,14547,14546,-296,-1.99,14772,-70,-0.47,14546,14600
338,اتكام,شركت بيمه اتكايي امين,281,1279581,6399574406,4940,4921,5000,60,1.21,4948,8,0.16,4921,5130
339,ضسپا3004,اختيارخ خساپا-2500-1400/03/26,280,10133,2817977000,292,271,268,-24,-8.22,278,-14,-4.79,264,292
340,ياقوت,صندوق س ياقوت آگاه-ثابت,278,2836861,34519314843,12150,12157,12171,21,0.17,12168,18,0.15,12154,12173
341,وتوشه,سرمايه‌ گذاري‌ پارس‌ توشه‌,272,464025,10399090680,22210,22990,22640,430,1.94,22250,40,0.18,21920,22990
342,بميلا,توسعه بازرگاني آهن وفولادميلاد,266,969338,15996036436,16693,16979,16404,-289,-1.73,16538,-155,-0.93,16368,16979
343,بساما,بيمه سامان,265,532737,12528825258,23994,23994,23515,-479,-2,23876,-118,-0.49,23515,23994
344,مارون,پتروشيمي مارون,265,53800,8619849337,159443,157877,159101,-342,-0.21,159511,68,0.04,157877,162100
345,فزرين,زرين معدن آسيا,264,1141607,32093997591,28686,28113,28113,-573,-2,28318,-368,-1.28,28113,28113
346,تسه9908,امتياز تسهيلات مسكن آبان99,260,4028,2359410255,573937,581602,558000,-15937,-2.78,585752,11815,2.06,558000,602633
347,سحرخيز,صندوق س. گروه زعفران سحرخيز,255,403181,3907614081,9754,9790,9696,-58,-0.59,9692,-62,-0.64,9653,9790
348,گوهران,سرمايه گذاري توسعه گوهران اميد,255,1481794,10833868380,7459,7530,7310,-149,-2,7426,-33,-0.44,7310,7530
349,كاريس,صندوق س.سپهر كاريزما-س,253,1021543,11865598842,11660,11510,11632,-28,-0.24,11615,-45,-0.39,11441,11693
350,شگل,گلتاش‌,253,849239,8647075790,10380,10180,10180,-200,-1.93,10340,-40,-0.39,10180,10380
351,فخاس,فولاد خراسان,250,183757,5212968150,28520,28300,28550,30,0.11,28510,-10,-0.04,27950,29020
352,ختراكح,ح . ريخته‌گري‌ تراكتورسازي‌,249,4406410,50541888700,11470,11500,11470,0,0,11470,0,0,11470,11500
353,دالبر,البرزدارو,248,394420,5930606860,15280,15280,15100,-180,-1.18,15250,-30,-0.2,14980,15280
354,دانا,بيمه دانا,247,1642417,10807103860,6710,6580,6580,-130,-1.94,6680,-30,-0.45,6580,6580
355,وبيمه,سرمايه‌ گذاري‌ صنعت‌ بيمه‌,244,2896357,8023504220,2820,2770,2770,-50,-1.77,2810,-10,-0.35,2770,2810
356,افران,صندوق س افرا نماد پايدار-ثابت,243,6160584,80034726033,12980,12987,12994,14,0.11,12991,11,0.08,12985,12995
357,شپاس,نفت پاسارگاد,242,714088,15825856510,22587,22170,22200,-387,-1.71,22450,-137,-0.61,22136,22600
358,وثنو,سرمايه گذاري ساختماني نوين,241,1575415,9737538221,6194,6290,6150,-44,-0.71,6188,-6,-0.1,6141,6290
359,حفارس,حمل و نقل بين المللي خليج فارس,239,1686250,8067711990,4870,4800,4780,-90,-1.85,4860,-10,-0.21,4780,4810
360,كرماشا,صنايع پتروشيمي كرمانشاه,238,321895,12559742540,39260,38510,38740,-520,-1.32,39200,-60,-0.15,38500,39650
361,كمينا,شيشه سازي مينا,237,823983,20901152778,24628,25366,25366,738,3,25339,711,2.89,25366,25366
362,پخش,پخش البرز,233,384997,12602139982,33149,33149,33149,0,0,33043,-106,-0.32,32487,33390
363,معيار,سرمايه گذاري معيار صنعت پارس,232,318139,14273280605,43656,44000,44965,1309,3,44526,870,1.99,43800,44965
364,سهگمت,سيمان‌هگمتان‌,225,536779,13517358680,25620,26240,25110,-510,-1.99,25500,-120,-0.47,25110,26240
365,شيراز,پتروشيمي‌شيراز,224,315200,18309968020,58320,57170,58970,650,1.11,58280,-40,-0.07,57160,58980
366,وسپهر,سرمايه گذاري مالي سپهرصادرات,223,587531,6059207203,10523,10313,10313,-210,-2,10512,-11,-0.1,10313,10313
367,شنفت,نفت‌ پارس‌,222,172538,8767907390,50800,50160,50800,0,0,50800,0,0,50160,51990
368,دسبحا,گروه دارويي سبحان,222,401268,7814450900,19560,20490,19560,0,0,19550,-10,-0.05,19170,20490
369,تسه9910,امتياز تسهيلات مسكن دي99,222,3177,1860803025,583644,595000,554462,-29182,-5,585711,2067,0.35,554462,600900
370,دتماد,توليدمواداوليه‌داروپخش‌,221,411805,19178586970,47460,46610,46520,-940,-1.98,47110,-350,-0.74,46520,47940
371,شراز,پالايش نفت شيراز,214,89368,10327943531,115672,113400,115215,-457,-0.4,115650,-22,-0.02,113359,116830
372,دسبحان,سبحان دارو,213,307868,6861569970,22280,22280,22120,-160,-0.72,22280,0,0,21870,22950
373,جوين,كشت و صنعت جوين,211,2146776,11888288338,5647,5550,5535,-112,-1.98,5579,-68,-1.2,5535,5560
374,شستان,پتروشيمي گلستان,208,1710050,7081025850,4060,4133,4141,81,2,4118,58,1.43,4133,4141
375,نمرينو,ايران‌ مرينوس‌,208,370122,38714761200,98680,104600,104600,5920,6,102740,4060,4.11,104600,104600
376,تماوند,تامين سرمايه دماوند,206,702998,11350021658,16202,16231,16200,-2,-0.01,16170,-32,-0.2,15900,16680
377,بخاور,بيمه زندگي خاورميانه,206,1298399,9158312382,7013,7000,7002,-11,-0.16,7020,7,0.1,6906,7190
378,تسه9909,امتياز تسهيلات مسكن آذر99,199,1950,1125771918,573613,602293,544933,-28680,-5,577319,3706,0.65,544933,602293
379,كبافق,معادن‌ بافق‌,197,296007,14915792730,51410,50390,50390,-1020,-1.98,51100,-310,-0.6,50390,50390
380,كخاك,صنايع‌خاك‌چيني‌ايران‌,196,664066,28055982060,43050,42190,42190,-860,-2,42590,-460,-1.07,42190,43730
381,وآيند,بانك  آينده,194,4139397,72903059964,17971,17612,17612,-359,-2,17690,-281,-1.56,17612,17612
382,وبهمن,سرمايه‌گذاري‌بهمن‌,193,455141,7069914160,15830,15520,15520,-310,-1.96,15790,-40,-0.25,15520,15780
383,خفولا,خدمات فني فولاد يزد,192,1001547,46993586787,48876,46921,46921,-1955,-4,46921,-1955,-4,46921,46921
384,هاي وب,داده گسترعصرنوين-هاي وب,192,972454,10132970680,10630,10420,10420,-210,-1.98,10590,-40,-0.38,10420,10420
385,سيدكو,سرمايه گذاري توسعه صنايع سيمان,190,3102567,19825403130,6520,6390,6390,-130,-1.99,6470,-50,-0.77,6390,6390
386,كگهر,سنگ آهن گهرزمين,186,126088,5998874650,47313,47790,47590,277,0.59,47326,13,0.03,47313,48020
387,وپخش,داروپخش‌ (هلدينگ‌,186,74307,7605018450,101950,100200,101000,-950,-0.93,102010,60,0.06,100200,104550
388,تاصيكو,سرمايه گذاري صدرتامين,182,4531298,51656797200,11630,11400,11400,-230,-1.98,11530,-100,-0.86,11400,11400
389,فيروزه,صندوق شاخص30 شركت فيروزه- سهام,178,82139,11843183230,144500,143000,144000,-500,-0.35,144180,-320,-0.22,143000,145120
390,ساراب,سيمان‌ داراب‌,177,961152,15718103290,16680,16350,16350,-330,-1.98,16570,-110,-0.66,16350,16700
391,خراسان,پتروشيمي خراسان,170,104252,7997498840,77760,76210,76240,-1520,-1.95,77610,-150,-0.19,76210,78280
392,قنقش,قند نقش جهان,168,139041,9905147413,70433,69290,71841,1408,2,71234,801,1.14,69026,71841
393,گوهر,صندوق سكه طلاي كيان,167,55058,3037554521,55258,55511,54820,-438,-0.79,55170,-88,-0.16,54261,55511
394,بفجر,فجر انرژي خليج فارس,167,406429,9836987990,23860,23720,24350,490,2.05,23910,50,0.21,23700,24650
395,فاسمين,كالسيمين‌,167,769573,13644529290,18090,17730,17730,-360,-1.99,17990,-100,-0.55,17730,17730
396,لخزر,پارس‌ خزر,160,31322,5749153100,187290,183550,183550,-3740,-2,186850,-440,-0.23,183550,183550
397,زرين,صندوق س. سهام زرين كوروش-س,160,502873,5312675760,10664,10700,10580,-84,-0.79,10565,-99,-0.93,10430,10750
398,ضخود2005,اختيارخ خودرو-2000-1400/02/08,159,7601,4598463000,664,607,608,-56,-8.43,605,-59,-8.89,593,620
399,كيميا,معدني كيمياي زنجان گستران,156,832172,14696458949,18020,17660,17660,-360,-2,17909,-111,-0.62,17660,17700
400,شپلي,پلي اكريل ايران,149,1132803,10552059945,9505,9315,9315,-190,-2,9354,-151,-1.59,9315,9315
401,پترولح,ح . گروه پتروشيمي س. ايرانيان,148,3945491,36337972110,9210,9210,9210,0,0,9210,0,0,9210,9210
402,آساميد,صندوق س.مشترك آسمان اميد -د,147,5733003,67728818174,11801,11810,11830,29,0.25,11814,13,0.11,11800,11830
403,غزر,صنعتي زر ماكارون,145,187973,4983164230,27050,26510,26510,-540,-2,26990,-60,-0.22,26510,26510
404,دتوزيع,توزيع دارو پخش,144,259096,13776393416,54256,53171,53171,-1085,-2,53982,-274,-0.51,53171,53171
405,ضخود2008,اختيارخ خودرو-3500-1400/02/08,143,4690,134591000,41,42,27,-14,-34.15,29,-12,-29.27,27,42
406,وسرمد,بيمه  سرمد,143,628586,3987746093,6459,6332,6330,-129,-2,6436,-23,-0.36,6330,6450
407,دلر,داروسازي‌ اكسير,142,88571,3303834480,36620,37000,37300,680,1.86,36660,40,0.11,36630,37700
408,كارين,صندوق س نگين سامان-ثابت,140,6049249,61008273861,10076,10090,10086,10,0.1,10085,9,0.09,10084,10090
409,شكبير,پتروشيمي اميركبير,136,221873,20405528957,91924,90090,90712,-1212,-1.32,91933,9,0.01,90086,93630
410,گشان,توسعه بين المللي پديده شانديز,133,122079,3900790287,32605,31953,31953,-652,-2,32471,-134,-0.41,31953,31953
411,ساينا,صنايع بهداشتي ساينا,133,36903,5723875423,158239,155075,157930,-309,-0.2,157872,-367,-0.23,155075,157930
412,ضسپا3003,اختيارخ خساپا-2000-1400/03/26,131,3865,2115600000,562,554,530,-32,-5.69,547,-15,-2.67,518,585
413,كيان2,صندوق س. با درآمد ثابت كيان,131,13100000,13100000,27725,1,1,-27724,-100,1,-27724,-100,1,1
414,شفا,سرمايه گذاري شفادارو,131,126868,5770312960,46400,45540,45480,-920,-1.98,46290,-110,-0.24,45480,46880
415,سكرد,سيمان كردستان,130,471711,4613333580,9970,9780,9780,-190,-1.91,9950,-20,-0.2,9780,9780
416,پسهند,صنايع‌ لاستيكي‌  سهند,129,118927,4963268700,42560,42900,41710,-850,-2,42480,-80,-0.19,41710,42900
417,تسه9810,امتياز تسهيلات مسكن دي98,124,2276,1304860694,571297,550333,550000,-21297,-3.73,573313,2016,0.35,550000,589990
418,خنصير,مهندسي‌نصيرماشين‌,122,90475,9553255250,109990,105590,105590,-4400,-4,109110,-880,-0.8,105590,105590
419,مداران,داده‌پردازي‌ايران‌,121,158266,3933182430,25330,25300,24830,-500,-1.97,25290,-40,-0.16,24830,25300
420,وايرا,سرمايه گذاري صنايع ايران,120,930651,12308790126,12841,13226,13226,385,3,13061,220,1.71,13226,13226
421,تكنار,مجتمع معادن مس تكنار,119,26198,3312941693,128985,127519,126406,-2579,-2,128551,-434,-0.34,126406,128000
422,رتكو,كنترل‌خوردگي‌تكين‌كو,112,605793,11092069830,18680,18310,18310,-370,-1.98,18600,-80,-0.43,18310,18310
423,تسه9802,امتياز تسهيلات مسكن ارديبهشت98,111,1321,721939037,562127,565000,534027,-28100,-5,546509,-15618,-2.78,534021,566000
424,تسه9907,امتياز تسهيلات مسكن مهر99,108,1321,758921051,576437,570122,560000,-16437,-2.85,574505,-1932,-0.34,559999,599999
425,فنرژي,گسترش صنايع انرژي آذرآب,106,150374,2835752892,19643,18858,18858,-785,-4,19410,-233,-1.19,18858,18858
426,ضشنا2002,اختيارخ شپنا-12000-1400/02/27,105,1896,5035058000,2722,2500,2600,-122,-4.48,2656,-66,-2.42,2500,2990
427,زعف0008پ10,زعفران0008نگين طلاي سرخ(پ),105,29888,3595203924,120997,120650,120000,-997,-0.82,120289,-708,-0.59,118500,121915
428,شساخت,مهندسي و ساختمان صنايع نفت,105,60986,2301067684,37050,37974,37540,490,1.32,37091,41,0.11,36520,38100
429,آتيمس,صندوق س.آرمان آتيه درخشان مس-س,104,21323,4078501936,191773,192000,189440,-2333,-1.22,191272,-501,-0.26,189000,193650
430,صايند,صندوق س. گنجينه آينده روشن-د,103,1047430,10499393310,10009,10053,10040,31,0.31,10024,15,0.15,10000,10053
431,تسه9803,امتياز تسهيلات مسكن خرداد98,101,978,549652798,576047,568000,554180,-21867,-3.8,562017,-14030,-2.44,550030,580000
432,ختور,رادياتور ايران‌,100,182855,4121551700,22990,22540,22540,-450,-1.96,22950,-40,-0.17,22540,22540
433,سپر,صندوق س سپر سرمايه بيدار- ثابت,96,1213466,14212976315,11678,11680,11710,32,0.27,11713,35,0.3,11680,11770
434,ملت,بيمه ملت,92,356009,5699704090,16330,16010,16010,-320,-1.96,16290,-40,-0.24,16010,16010
435,واحيا,م .صنايع و معادن احياء سپاهان,91,208224,32450044608,151303,155842,155842,4539,3,153666,2363,1.56,155842,155842
436,فسا,پتروشيمي فسا,90,692757,1206089937,1776,1741,1741,-35,-1.97,1774,-2,-0.11,1741,1741
437,سكه0011پ02,سكه تمام بهارتحويلي 1روزه ملت,90,18700,20696431400,1118735,1112089,1111700,-7035,-0.63,1106761,-11974,-1.07,1100169,1114000
438,كفپارس,فرآورده‌هاي‌ نسوز پارس‌,89,629790,2865544500,4640,4550,4550,-90,-1.94,4630,-10,-0.22,4550,4550
439,تسه9902,امتياز تسهيلات مسكن ارديبهشت99,88,954,550500752,568316,570522,571500,3184,0.56,577045,8729,1.54,555555,596731
440,ضترا3004,اختيارخ شتران-10000-1400/03/09,88,1665,2928704000,1009,6000,1449,440,43.61,1759,750,74.33,1320,6000
441,ارمغان,ص سرمايه گذاري ارمغان ايرانيان,85,1798758,18260275028,10143,10153,10158,15,0.15,10152,9,0.09,10149,10158
442,شاملا,معدني‌ املاح‌  ايران‌,85,71735,3614028900,51370,50890,50400,-970,-1.89,51300,-70,-0.14,50350,50900
443,ثزاگرس,سرمايه گذاري توسعه عمران زاگرس,84,172442,10698129238,65304,62039,62039,-3265,-5,63433,-1871,-2.87,62039,62039
444,وتعاون,بيمه  تعاون,83,397758,2430301380,5933,6110,6110,177,2.98,5954,21,0.35,6110,6110
445,تسه9906,امتياز تسهيلات مسكن شهريور99,82,923,533256176,573848,575523,570000,-3848,-0.67,577742,3894,0.68,546250,602540
446,غمارگ,مارگارين‌,82,833118,26101586940,31960,31330,31330,-630,-1.97,31620,-340,-1.06,31330,31330
447,خاتم,صندوق س خاتم ايساتيس پويا-ثابت,80,2418341,26091085672,10770,10784,10790,20,0.19,10789,19,0.18,10784,10791
448,كروي,توسعه‌ معادن‌ روي‌ ايران‌,80,723756,21278426400,30000,29400,29400,-600,-2,29740,-260,-0.87,29400,29400
449,تسه9905,امتياز تسهيلات مسكن مرداد99,79,1247,708901976,582106,580000,556000,-26106,-4.48,568486,-13620,-2.34,553001,599000
450,اخزا902,اسنادخزانه-م2بودجه99-011019,77,155987,110266681881,705534,691623,713000,7466,1.06,706897,1363,0.19,691623,713000
451,شلعاب,لعابيران‌,76,156406,3498802220,22820,22370,22370,-450,-1.97,22790,-30,-0.13,22370,22370
452,دارا,صندوق س. دارا الگوريتم-د,76,1640079,16504580262,10052,10080,10066,14,0.14,10063,11,0.11,10041,10080
453,شتولي,تولي‌پرس‌,72,232149,7753080153,32743,33397,33397,654,2,33248,505,1.54,33397,33397
454,سمايه,بانك سرمايه,71,1889066,11457185290,6188,6065,6065,-123,-1.99,6114,-74,-1.2,6065,6065
455,بزاگرس,نيروگاه زاگرس كوثر,71,207225,1459278450,7185,7042,7042,-143,-1.99,7181,-4,-0.06,7042,7042
456,قشكر,شكرشاهرود,70,1081014,4086232920,3850,3780,3780,-70,-1.82,3840,-10,-0.26,3780,3780
457,افق ملت,صندوق س در سهام افق ملت,70,14788,1942374380,131370,131500,130300,-1070,-0.81,131350,-20,-0.02,130020,132000
458,ولبهمن,شركت بهمن ليزينگ,69,1011050,8138952500,8214,8050,8050,-164,-2,8186,-28,-0.34,8050,8050
459,غدام,خوراك‌  دام‌ پارس‌,68,65089,25542876270,400430,392430,392430,-8000,-2,396260,-4170,-1.04,392430,392430
460,قجامح,ح.فرآورده غذايي وقندتربت‌جام,67,206803,1329536487,6303,6429,6429,126,2,6429,126,2,6429,6429
461,دكيمي,كيميدارو,67,139822,4155361170,30300,29720,29700,-600,-1.98,30250,-50,-0.17,29700,30300
462,زمگسا,كشاورزي‌ ودامپروي‌ مگسال‌,66,307051,9840984550,32700,32050,32050,-650,-1.99,32570,-130,-0.4,32050,32050
463,تسه9904,امتياز تسهيلات مسكن تير99,66,974,557409220,585225,565009,556000,-29225,-4.99,572289,-12936,-2.21,555964,590000
464,غشاذر,پگاه‌آذربايجان‌غربي‌,66,79861,782637800,10000,9800,9800,-200,-2,10000,0,0,9800,9800
465,ثفارس,عمران‌وتوسعه‌فارس‌,65,185885,1834684950,10070,9870,9870,-200,-1.99,10060,-10,-0.1,9870,9870
466,فنورد,نوردوقطعات‌ فولادي‌,64,30026,5574326900,189430,185650,185650,-3780,-2,189000,-430,-0.23,185650,185650
467,دبالك,مواد اوليه دارويي البرز بالك,63,163230,3347684070,20927,20509,20509,-418,-2,20898,-29,-0.14,20509,20509
468,وپويا,سرمايه گذاري پويا,63,173091,1131668958,6671,6538,6538,-133,-1.99,6668,-3,-0.04,6538,6538
469,تسه9801,امتياز تسهيلات مسكن فروردين98,63,1412,621298356,463171,440013,440013,-23158,-5,440013,-23158,-5,440013,440013
470,بالاس,مهندسي ساختمان تاسيسات راه آهن,62,49127,2818858133,58550,57379,57379,-1171,-2,58481,-69,-0.12,57379,57379
471,اخزا910,اسنادخزانه-م10بودجه99-020807,62,101056,61002853874,599058,598153,606000,6942,1.16,603654,4596,0.77,598153,608700
472,قصفها,قنداصفهان‌,61,10808,1698909520,160390,157190,157190,-3200,-2,160280,-110,-0.07,157190,157190
473,لپارس,پارس‌ الكتريك‌,61,53002,4959397140,95470,93570,93570,-1900,-1.99,95280,-190,-0.2,93570,93570
474,تسه9808,امتياز تسهيلات مسكن آبان98,58,648,371852877,560038,588039,588039,28001,5,573847,13809,2.47,532600,588039
475,فبيرا,بسته‌ بندي‌ ايران‌,58,900827,2709687616,3133,3008,3008,-125,-3.99,3115,-18,-0.57,3008,3008
476,ضخود2009,اختيارخ خودرو-4000-1400/02/08,57,2849,56486000,22,20,17,-5,-22.73,20,-2,-9.09,17,25
477,خلنت,لنت‌ ترمزايران‌,56,21502,1971948420,93580,91710,91710,-1870,-2,93500,-80,-0.09,91710,91710
478,تسه9812,امتياز تسهيلات مسكن اسفند98,56,718,406483797,582357,553240,553240,-29117,-5,566133,-16224,-2.79,553240,590000
479,بالبر,كابل‌ البرز,56,161131,9450333150,59840,58650,58650,-1190,-1.99,59610,-230,-0.38,58650,58650
480,اخزا821,اسنادخزانه-م21بودجه98-020906,55,105553,63213987779,591039,595000,600000,8961,1.52,598884,7845,1.33,590014,601998
481,صنوين,صندوق سرمايه‌گذاري صنوين-مختلط,54,10304,1118986570,107830,108850,108850,1020,0.95,108600,770,0.71,107800,108850
482,اخزا909,اسنادخزانه-م9بودجه99-020316,52,192456,125681988168,645151,646101,655850,10699,1.66,653043,7892,1.22,646101,655850
483,لكما,كارخانجات‌مخابراتي‌ايران‌,52,113504,694757984,6245,6121,6121,-124,-1.99,6241,-4,-0.06,6121,6121
484,تسه9903,امتياز تسهيلات مسكن خرداد99,51,460,261734661,587073,580000,557720,-29353,-5,568988,-18085,-3.08,557720,585000
485,اخزا817,اسنادخزانه-م17بودجه98-010512,51,70857,55197799086,773798,783500,773900,102,0.01,779003,5205,0.67,773900,783700
486,تكشا,گسترش‌صنايع‌وخدمات‌كشاورزي‌,50,23294,1071989880,46950,46020,46020,-930,-1.98,46930,-20,-0.04,46020,46020
487,سقاين,سيمان‌ قائن‌,50,33657,2446190760,74160,72680,72680,-1480,-2,74090,-70,-0.09,72680,72680
488,اخزا901,اسنادخزانه-م1بودجه99-010621,50,39451,29644281697,747720,748950,754000,6280,0.84,751420,3700,0.49,747002,754000
489,اخزا908,اسنادخزانه-م8بودجه99-020606,50,128900,80527887048,619318,617070,630000,10682,1.72,624731,5413,0.87,617070,630000
490,سفانو,سيمان فارس نو,48,78176,3162219200,41270,40450,40450,-820,-1.99,41220,-50,-0.12,40450,40450
491,گكيشح,ح.توريستي ورفاهي آبادگران كيش,48,40942,1541220648,36548,37644,37644,1096,3,37644,1096,3,37644,37644
492,اخزا903,اسنادخزانه-م3بودجه99-011110,48,117312,82110260323,699148,697555,705000,5852,0.84,699931,783,0.11,697002,705000
493,غنوش,نوش‌ مازندران‌,48,18103,1016845510,57310,56170,56170,-1140,-1.99,57290,-20,-0.03,56170,56170
494,خودرو4,ايران‌ خودرو,47,22973995436,54678109137680,2650,2380,2380,-270,-10.19,2380,-270,-10.19,2380,2380
495,كسرام,پارس‌ سرام‌,47,288229,2363477800,8360,8200,8200,-160,-1.91,8350,-10,-0.12,8200,8200
496,خبازرس,بازرسي مهندسي و صنعتي ايران,46,463181,16903790595,35433,36495,36495,1062,3,36260,827,2.33,36495,36495
497,سكه0112پ03,سكه تمام بهارتحويلي1روزه سامان,45,10900,12103448400,1118558,1110009,1112400,-6158,-0.55,1110408,-8150,-0.73,1103111,1122000
498,شكف,كف,44,71880,6797332200,92711,94565,94565,1854,2,93877,1166,1.26,94565,94565
499,دپارس,پارس‌ دارو,44,24425,1997083750,83410,81920,81750,-1660,-1.99,83340,-70,-0.08,81750,81920
500,ثروتم,صندوق س. ثروت آفرين پارسيان-س,43,80500,6506037270,81099,80650,80800,-299,-0.37,80820,-279,-0.34,80500,81400
501,سصفها,سيمان‌اصفهان‌,43,6306,775764120,128140,123020,123020,-5120,-4,128060,-80,-0.06,123020,123020
502,ساوه,سيمان ساوه,43,67271,4040094447,61282,60057,60057,-1225,-2,61181,-101,-0.16,60057,60057
503,غويتا,ويتانا,43,61263,1093789602,18218,17854,17854,-364,-2,18210,-8,-0.04,17854,17854
504,كوير,توليدي فولاد سپيد فراب كوير,43,30536,674540240,22540,22090,22090,-450,-2,22540,0,0,22090,22090
505,تپمپي,پمپ‌ سازي‌ ايران‌,43,66890,1274923400,19440,19060,19060,-380,-1.95,19430,-10,-0.05,19060,19060
506,چكاوه,صنايع‌كاغذسازي‌كاوه‌,42,58625,1068147500,18590,18220,18220,-370,-1.99,18580,-10,-0.05,18220,18220
507,زعف0008پ11,زعفران0008نگين سحرخيز(پ),42,46598,5594943198,121010,116500,119501,-1509,-1.25,120068,-942,-0.78,116500,121915
508,فلات,گروه صنايع معادن فلات ايرانيان,42,362843,5698449315,16025,15705,15705,-320,-2,15935,-90,-0.56,15705,15705
509,تسه9901,امتياز تسهيلات مسكن فروردين99,41,281,160906938,600615,572777,576000,-24615,-4.1,572623,-27992,-4.66,570585,580000
510,زماهان,مجتمع توليد گوشت مرغ ماهان,41,395809,8038880790,20724,20310,20310,-414,-2,20656,-68,-0.33,20310,20310
511,شدوص,دوده‌ صنعتي‌ پارس‌,41,721133,20436909220,28910,28340,28340,-570,-1.97,28670,-240,-0.83,28340,28340
512,چخزر,صنايع چوب خزر كاسپين,41,9070,522495490,58782,57607,57607,-1175,-2,58769,-13,-0.02,57607,57607
513,كترام,توليدي‌ كاشي‌ تكسرام‌,40,55107,2631910320,48730,47760,47760,-970,-1.99,48680,-50,-0.1,47760,47760
514,فرآور,فرآوري‌موادمعدني‌ايران‌,40,60135,2091495300,35480,34780,34780,-700,-1.97,35450,-30,-0.08,34780,34780
515,تسه9806,امتياز تسهيلات مسكن شهريور98,40,359,203847845,567878,565555,555011,-12867,-2.27,567821,-57,-0.01,550003,585000
516,غشصفا,شيرپاستوريزه‌پگاه‌اصفهان‌,40,58759,1615423990,28050,27490,27490,-560,-2,28030,-20,-0.07,27490,28150
517,تپكو,توليدتجهيزات‌سنگين‌هپكو,40,289544,1551955840,5469,5360,5360,-109,-1.99,5465,-4,-0.07,5360,5360
518,دفارا,داروسازي‌ فارابي‌,39,35764,2324660000,66320,65000,65000,-1320,-1.99,66260,-60,-0.09,65000,65000
519,وملت,سرمايه گذاري ملت,39,299557,1279707504,4449,4272,4272,-177,-3.98,4425,-24,-0.54,4272,4272
520,كسعدي,كاشي‌ سعدي‌,39,193809,4079679450,21470,21050,21050,-420,-1.96,21430,-40,-0.19,21050,21050
521,سخاش,سيمان‌خاش‌,38,15874,2436659000,156630,153500,153500,-3130,-2,156470,-160,-0.1,153500,153500
522,فردا,صندوق س آواي فرداي زاگرس-ثابت,38,167344,1746340916,10430,10439,10433,3,0.03,10436,6,0.06,10432,10440
523,ديران,ايران‌دارو,38,31669,841128640,27100,26560,26560,-540,-1.99,27090,-10,-0.04,26560,26560
524,ضپاس2002,اختيارخ وپارس-3000-1400/02/29,37,772,243790000,330,300,315,-15,-4.55,316,-14,-4.24,291,380
525,تسه9811,امتياز تسهيلات مسكن بهمن98,37,373,213909089,598292,575000,568378,-29914,-5,573483,-24809,-4.15,568378,590000
526,زنجان,صنايع كشاورزي وكود زنجان,37,94925,859830650,9435,9058,9058,-377,-4,9418,-17,-0.18,9058,9058
527,الماس,صندوق س.امين تدبيرگران فردا-س,36,10179,1124827816,110007,109002,109261,-746,-0.68,110505,498,0.45,109000,111200
528,سنوين,سرمايه گذاري اقتصاد نوين,36,1040404,9877595576,9687,9494,9494,-193,-1.99,9585,-102,-1.05,9494,9494
529,دمعيار,صندوق س. توازن معيار-د,36,1125470,11314166330,10040,10055,10053,13,0.13,10053,13,0.13,10050,10055
530,داريك,صندوق س.اعتماد داريك-د,36,102956,1080190468,10474,10104,10475,1,0.01,10492,18,0.17,10104,10501
531,تسه9809,امتياز تسهيلات مسكن آذر98,36,350,198439923,559343,560000,565000,5657,1.01,566971,7628,1.36,555100,585000
532,خزر,فنرسازي‌زر,35,38078,1743210840,47680,45780,45780,-1900,-3.98,47610,-70,-0.15,45780,45780
533,سكه0012پ04,سكه تمام بهارتحويلي1روز صادرات,35,8300,9174974300,1118885,1105100,1110000,-8885,-0.79,1105419,-13466,-1.2,1100500,1113000
534,تسه9807,امتياز تسهيلات مسكن مهر98,34,215,119967971,570175,552000,570000,-175,-0.03,557991,-12184,-2.14,541670,575000
535,دكوثر,داروسازي‌ كوثر,34,114044,2320795400,20760,20350,20350,-410,-1.97,20740,-20,-0.1,20350,20350
536,آسام,صندوق س.آرمان سپهر آشنا-م,33,9350,1017484370,108961,109500,108799,-162,-0.15,108822,-139,-0.13,108021,109500
537,غپآذر,شير پگاه آذربايجان شرقي,33,8319,536575500,65816,64500,64500,-1316,-2,65802,-14,-0.02,64500,64500
538,تاپكيش,تجارت الكترونيك پارسيان كيش,33,448411,8312194707,18915,18537,18537,-378,-2,18851,-64,-0.34,18537,18537
539,تسه9804,امتياز تسهيلات مسكن تير98,33,298,175445362,605253,583030,575010,-30243,-5,588743,-16510,-2.73,574991,605890
540,وكادو,تكادو,32,225835,4344387895,19629,19237,19237,-392,-2,19540,-89,-0.45,19237,19237
541,وگستر,گسترش سرمايه گذاري ايرانيان,32,66744,1264064616,19325,18939,18939,-386,-2,19315,-10,-0.05,18939,18939
542,تكنو,تكنوتار,32,157965,3500504400,22610,22160,22160,-450,-1.99,22580,-30,-0.13,22160,22160
543,فلامي,لاميران‌,31,88007,3876708350,44940,44050,44050,-890,-1.98,44870,-70,-0.16,44050,44050
544,گنجين,صندوق س. گنجينه يكم آويد-د,31,506689,6343703281,12521,12519,12530,9,0.07,12520,-1,-0.01,12300,12530
545,اوصتا,صندوق انديشه ورزان صباتامين -د,31,494442,9018908067,18231,18245,18249,18,0.1,18241,10,0.05,18235,18250
546,واميد,گروه مديريت سرمايه گذاري اميد,30,72866,935599440,13100,12840,12840,-260,-1.98,13100,0,0,12840,12840
547,شسينا,صنايع‌شيميايي‌سينا,30,11116,1481762800,136020,133300,133300,-2720,-2,135940,-80,-0.06,133300,133300
548,خاذين,سايپاآذين‌,30,155010,722346600,4750,4660,4660,-90,-1.89,4750,0,0,4660,4660
549,گدنا,تهيه توزيع غذاي دنا آفرين فدك,30,9460,315216660,34001,33321,33321,-680,-2,33997,-4,-0.01,33321,33321
550,فمراد,آلومراد,30,4958,700317500,144130,141250,141250,-2880,-2,144090,-40,-0.03,141250,141250
551,سنير,سيمان‌ سفيد ني‌ريز,30,8201,1980459490,251550,241490,241490,-10060,-4,251130,-420,-0.17,241490,241490
552,گكيش,توريستي ورفاهي آبادگران كيش,29,15390,771669990,51164,50141,50141,-1023,-2,51122,-42,-0.08,50141,50141
553,ثاباد,توريستي ورفاهي آبادگران ايران,29,26964,1453898880,55020,53920,53920,-1100,-2,54990,-30,-0.05,53920,53920
554,وسبحان,سرمايه گذاري سبحان,28,130378,411603346,3221,3157,3157,-64,-1.99,3220,-1,-0.03,3157,3157
555,قثابت,قند ثابت‌ خراسان‌,27,13377,899335710,68600,67230,67230,-1370,-2,68570,-30,-0.04,67230,67230
556,ضترا3002,اختيارخ شتران-8000-1400/03/09,27,128,382285000,2495,2800,2603,108,4.33,2987,492,19.72,2555,3300
557,ثنوسا,نوسازي‌وساختمان‌تهران‌,27,30661,391847580,13040,12780,12780,-260,-1.99,13040,0,0,12780,12780
558,زفكا,كشت و دامداري فكا,27,34090,442999550,13260,12995,12995,-265,-2,13258,-2,-0.02,12995,12995
559,بذر,صندوق س بذر اميد آفرين-سهام,26,13176,1336690790,102310,101450,101700,-610,-0.6,101450,-860,-0.84,101440,101700
560,خفنر,فنرسازي‌خاور,25,109349,928373010,8660,8490,8490,-170,-1.96,8660,0,0,8490,8490
561,فيروزا,صندوق بادرآمد ثابت فيروزه آسيا,25,256626,5760959884,22345,22345,22470,125,0.56,22449,104,0.47,22345,22510
562,پارتا,مجتمع‌صنعتي‌آرتاويل‌تاير,25,13886,768715074,56488,55359,55359,-1129,-2,56455,-33,-0.06,55359,55359
563,هجرت,پخش هجرت,24,76990,2139321130,28354,27787,27787,-567,-2,28329,-25,-0.09,27787,27787
564,غشان,شيرپاستوريزه‌پگاه‌خراسان‌,24,529627,4003980120,7710,7560,7560,-150,-1.95,7700,-10,-0.13,7560,7560
565,غگرجي,بيسكويت‌  گرجي‌,24,17185,319297300,18950,18580,18580,-370,-1.95,18950,0,0,18580,18580
566,قاسم,قاسم ايران,24,42803,572276110,13642,13370,13370,-272,-1.99,13639,-3,-0.02,13370,13370
567,توريل,توکاريل,24,39369,972926097,25217,24713,24713,-504,-2,25207,-10,-0.04,24713,24713
568,سفار,سيمان‌فارس‌,24,4981,741272420,155020,148820,148820,-6200,-4,154920,-100,-0.06,148820,148820
569,قمرو,قند مرودشت‌,23,12930,468841800,36990,36260,36260,-730,-1.97,36980,-10,-0.03,36260,36260
570,پلوله,گازلوله‌,23,564554,12341150440,21224,21860,21860,636,3,21583,359,1.69,21860,21860
571,تسه9805,امتياز تسهيلات مسكن مرداد98,23,188,104728942,557708,562010,570000,12292,2.2,557069,-639,-0.11,551300,570000
572,اخزا820,اسنادخزانه-م20بودجه98-020806,23,34623,21070770950,599599,603999,601555,1956,0.33,608577,8978,1.5,601555,610000
573,ضشنا2003,اختيارخ شپنا-14000-1400/02/27,23,613,864786000,1426,1399,1409,-17,-1.19,1411,-15,-1.05,1315,1800
574,سجام,مجتمع سيمان غرب آسيا,22,54742,276830294,5160,5057,5057,-103,-2,5159,-1,-0.02,5057,5057
575,ساروج,بين المللي ساروج بوشهر,22,94565,1811865400,19551,19160,19160,-391,-2,19515,-36,-0.18,19160,19160
576,بايكا,كارخانجات كابلسازي ‌ايران‌,21,54207,2252192436,42395,41548,41548,-847,-2,42297,-98,-0.23,41548,41548
577,دشيمي,شيمي‌ داروئي‌ داروپخش‌,21,7625,233020000,31180,30560,30560,-620,-1.99,31180,0,0,30560,30560
578,وآوا,سرمايه گذاري آوا نوين,21,147454,1286536150,8903,8725,8725,-178,-2,8898,-5,-0.06,8725,8725
579,ثقزوي,شركت عمران و سازندگي قزوين,21,7562,231533316,31893,30618,30618,-1275,-4,31878,-15,-0.05,30618,30618
580,كخاكح,ح . صنايع‌خاك‌چيني‌ايران‌,21,247593,9562041660,38620,38620,38620,0,0,38620,0,0,38620,38620
581,سخزر,سيمان‌ خزر,21,15060,454510800,30790,30180,30180,-610,-1.98,30780,-10,-0.03,30180,30180
582,قشير,قند شيروان قوچان و بجنورد,21,11547,291642579,25772,25257,25257,-515,-2,25769,-3,-0.01,25257,25257
583,آكورد2,صندوق س. آرمان آتي كوثر-د,20,2000000,2000000,31322,1,1,-31321,-100,1,-31321,-100,1,1
584,ساروم,سيمان‌اروميه‌,20,10385,421734850,41430,40610,40610,-820,-1.98,41420,-10,-0.02,40610,40610
585,غديس,پاكديس,20,60482,798301918,13468,13199,13199,-269,-2,13464,-4,-0.03,13199,13199
586,وآذر,سرمايه‌گذاري‌توسعه‌آذربايجان‌,20,7297,613604730,85800,84090,84090,-1710,-1.99,85780,-20,-0.02,84090,84090
587,اخزا815,اسنادخزانه-م15بودجه98-010406,20,19574,15413112913,785171,785957,786000,829,0.11,787428,2257,0.29,785957,793000
588,وليز,ليزينگ‌ايران‌,19,81803,764858050,9540,9350,9350,-190,-1.99,9540,0,0,9350,9350
589,دابور,داروسازي‌ ابوريحان‌,19,7925,306459750,39450,38670,38670,-780,-1.98,39450,0,0,38670,38670
590,ضمخا7066,اختيارخ اخابر-12000-1400/07/28,18,175,301459000,2917,1201,2400,-517,-17.72,1723,-1194,-40.93,1100,2400
591,ضجار2003,اختيارخ وتجارت-3000-1400/02/22,18,1240,204605000,209,190,160,-49,-23.44,165,-44,-21.05,150,190
592,غصينو,صنعتي مينو,18,12004,801327020,68117,66755,66755,-1362,-2,68106,-11,-0.02,66755,66755
593,خموتور,موتورسازان‌تراكتورسازي‌ايران‌,18,71429,1054292040,15060,14760,14760,-300,-1.99,15050,-10,-0.07,14760,14760
594,ثالوند,سرمايه گذاري مسكن الوند,18,25193,811768846,32879,32222,32222,-657,-2,32868,-11,-0.03,32222,32222
595,سدور,سيمان‌ دورود,18,99926,1901591780,19410,19030,19030,-380,-1.96,19400,-10,-0.05,19030,19030
596,ساربيل,سيمان آرتا اردبيل,18,7971,453470190,58050,56890,56890,-1160,-2,58040,-10,-0.02,56890,56890
597,سدشت,صنايع سيمان دشتستان,17,11070,669956400,57100,60520,60520,3420,5.99,57140,40,0.07,60520,60520
598,سباقر,سيمان باقران,17,88951,1690069000,18986,19000,19000,14,0.07,18987,1,0.01,19000,19000
599,ثاصفا,شركت‌ ساختمان‌ اصفهان‌,17,63407,1742628905,27820,27264,27264,-556,-2,27790,-30,-0.11,27264,28654
600,ضترا3003,اختيارخ شتران-9000-1400/03/09,17,93,196085000,1400,2221,2000,600,42.86,2108,708,50.57,2000,2222
601,وهنر,گروه توسعه هنر ايران,16,131649,1154825028,8951,8772,8772,-179,-2,8940,-11,-0.12,8772,8772
602,غشوكو,شوكو پارس,16,4987,191356177,39969,38371,38371,-1598,-4,39953,-16,-0.04,38371,38371
603,كاذر,فرآورده‌هاي‌نسوزآذر,16,7958,255770120,32790,32140,32140,-650,-1.98,32790,0,0,32140,32140
604,شپنا4,پالايش نفت اصفهان,16,3962409928,46786675609270,14140,9810,13300,-840,-5.94,11808,-2332,-16.49,9340,15740
605,بهپاك,صنعتي بهپاك,16,53484,2352814644,44888,43991,43991,-897,-2,44845,-43,-0.1,43991,43991
606,كساوه,صنايع‌ كاشي‌ و سراميك‌ سينا,16,5256,364188240,70700,69290,69290,-1410,-1.99,70690,-10,-0.01,69290,69290
607,شتوكا,توكا رنگ فولاد سپاهان,16,3932,209131284,54272,53187,53187,-1085,-2,54267,-5,-0.01,53187,53187
608,حآسا,آسيا سير ارس,15,47670,2108110410,45125,44223,44223,-902,-2,45086,-39,-0.09,44223,44223
609,تملي804,تسهيلات مسكن ب. ملي-تير98,15,120,119667852,953685,1001369,1001369,47684,5,997232,43547,4.57,960000,1001369
610,دجابر,داروسازي‌ جابرابن‌حيان‌,15,12936,257038320,20270,19870,19870,-400,-1.97,20270,0,0,19870,19870
611,تابا,تابان نيرو سپاهان,15,27284,1478328972,56440,54183,54183,-2257,-4,56266,-174,-0.31,54183,54183
612,پاسا,ايران‌ياساتايرورابر,15,62620,1639391600,26710,26180,26180,-530,-1.98,26690,-20,-0.07,26180,26180
613,كتوكا,توليدي و خدمات صنايع نسوز توكا,15,3728,142685472,39055,38274,38274,-781,-2,39053,-2,-0.01,38274,38274
614,غبهار,كشت وصنعت بهاران گلبهار خراسان,15,12274,412455496,34289,33604,33604,-685,-2,34275,-14,-0.04,33604,33604
615,اخزا811,اسنادخزانه-م11بودجه98-001013,14,22349,19349939410,864000,865022,868010,4010,0.46,865808,1808,0.21,865022,868010
616,زعف0008پ20,زعفران0008نگين وحدت جام(پ),14,18778,2222595000,118916,118600,118600,-316,-0.27,118362,-554,-0.47,118000,118600
617,اخزا806,اسنادخزانه-م6بودجه98-000519,14,13456,12528988506,928576,931510,932999,4423,0.48,931108,2532,0.27,930530,932999
618,غاذر,كشت‌وصنعت‌پياذر,14,20822,1142711360,55990,54880,54880,-1110,-1.98,55960,-30,-0.05,54880,54880
619,كلوند,كاشي‌ الوند,14,26313,1200399060,46550,45620,45620,-930,-2,46530,-20,-0.04,45620,45620
620,كساپا,سايپاشيشه‌,14,28460,1092579400,39170,38390,38390,-780,-1.99,39150,-20,-0.05,38390,38390
621,حپارسا,توسعه حمل و نقل ريلي پارسيان,14,8978,310046252,35238,34534,34534,-704,-2,35234,-4,-0.01,34534,34534
622,غدشت,دشت‌ مرغاب‌,14,3746,1066074140,290390,284590,284590,-5800,-2,290260,-130,-0.04,284590,284590
623,غمهرا,توليدي‌مهرام‌,13,2925,349771500,122020,119580,119580,-2440,-2,122000,-20,-0.02,119580,119580
624,زعف0008پ12,زعفران0008پوشالمعمول سحرخيز(پ),13,777,69593619,89175,85002,92500,3325,3.73,89567,392,0.44,85002,92500
625,كفرا,فراورده‌ هاي‌ نسوزايران‌,13,11106,516762180,47470,46530,46530,-940,-1.98,47460,-10,-0.02,46530,46530
626,فجام,جام‌دارو,13,7762,78939540,10370,10170,10170,-200,-1.93,10370,0,0,10170,10170
627,اخزا808,اسنادخزانه-م8بودجه98-000817,13,3982,3537258280,886806,885000,889110,2304,0.26,888312,1506,0.17,885000,889115
628,ضشنا2001,اختيارخ شپنا-10000-1400/02/27,12,42,172700000,4097,4480,4000,-97,-2.37,4112,15,0.37,3800,4680
629,ثعمرا,عمران و توسعه شاهد,12,35790,457933050,13056,12795,12795,-261,-2,13054,-2,-0.02,12795,12795
630,ضفلا3005,اختيارخ فولاد-9986-1400/03/19,12,114,134190000,1168,1200,1230,62,5.31,1177,9,0.77,1001,1300
631,سيلام,سيمان‌ ايلام‌,12,61339,675955780,11240,11020,11020,-220,-1.96,11240,0,0,11020,11020
632,وايران,ليزينگ ايرانيان,12,16400,202212000,12580,12330,12330,-250,-1.99,12580,0,0,12330,12330
633,شتران4,پالايش نفت تهران,12,1713202275,15009369983130,10050,9520,7800,-2250,-22.39,8761,-1289,-12.83,7800,9690
634,ضملي3004,اختيارخ فملي-14000-1400/03/02,12,313,266162000,890,900,761,-129,-14.49,850,-40,-4.49,760,998
635,سخند,صندوق س.سپهرخبرگان نفت-د,11,65560,663758650,10119,10123,10124,5,0.05,10124,5,0.05,10123,10130
636,داوه,داروسازي آوه سينا,11,15798,312689814,20196,19793,19793,-403,-2,20193,-3,-0.01,19793,19793
637,ضپاس2003,اختيارخ وپارس-3500-1400/02/29,11,64,14278000,200,200,190,-10,-5,223,23,11.5,155,239
638,ولملت,واسپاري ملت,11,39492,316725840,8180,8020,8020,-160,-1.96,8180,0,0,8020,8020
639,درهآور,دارويي ره آورد تامين,11,4925,257016050,53251,52186,52186,-1065,-2,53245,-6,-0.01,52186,52186
640,اخزا914,اسنادخزانه-م14بودجه99-021025,11,13363,7730949776,568051,570001,596450,28399,5,578534,10483,1.85,570001,596452
641,خوساز,محورسازان‌ايران‌خودرو,10,23873,187641780,8020,7860,7860,-160,-2,8020,0,0,7860,7860
642,شبريز4,پالايش نفت تبريز,10,729510188,20313415115620,31960,24150,22990,-8970,-28.07,27845,-4115,-12.88,22990,32720
643,سفاسي,شركت فارسيت اهواز,10,38775,538041900,14454,13876,13876,-578,-4,14438,-16,-0.11,13876,13876
644,چافست,افست‌,10,11314,184078780,16600,16270,16270,-330,-1.99,16600,0,0,16270,16270
645,قجام,فرآوردههاي غذايي وقندتربت‌جام‌,10,9265,149740930,16491,16162,16162,-329,-2,16486,-5,-0.03,16162,16162
646,ركيش,كارت اعتباري ايران كيش,10,43957,1059363700,24590,24100,24100,-490,-1.99,24580,-10,-0.04,24100,24100
647,غچين,كشت‌ و صنعت‌ چين‌ چين,10,32039,634051810,20190,19790,19790,-400,-1.98,20180,-10,-0.05,19790,19790
648,عيار2,صندوق س. پشتوانه طلاي مفيد,10,100000,100000,28139,1,1,-28138,-100,1,-28138,-100,1,1
649,فسديد,لوله‌وتجهيزات‌ سديد - ورشكسته,10,12440,1425474720,115745,114588,114588,-1157,-1,115411,-334,-0.29,114588,114588
650,حتوكا,حمل‌ونقل‌توكا,10,9078,274427940,30840,30230,30230,-610,-1.98,30840,0,0,30230,30230
651,تمحركه,ماشين سازي نيرو محركه,10,11128,225152824,20645,20233,20233,-412,-2,20640,-5,-0.02,20233,20233
652,گپارس,امور رفاهي كارگزاران پارس,10,687,137666556,208737,200388,200388,-8349,-4,208677,-60,-0.03,200388,200388
653,ضفلا3003,اختيارخ فولاد-7133-1400/03/19,10,76,339348000,4315,4700,4500,185,4.29,4465,150,3.48,4000,4700
654,ثپرديس,سرمايه گذاري مسكن پرديس,10,7660,76354880,10171,9968,9968,-203,-2,10171,0,0,9968,9968
655,فپنتا,سپنتا,10,750,301597500,410330,402130,402130,-8200,-2,410280,-50,-0.01,402130,402130
656,بكاب,صنايع‌جوشكاب‌يزد,10,304,107488320,360790,353580,353580,-7210,-2,360770,-20,-0.01,353580,353580
657,بشهاب,لامپ‌  پارس‌ شهاب‌,10,11325,1660131750,149580,146590,146590,-2990,-2,149480,-100,-0.07,146590,146590
658,اوان,مبين وان كيش,10,12197,654844733,54784,53689,53689,-1095,-2,54769,-15,-0.03,53689,53689
659,اخزا813,اسنادخزانه-م13بودجه98-010219,10,11886,9581183030,806988,810002,809999,3011,0.37,806090,-898,-0.11,803002,811000
660,غگلستا,شير پاستوريزه پگاه گلستان,9,11645,326653895,28623,28051,28051,-572,-2,28619,-4,-0.01,28051,28051
661,لازما,كارخانه هاي صنعتي آزمايش,9,9181,310161723,34472,33783,33783,-689,-2,34461,-11,-0.03,33783,33783
662,ثتوسا,س.توسعه و عمران استان اردبيل,9,4653,183072285,40147,39345,39345,-802,-2,40139,-8,-0.02,39345,39345
663,كپشير,پشم‌شيشه‌ايران‌,9,8960,353113600,40210,39410,39410,-800,-1.99,40200,-10,-0.02,39410,39410
664,سخواف,سيمان مجد خواف,9,25202,421453046,17064,16723,16723,-341,-2,17057,-7,-0.04,16723,16723
665,اخزا713,اسنادخزانه-م13بودجه97-000518,9,614,571808194,930999,942000,931022,23,0,931284,285,0.03,931022,942000
666,اخزا904,اسنادخزانه-م4بودجه99-011215,9,69189,48793307970,699939,705999,690500,-9439,-1.35,705218,5279,0.75,690500,706000
667,ثشرق,سرمايه گذاري مسكن شمال شرق,9,32947,223380660,6910,6780,6780,-130,-1.88,6910,0,0,6780,6780
668,اراد50,مرابحه عام دولت5-ش.خ0302,9,200000,200000200000,1000001,1000001,1000001,0,0,1000001,0,0,1000001,1000001
669,زعف0008پ05,زعفران0008نگين زرين(پ),8,2340,277659310,118817,119000,119500,683,0.57,118658,-159,-0.13,118002,119500
670,ضمخا7071,اختيارخ اخابر-24000-1400/07/28,8,511,104311000,203,205,211,8,3.94,204,1,0.49,200,211
671,سبهان,سيمان‌ بهبهان‌,8,1587,221402370,142350,139510,139510,-2840,-2,142340,-10,-0.01,139510,139510
672,شبندر4,پالايش نفت بندرعباس,8,1316274116,33340055647800,28000,25960,29630,1630,5.82,25329,-2671,-9.54,19220,29630
673,كطبس,ذغال‌سنگ‌ نگين‌ ط‌بس‌,8,911,73690790,82540,80890,80890,-1650,-2,82540,0,0,80890,80890
674,قيستو,شركت قند بيستون,8,220184,3503127440,15599,15910,15910,311,1.99,15706,107,0.69,15910,15910
675,زعف0008پ15,زعفران0008پوشالمعمول طلاسرخ(پ),8,2250,203348800,89652,90000,89999,347,0.39,90377,725,0.81,89999,93870
676,حسير,ريل سير كوثر,8,12965,221208830,17410,17062,17062,-348,-2,17408,-2,-0.01,17062,17062
677,قهكمت,قندهكمتان‌,8,18415,833831200,46200,45280,45280,-920,-1.99,46180,-20,-0.04,45280,45280
678,آ س پ,آ.س.پ,8,9726,153884772,16144,15822,15822,-322,-1.99,16143,-1,-0.01,15822,15822
679,فنفت,صنايع تجهيزات نفت,8,12157,399089996,33497,32828,32828,-669,-2,33483,-14,-0.04,32828,32828
680,اخزا814,اسنادخزانه-م14بودجه98-010318,8,807,651063580,807088,800100,807100,12,0,806770,-318,-0.04,800100,807100
681,اخزا818,اسنادخزانه-م18بودجه98-010614,8,4282,3259882719,762840,760000,760017,-2823,-0.37,761299,-1541,-0.2,760000,763001
682,ولصنم,ليزينگ‌صنعت‌ومعدن‌,7,14983,163015040,11100,10880,10880,-220,-1.98,11100,0,0,10880,10880
683,سدبير,س. تدبيرگران فارس وخوزستان,7,7663,673661993,89705,87911,87911,-1794,-2,89680,-25,-0.03,87911,87911
684,سبجنو,سيمان‌ بجنورد,7,46709,2731075230,59660,58470,58470,-1190,-1.99,59590,-70,-0.12,58470,58470
685,شزنگ,تجهيزنيروي‌زنگان‌,7,188,43362952,235361,230654,230654,-4707,-2,235351,-10,0,230654,230654
686,قلرست,قند لرستان‌,7,4410,155055600,35870,35160,35160,-710,-1.98,35870,0,0,35160,35160
687,اخزا907,اسنادخزانه-م7بودجه99-020704,7,34159,21055631100,612156,613200,617500,5344,0.87,616401,4245,0.69,613200,620000
688,ضصاد3004,اختيارخ وبصادر-3500-1400/03/12,7,640,43060000,117,69,67,-50,-42.74,67,-50,-42.74,67,69
689,آينده,بازرگاني آينده سازان بهشت پارس,7,8060,157492400,19938,19540,19540,-398,-2,19935,-3,-0.02,19540,19540
690,ثغرب,شركت سرمايه گذاري مسكن شمالغرب,7,17005,132843060,7971,7812,7812,-159,-1.99,7971,0,0,7812,7812
691,سفارود,كارخانه فارسيت درود,7,13855,246923810,18185,17822,17822,-363,-2,18176,-9,-0.05,17822,17822
692,خعمرا,توسعه و عمران شهرستان نائين,7,13318,309736726,22580,23257,23257,677,3,22590,10,0.04,23257,23257
693,آبين,كشت و صنعت آبشيرين,7,11079,45878139,4225,4141,4141,-84,-1.99,4225,0,0,4141,4141
694,تملي806,تسهيلات مسكن ب. ملي-شهريور98,7,55,54051690,959029,962573,1006980,47951,5,982758,23729,2.47,962573,1006980
695,اخزا721,اسنادخزانه-م21بودجه97-000728,7,8119,7291291392,897020,898000,898021,1001,0.11,898053,1033,0.12,898000,900000
696,اخزا720,اسنادخزانه-م20بودجه97-000324,7,297,285826149,959437,961000,962499,3062,0.32,962378,2941,0.31,961000,962499
697,سپرمي,پرميت‌,6,80000,715040000,8850,8938,8938,88,0.99,8862,12,0.14,8938,8938
698,ياقوت2,صندوق س ياقوت آگاه-ثابت,6,82618370,82618370,12150,1,1,-12149,-99.99,1,-12149,-99.99,1,1
699,زعف0008پ18,زعفران0008نگين بهرامن(پ),6,1630,192866400,121930,118300,118015,-3915,-3.21,118323,-3607,-2.96,118015,121890
700,ضجار2002,اختيارخ وتجارت-2500-1400/02/22,6,309,140623000,510,472,447,-63,-12.35,455,-55,-10.78,447,472
701,قزوين,كارخانجات‌ قند قزوين‌,6,4113,159748920,39630,38840,38840,-790,-1.99,39630,0,0,38840,38840
702,ضشنا2004,اختيارخ شپنا-16000-1400/02/27,6,148,111938000,800,721,771,-29,-3.63,756,-44,-5.5,721,772
703,ضملت3002,اختيارخ وبملت-4000-1400/03/19,6,276,192840000,773,630,650,-123,-15.91,699,-74,-9.57,630,760
704,پرداخت,به پرداخت ملت,6,1789,62114080,35420,34720,34720,-700,-1.98,35420,0,0,34720,34720
705,البرز4,بيمه البرز,6,748657987,2597843214890,4130,3470,3470,-660,-15.98,3470,-660,-15.98,3470,3470
706,اخزا810,اسنادخزانه-م10بودجه98-001006,6,5560,4826197850,866627,868022,868021,1394,0.16,868021,1394,0.16,868021,868030
707,ددام,داروسازي زاگرس فارمد پارس,6,2826,61945920,22360,21920,21920,-440,-1.97,22360,0,0,21920,21920
708,ثعتما,س. ساختماني اعتماد گستر,6,2659,176347539,67674,66321,66321,-1353,-2,67662,-12,-0.02,66321,66321
709,چفيبر,فيبر ايران‌,5,6254,85242020,13900,13630,13630,-270,-1.94,13900,0,0,13630,13630
710,كمرجان,بازرگاني و توليدي مرجان كار,5,357,51435489,147017,144077,144077,-2940,-2,147014,-3,0,144077,144077
711,ضخود2012,اختيارخ خودرو-6000-1400/02/08,5,213,1828000,11,10,8,-3,-27.27,9,-2,-18.18,8,10
712,پلاست,كارخانجات توليدي پلاستيران,5,1348,95218676,72078,70637,70637,-1441,-2,72071,-7,-0.01,70637,70637
713,حپترو,حمل و نقل پتروشيمي( سهامي عام,5,25640,1362509600,54220,53140,53140,-1080,-1.99,54190,-30,-0.06,53140,53140
714,نهال2,صندوق س. طلاي سرخ نوويرا,5,500000,500000,9303,1,1,-9302,-99.99,1,-9302,-99.99,1,1
715,فولاي,صنايع فولاد آلياژي يزد,5,939,47088972,51171,50148,50148,-1023,-2,51170,-1,0,50148,50148
716,ضسپا3002,اختيارخ خساپا-1800-1400/03/26,5,28,15609000,750,566,556,-194,-25.87,557,-193,-25.73,556,566
717,اخزا809,اسنادخزانه-م9بودجه98-000923,5,1447,1263262834,871991,873022,873022,1031,0.12,873022,1031,0.12,873022,873022
718,زعف0008پ09,زعفران0008نگين نوين(پ),5,1195,141255000,116337,118340,119000,2663,2.29,118205,1868,1.61,118000,119000
719,داسوه,داروسازي‌ اسوه‌,5,3844,140882600,37390,36650,36650,-740,-1.98,37390,0,0,36650,36650
720,خپويش,سازه‌ پويش‌,5,634,37558160,60440,59240,59240,-1200,-1.99,60440,0,0,59240,59240
721,لپيام,گسترش صنايع پيام,5,2536,137101232,55165,54062,54062,-1103,-2,55157,-8,-0.01,54062,54062
722,پست0008پ08,پسته فندقي32-30مه ولات0008(پ),5,109,156110000,1419000,1430000,1490000,71000,5,1432202,13202,0.93,1430000,1490000
723,خچرخش,چرخشگر,5,4780,85657600,18280,17920,17920,-360,-1.97,18280,0,0,17920,17920
724,اخزا816,اسنادخزانه-م16بودجه98-010503,5,1490,1164318875,776301,782000,777000,699,0.09,781422,5121,0.66,775511,782000
725,وثخوز,سرمايه گذاري و توسعه خوزستان,5,3801,255837708,70850,67308,67308,-3542,-5,70802,-48,-0.07,67308,67308
726,نيرو,نيرو سرمايه,5,4291,223779941,53215,52151,52151,-1064,-2,53203,-12,-0.02,52151,52151
727,ضغدر3002,اختيارخ وغدير-8200-1400/03/26,4,11,46450000,4018,4300,4150,132,3.29,4223,205,5.1,4150,4300
728,صخابر102,صكوك اجاره مخابرات-3 ماهه 16%,4,20195,19579052500,960000,969500,969500,9500,0.99,969500,9500,0.99,969500,969500
729,وسناح,ح. سرمايه گذاري نيروگاهي ايران,4,3894,60928644,15127,16034,14522,-605,-4,15647,520,3.44,14522,16034
730,دحاوي,الحاوي,4,3193,38261719,12227,11983,11983,-244,-2,12227,0,0,11983,11983
731,ضملي3000,اختيارخ فملي-8000-1400/03/02,4,7,36279000,6167,5700,5183,-984,-15.96,5183,-984,-15.96,5010,5700
732,حخزر,كشتيراني درياي خزر,4,2980,85514080,29281,28696,28696,-585,-2,29280,-1,0,28696,28696
733,كابگن,توليدي و صنعتي آبگينه‌,4,11588,60512536,5120,5222,5222,102,1.99,5121,1,0.02,5222,5222
734,اخزا812,اسنادخزانه-م12بودجه98-001111,4,3560,3045712670,855306,855900,856000,694,0.08,855537,231,0.03,855021,856000
735,زكشت,كشاورزي مكانيزه اصفهان كشت,4,903,35745255,40392,39585,39585,-807,-2,40391,-1,0,39585,39585
736,ونيكي4,سرمايه‌گذاري‌ ملي‌ايران‌,4,519890350,8155514042060,11190,22210,11230,40,0.36,15687,4497,40.19,11230,22210
737,ضفلا3004,اختيارخ فولاد-8560-1400/03/19,4,46,111271000,2340,2500,2346,6,0.26,2419,79,3.38,2346,2500
738,ضملي3003,اختيارخ فملي-12000-1400/03/02,4,8,15188000,2003,1900,1900,-103,-5.14,1898,-105,-5.24,1888,1900
739,ضپاس2004,اختيارخ وپارس-4000-1400/02/29,4,17,1733000,143,122,100,-43,-30.07,102,-41,-28.67,100,122
740,ضچاد2005,اختيارخ كچاد-24000-1400/02/05,4,7,8100000,2000,1000,1500,-500,-25,1157,-843,-42.15,1000,1500
741,ضخود2013,اختيارخ خودرو-7000-1400/02/08,4,400,2900000,6,7,7,1,16.67,7,1,16.67,7,8
742,واحصا,احياء صنايع خراسان,4,1428,102017748,72898,71441,71441,-1457,-2,72890,-8,-0.01,71441,71441
743,حاريا,كشتيراني آريا,4,6261,177799878,28977,28398,28398,-579,-2,28972,-5,-0.02,28398,28398
744,پست0008پ09,پسته بادامي30-28مه ولات0008(پ),4,70,103974316,1433856,1460000,1480000,46144,3.22,1485347,51491,3.59,1460000,1505548
745,زعف0008پ08,زعفران0008نگين روستا(پ),4,3101,370727910,118140,118600,120000,1860,1.57,119551,1411,1.19,118600,120000
746,ضملت3000,اختيارخ وبملت-3000-1400/03/19,4,93,126050000,1691,1500,1150,-541,-31.99,1355,-336,-19.87,1150,1500
747,ضصاد3002,اختيارخ وبصادر-2500-1400/03/12,3,120,42800000,432,390,350,-82,-18.98,357,-75,-17.36,350,390
748,سلار,شركت سيمان لارستان,3,278,16025032,60045,57644,57644,-2401,-4,60043,-2,0,57644,57644
749,كقزوي,شيشه‌ قزوين‌,3,4472,44970432,10261,10056,10056,-205,-2,10261,0,0,10056,10056
750,خكار,ايركا پارت صنعت,3,949,20412990,21940,21510,21510,-430,-1.96,21940,0,0,21510,21510
751,ضجار2000,اختيارخ وتجارت-1800-1400/02/22,3,70,76700000,1012,1100,1050,38,3.75,1096,84,8.3,1050,1100
752,وآتوس,س.آرين توسكا قيمت اسمي 350ريال,3,17216,757176896,44878,43981,43981,-897,-2,44843,-35,-0.08,43981,43981
753,ضخود2010,اختيارخ خودرو-4500-1400/02/08,3,120,1210000,12,11,10,-2,-16.67,10,-2,-16.67,10,11
754,اخزا716,اسنادخزانه-م16بودجه97-000407,3,30,28604990,952220,953499,953500,1280,0.13,953500,1280,0.13,953499,953500
755,زعف0008پ16,زعفران0008نگين بيرجند(پ),3,54,6437102,120872,118401,119250,-1622,-1.34,119206,-1666,-1.38,118401,119250
756,وسالت,بانك قرض الحسنه رسالت,3,15138,17272458,1108,1141,1141,33,2.98,1108,0,0,1141,1141
757,ضپنا2003,اختيارخ رمپنا-16000-1400/02/12,3,25,84570000,3920,3700,3300,-620,-15.82,3383,-537,-13.7,3300,3700
758,تملي803,تسهيلات مسكن ب. ملي-خرداد98,3,24,18709680,820599,779570,779570,-41029,-5,779570,-41029,-5,779570,779570
759,داراب,پتروشيمي داراب,3,9000,21627000,2452,2403,2403,-49,-2,2452,0,0,2403,2403
760,رطب0002پ02,رطب مضافتي0002اتحاديه كرمان(پ),3,150,27475800,164505,183172,183172,18667,11.35,183172,18667,11.35,183172,183172
761,ولشرق,ليزينگ ايران و شرق,3,1821,15573192,8726,8552,8552,-174,-1.99,8726,0,0,8552,8552
762,قشهد,شهد,3,23895,479572650,20470,20070,20070,-400,-1.95,20470,0,0,20070,20070
763,ثاژن,سخت آژند,3,18000,173628000,9842,9646,9646,-196,-1.99,9838,-4,-0.04,9646,9646
764,آرمان,بيمه آرمان,3,3000,25059000,8523,8353,8353,-170,-1.99,8523,0,0,8353,8353
765,اخزا805,اسنادخزانه-م5بودجه98-000422,2,70,66220000,945351,946000,946000,649,0.07,946000,649,0.07,946000,946000
766,كچاد2,معدني‌وصنعتي‌چادرملو,2,3600000,84240000000,23870,23400,23400,-470,-1.97,23400,-470,-1.97,23400,23400
767,سهرمز,سيمان‌هرمزگان‌,2,807,19747290,24960,24470,24470,-490,-1.96,24960,0,0,24470,24470
768,ثجوان,تامين مسكن جوانان,2,5563,60870346,11165,10942,10942,-223,-2,11164,-1,-0.01,10942,10942
769,رطب0002پ01,رطب مضافتي0002افشارتعاون بم(پ),2,100,18317200,192812,183172,183172,-9640,-5,183172,-9640,-5,183172,183172
770,ضجار2001,اختيارخ وتجارت-2000-1400/02/22,2,100,85000000,1016,850,850,-166,-16.34,850,-166,-16.34,850,850
771,ضصاد3003,اختيارخ وبصادر-3000-1400/03/12,2,6,895000,180,150,149,-31,-17.22,149,-31,-17.22,149,150
772,تملي809,تسهيلات مسكن ب. ملي-آذر98,2,30,10694190,339499,356473,356473,16974,5,356473,16974,5,356473,356473
773,مفاخر,توسعه فناوري اطلاعات خوارزمي,2,1868,122243788,66776,65441,65441,-1335,-2,66773,-3,0,65441,65441
774,شرق1400,مشاركت ليزينگ ايران وشرق140010,2,10,10080000,1008000,1008000,1008000,0,0,1008000,0,0,1008000,1008000
775,نگين,ص.س. زمين و ساختمان نگين شهرري,2,400,19326000,48540,48320,48310,-230,-0.47,48310,-230,-0.47,48310,48320
776,تپولا,مهندسي مرآت پولاد,2,966,33519234,35407,34699,34699,-708,-2,35406,-1,0,34699,34699
777,وزمين,بانك ايران زمين,2,777,10465413,13743,13469,13469,-274,-1.99,13743,0,0,13469,13469
778,ولراز,ليزينگ رازي,2,188,10130004,56128,53883,53883,-2245,-4,56127,-1,0,53883,53883
779,ضپنا2007,اختيارخ رمپنا-28000-1400/02/12,2,20,770000,55,44,33,-22,-40,38,-17,-30.91,33,44
780,خاتم2,صندوق س خاتم ايساتيس پويا-ثابت,2,2000000,2000000,10770,1,1,-10769,-99.99,1,-10769,-99.99,1,1
781,كباده,توليد خاك نسوزاستقلال آباده,2,3600,32562000,8615,9045,9045,430,4.99,8616,1,0.01,9045,9045
782,فولاد2,فولاد مباركه اصفهان,2,5600000,75768000000,13800,13530,13530,-270,-1.96,13530,-270,-1.96,13530,13530
783,تملي707,تسهيلات مسكن ب. ملي-مهر97,2,45,29505195,624449,655671,655671,31222,5,655671,31222,5,655671,655671
784,طخود2005,اختيارف خودرو-2000-1400/02/08,2,13,558000,47,42,46,-1,-2.13,43,-4,-8.51,42,46
785,مهان01,اجاره مهرآيندگان لوتوس0311,2,100000,100000100000,1000000,1000001,1000001,1,0,1000001,1,0,1000001,1000001
786,ضفار3000,اختيارخ فارس-8000-1400/03/05,2,29,72260000,2192,2480,2500,308,14.05,2492,300,13.69,2480,2500
787,تشتاد,صنايع توليدي اشتاد ايران‌,2,1070,16476930,15713,15399,15399,-314,-2,15713,0,0,15399,15399
788,اميد2,تامين سرمايه اميد,1,94500000,742770000000,7860,7860,7860,0,0,7860,0,0,7860,7860
789,ضغدر3000,اختيارخ وغدير-6200-1400/03/26,1,1,5900000,5944,5900,5900,-44,-0.74,5900,-44,-0.74,5900,5900
790,كمند2,صندوق س. با درآمد ثابت كمند,1,30000000,30000000,10128,1,1,-10127,-99.99,1,-10127,-99.99,1,1
791,صايپا203,صكوك مرابحه سايپا203-3ماهه 16%,1,170,161874000,952222,952200,952200,-22,0,952200,-22,0,952200,952200
792,ضترا3005,اختيارخ شتران-12000-1400/03/09,1,1,550000,555,550,550,-5,-0.9,550,-5,-0.9,550,550
793,دقاضي,داروسازي شهيد قاضي,1,120,5158080,43861,42984,42984,-877,-2,43861,0,0,42984,42984
794,افران2,صندوق س افرا نماد پايدار-ثابت,1,2300000,2300000,12980,1,1,-12979,-99.99,1,-12979,-99.99,1,1
795,سايرا,ايرانيت‌,1,180,8116560,46012,45092,45092,-920,-2,46011,-1,0,45092,45092
796,لخانه,لوازم‌ خانگي‌ پارس‌,1,196,5661852,29476,28887,28887,-589,-2,29476,0,0,28887,28887
797,تملي703,تسهيلات مسكن ب. ملي-خرداد97,1,93,49504272,560320,532304,532304,-28016,-5,532304,-28016,-5,532304,532304
798,ضمخا7067,اختيارخ اخابر-14000-1400/07/28,1,2,2002000,1499,1001,1001,-498,-33.22,1001,-498,-33.22,1001,1001
799,تملي708,تسهيلات مسكن ب. ملي-آبان97,1,28,13619480,484610,486410,486410,1800,0.37,486410,1800,0.37,486410,486410
800,اراد434,مرابحه عام دولت4-ش.خ 0205,1,1568000,1479564800000,955460,943600,943600,-11860,-1.24,943600,-11860,-1.24,943600,943600
801,ضچاد2004,اختيارخ كچاد-20000-1400/02/05,1,1,3100000,4500,3100,3100,-1400,-31.11,3100,-1400,-31.11,3100,3100
802,تملي805,تسهيلات مسكن ب. ملي-مرداد98,1,7,5163725,776499,737675,737675,-38824,-5,737675,-38824,-5,737675,737675
803,ميدكو2,هلدينگ صنايع  معدني خاورميانه,1,1910000,59662670000,31237,31237,31237,0,0,31237,0,0,31237,31237
804,ضپنا2008,اختيارخ رمپنا-32000-1400/02/12,1,10,330000,1,33,33,32,3200,33,32,3200,33,33
805,زير0003پ04,زيره سبز0003شركت مينوبذر(پ),1,19,8436000,466559,444000,444000,-22559,-4.84,444000,-22559,-4.84,444000,444000
806,اراد404,مرابحه عام دولت4-ش.خ 0207,1,1047000,934918650000,1000000,892950,892950,-107050,-10.71,892950,-107050,-10.71,892950,892950
807,زير0003پ02,زيره سبز0003 دانش(پ),1,10,4430460,466129,443046,443046,-23083,-4.95,443046,-23083,-4.95,443046,443046
808,نبروج,نساجي بروجرد,1,2256,13378080,5814,5930,5930,116,2,5814,0,0,5930,5930
809,ضترا3000,اختيارخ شتران-6000-1400/03/09,1,1,4999000,5030,4999,4999,-31,-0.62,4999,-31,-0.62,4999,4999
810,امين يكم2,صندوق درآمد ثابت امين يكم فردا,1,100000,100000,10125,1,1,-10124,-99.99,1,-10124,-99.99,1,1
811,ضمخا2005,اختيارخ اخابر-18000-1400/02/29,1,10,550000,1,55,55,54,5400,55,54,5400,55,55
812,اخزا722,اسنادخزانه-م22بودجه97-000428,1,6,5646126,939753,941021,941021,1268,0.13,941021,1268,0.13,941021,941021
813,وحافظ,بيمه حافظ,1,80,5315600,67801,66445,66445,-1356,-2,67800,-1,0,66445,66445
814,اراد604,مرابحه عام دولتي6-ش.خ0210,1,3300000,3150708000000,945507,954760,954760,9253,0.98,954760,9253,0.98,954760,954760
815,اراد514,مرابحه عام دولت5-ش.خ 0010,1,308200,307583600000,1000000,998000,998000,-2000,-0.2,998000,-2000,-0.2,998000,998000
816,تملي710,تسهيلات مسكن ب. ملي-دي97,1,27,14698017,573022,544371,544371,-28651,-5,544371,-28651,-5,544371,544371
817,ضفلا3006,اختيارخ فولاد-11413-1400/03/19,1,1,555000,947,555,555,-392,-41.39,555,-392,-41.39,555,555
818,تملي612,تسهيلات مسكن بانك ملي-اسفند96,1,1,808071,808071,808071,808071,0,0,808071,0,0,808071,808071
819,اراد384,مرابحه عام دولت3-ش.خ 0105,1,10000,9546900000,1050000,954690,954690,-95310,-9.08,954690,-95310,-9.08,954690,954690
820,زير0003پ01,زيره سبز0003كيميابذر(پ),1,10,4896820,466559,489682,489682,23123,4.96,489682,23123,4.96,489682,489682
821,ضسپا3005,اختيارخ خساپا-3000-1400/03/26,1,100,17000000,186,170,170,-16,-8.6,170,-16,-8.6,170,170
822,ضپيك2010,اختيارخ تاپيكو-12000-00/02/19,1,20,32000000,1668,1600,1600,-68,-4.08,1600,-68,-4.08,1600,1600
823,اراد334,مرابحه عام دولت3-ش.خ 0303,1,1597000,1394021300000,856017,872900,872900,16883,1.97,872900,16883,1.97,872900,872900
824,ضفار3001,اختيارخ فارس-9000-1400/03/05,1,1,1700000,1700,1700,1700,0,0,1700,0,0,1700,1700
825,ضصاد3001,اختيارخ وبصادر-2000-1400/03/12,1,30,18000000,800,600,600,-200,-25,600,-200,-25,600,600
826,ضشنا2000,اختيارخ شپنا-9000-1400/02/27,1,5,24440000,4953,4888,4888,-65,-1.31,4888,-65,-1.31,4888,4888
827,اشاد10,مشاركت دولتي10-شرايط خاص001226,1,100,95900000,950000,959000,959000,9000,0.95,959000,9000,0.95,959000,959000
828,اراد35,مرابحه عام دولت3-ش.خ 0103,1,7000,6720000000,959836,960000,960000,164,0.02,960000,164,0.02,960000,960000
829,كصدف,كاشي صدف سرام استقلال آباده,1,500,12423500,25354,24847,24847,-507,-2,25354,0,0,24847,24847
830,ضخود2011,اختيارخ خودرو-5000-1400/02/08,1,10,100000,10,10,10,0,0,10,0,0,10,10
831,ثنظام,س. ساختماني نظام مهندسي ايران,1,1000,46759000,47713,46759,46759,-954,-2,47711,-2,0,46759,46759
832,ضسپا3000,اختيارخ خساپا-1400-1400/03/26,1,1,1090000,1143,1090,1090,-53,-4.64,1090,-53,-4.64,1090,1090
833,ضبدر3001,اختيارخ شبندر-16000-1400/03/30,1,3,42000000,14048,14000,14000,-48,-0.34,14000,-48,-0.34,14000,14000
834,اراد654,مرابحه عام دولتي65-ش.خ0210,1,3230277,3061666231431,928630,947803,947803,19173,2.06,947803,19173,2.06,947803,947803
835,اشاد14,مشاركت دولتي1-شرايط خاص001026,1,750100,738810995000,990000,984950,984950,-5050,-0.51,984950,-5050,-0.51,984950,984950
836,ضغدر3003,اختيارخ وغدير-9200-1400/03/26,1,5,16650000,3160,3330,3330,170,5.38,3330,170,5.38,3330,3330
837,ضمخا2004,اختيارخ اخابر-16000-1400/02/29,1,1,111000,1,111,111,110,11000,111,110,11000,111,111
838,ماديرا2,صنايع ماشين هاي اداري ايران,1,4000000,34688000000,8848,8672,8672,-176,-1.99,8672,-176,-1.99,8672,8672
839,تبريز112,مشاركت شهرداري تبريز-3ماهه18%,1,2,1870000,953687,935000,935000,-18687,-1.96,935000,-18687,-1.96,935000,935000
