,نماد,نام,تعداد,حجم,ارزش,دیروز,اولین,آخرین معامله - مقدار,آخرین معامله - تغییر,آخرین معامله - درصد,قیمت پایانی - مقدار,قیمت پایانی - تغییر,قیمت پایانی - درصد,کمترین,بیشترین
2,دارا يكم,صندوق واسطه گري مالي يكم-سهام,47854,48193710,6763937772840,135380,136300,142340,6960,5.14,140350,4970,3.67,135500,143780
3,پالايش,صندوق پالايشي يکم-سهام,45196,55845194,4119050550890,72700,73300,74000,1300,1.79,73760,1060,1.46,72000,75490
4,خساپا,سايپا,24389,925184942,1839147123290,1940,1950,2030,90,4.64,1990,50,2.58,1900,2040
5,خودرو,ايران‌ خودرو,20859,807459265,1708357752330,2060,2060,2160,100,4.85,2120,60,2.91,2020,2180
6,فملي,ملي‌ صنايع‌ مس‌ ايران‌,17297,98350081,1200387842090,12040,12240,12130,90,0.75,12210,170,1.41,11830,12530
7,امينح,ح . تامين سرمايه امين,17254,23328221,118011403540,4640,4700,5190,550,11.85,5060,420,9.05,4690,5190
8,شپنا,پالايش نفت اصفهان,17193,128765004,1396461566680,11000,11000,10850,-150,-1.36,10850,-150,-1.36,10670,11390
9,بركت,گروه دارويي بركت,17163,38089844,1227827294000,32800,33000,31820,-980,-2.99,32240,-560,-1.71,31820,33270
10,خگستر,گسترش‌سرمايه‌گذاري‌ايران‌خودرو,16607,440860483,1085712869070,2480,2430,2520,40,1.61,2460,-20,-0.81,2410,2550
11,وبملت,بانك ملت,15192,539813093,2422315869670,4250,4360,4500,250,5.88,4490,240,5.65,4330,4500
12,وتجارت,بانك تجارت,15011,526356037,1411155991450,2550,2590,2700,150,5.88,2680,130,5.1,2580,2700
13,شستا,سرمايه گذاري تامين اجتماعي,12552,45301053,526781331120,11630,11650,11530,-100,-0.86,11630,0,0,11350,11950
14,شتران,پالايش نفت تهران,10281,75339993,651954284690,8800,8740,8640,-160,-1.82,8650,-150,-1.7,8540,8960
15,فولاد,فولاد مباركه اصفهان,9133,56904744,726552365030,12660,12670,12660,0,0,12770,110,0.87,12450,13200
16,امين,تامين سرمايه امين,8406,6395935,45057811850,7110,7010,7090,-20,-0.28,7050,-60,-0.84,6990,7350
17,وبصادر,بانك صادرات ايران,8167,297994964,696932500920,2220,2250,2350,130,5.86,2340,120,5.41,2250,2350
18,خبهمن,گروه‌بهمن‌,7217,501229329,716082245680,1350,1390,1430,80,5.93,1430,80,5.93,1380,1430
19,ضخود2005,اختيارخ خودرو-2000-1400/02/08,6904,376380,6838080000,21,9,31,10,47.62,18,-3,-14.29,2,35
20,كرمان,س. توسعه و عمران استان كرمان,6250,233444563,287382014100,1176,1192,1246,70,5.95,1231,55,4.68,1150,1246
21,بوعلي,پتروشيمي بوعلي سينا,6182,2901041,124477260410,42090,41900,42950,860,2.04,42910,820,1.95,41900,43560
22,وكبهمن,مديريت سرمايه گذاري كوثربهمن,5898,2788062,29920681712,10414,10728,10900,486,4.67,10598,184,1.77,10451,10985
23,ذوب,سهامي ذوب آهن  اصفهان,5748,82929267,281037939126,3370,3359,3395,25,0.74,3389,19,0.56,3330,3463
24,ساراب,سيمان‌ داراب‌,5457,23379154,473348127160,20390,19780,19780,-610,-2.99,20250,-140,-0.69,19780,21350
25,شبندر,پالايش نفت بندرعباس,5382,19225180,419242310960,22190,22000,21750,-440,-1.98,21810,-380,-1.71,21530,22640
26,شگويا,پتروشيمي تندگويان,5351,25503805,226340016986,8893,8893,8779,-114,-1.28,8875,-18,-0.2,8662,9197
27,پترول,گروه پتروشيمي س. ايرانيان,5304,29994203,260431353680,8620,8740,8660,40,0.46,8680,60,0.7,8550,8910
28,آريا,پليمر آريا ساسول,4445,1802920,159053960437,87176,88850,87700,524,0.6,88220,1044,1.2,87000,88850
29,حكشتي,كشتيراني جمهوري اسلامي ايران,4262,22939323,398070753360,17840,17310,17310,-530,-2.97,17350,-490,-2.75,17310,17630
30,ماديرا,صنايع ماشين هاي اداري ايران,4241,29242168,230949393882,8102,7859,7880,-222,-2.74,7898,-204,-2.52,7859,8199
31,بپيوند,برق و انرژي پيوندگستر پارس,4073,3787307,45080638672,12111,11900,11940,-171,-1.41,11912,-199,-1.64,11748,12230
32,اپال,فرآوري معدني اپال كاني پارس,3839,4343188,74168809420,17060,17050,17060,0,0,17070,10,0.06,17000,17290
33,وخارزم,سرمايه گذاري خوارزمي,3726,36001464,174457267080,4960,4820,4870,-90,-1.81,4850,-110,-2.22,4820,4960
34,امين يكم,صندوق درآمد ثابت امين يكم فردا,3620,111600279,1125484722824,10075,10082,10087,12,0.12,10085,10,0.1,10078,10090
35,سيتا,سرمايه گذاري سيمان تامين,3573,4827283,72417905230,15010,15000,15000,-10,-0.07,15000,-10,-0.07,15000,15040
36,كيان,صندوق س. با درآمد ثابت كيان,3443,34227879,964917786050,28161,28191,28193,32,0.11,28191,30,0.11,28190,28195
37,وپارس,بانك‌پارسيان‌,3354,96862236,241727463550,2440,2440,2500,60,2.46,2500,60,2.46,2410,2540
38,وپاسار,بانك  پاسارگاد,3241,35666825,505618915910,13700,13770,14390,690,5.04,14180,480,3.5,13770,14400
39,وخارزمح,ح.سرمايه گذاري خوارزمي,3229,12791131,42506338130,3320,3350,3330,10,0.3,3320,0,0,3220,3450
40,ونوين,بانك‌اقتصادنوين‌,3103,65144758,288937150130,4230,4290,4480,250,5.91,4440,210,4.96,4230,4480
41,پيزد,مجتمع صنايع لاستيك يزد,3037,485149,30080929446,63504,63000,64000,496,0.78,62555,-949,-1.49,61599,64700
42,كمند,صندوق س. با درآمد ثابت كمند,2957,113449657,1149559468134,10127,10132,10133,6,0.06,10133,6,0.06,10132,10136
43,تملت,تامين سرمايه بانك ملت,2922,18712724,92062658820,4730,4730,4910,180,3.81,4920,190,4.02,4620,5010
44,غگل,گلوكوزان‌,2773,28289415,86063785240,3000,3080,3030,30,1,3040,40,1.33,2990,3110
45,بگيلان,توسعه مسير برق گيلان,2690,434340,8712659016,20480,20000,20110,-370,-1.81,20403,-77,-0.38,19901,20480
46,فباهنرح,ح . مس‌ شهيدباهنر,2643,8455093,152481905640,17520,17970,18170,650,3.71,18030,510,2.91,17230,18600
47,فخوز,فولاد  خوزستان,2642,13936323,213594338800,15240,15240,15320,80,0.52,15330,90,0.59,15100,15760
48,فارس,صنايع پتروشيمي خليج فارس,2601,12882692,115761264520,8850,8940,8950,100,1.13,8980,130,1.47,8800,9200
49,كارين2,صندوق س نگين سامان-ثابت,2490,24900000,24900000,10039,1,1,-10038,-99.99,1,-10038,-99.99,1,1
50,آوا,صندوق س.سهام آواي معيار-س,2357,15431836,100763497594,6498,6460,6549,51,0.78,6530,32,0.49,6403,6657
51,غسالم,سالمين‌,2296,20572523,84511463300,4210,4090,4120,-90,-2.14,4110,-100,-2.38,4090,4280
52,وساپا,سرمايه‌گذاري‌ سايپا,2262,25897345,120151707860,4560,4600,4720,160,3.51,4640,80,1.75,4480,4750
53,وغدير,سرمايه‌گذاري‌غدير(هلدينگ‌,2231,10950834,112590486080,10200,10200,10250,50,0.49,10280,80,0.78,10140,10630
54,صبا,سرمايه گذاري صبا تامين,2221,10344489,79773087888,7456,7450,7680,224,3,7622,166,2.23,7450,7820
55,گشان,توسعه بين المللي پديده شانديز,2214,7968654,192676287599,25151,24145,24145,-1006,-4,24179,-972,-3.86,24145,24648
56,آسيا,بيمه آسيا,2204,44899180,89229642890,2040,1980,2000,-40,-1.96,1990,-50,-2.45,1980,2020
57,شبريز,پالايش نفت تبريز,2178,6115757,161212359320,27020,26410,26400,-620,-2.29,26360,-660,-2.44,26210,27390
58,نوري,پتروشيمي نوري,2154,1946989,116391340010,60130,59200,59500,-630,-1.05,59780,-350,-0.58,59010,60440
59,ومهان,گروه توسعه مالي مهر آيندگان,2094,16134160,208245939010,12307,12470,13045,738,6,12907,600,4.88,12200,13045
60,سمازن,سيمان‌مازندران‌,1974,10138521,126689532130,12760,12380,12620,-140,-1.1,12500,-260,-2.04,12380,12980
61,فاسمين,كالسيمين‌,1896,9870001,147038152440,15220,15240,14940,-280,-1.84,14900,-320,-2.1,14770,15600
62,آگاس,صندوق س.هستي بخش آگاه-س,1863,3291702,216729190523,65034,64500,65900,866,1.33,65841,807,1.24,64500,66660
63,فباهنر,مس‌ شهيدباهنر,1794,3216505,81998581260,25720,26000,25100,-620,-2.41,25490,-230,-0.89,24960,26480
64,فنوال,نورد آلومينيوم‌,1726,2356876,67535109090,28240,28980,28310,70,0.25,28650,410,1.45,27780,29480
65,حفاري,حفاري شمال,1722,12197653,81744440690,6730,6600,6780,50,0.74,6700,-30,-0.45,6540,6890
66,سرو,صندوق س سروسودمند مدبران-سهام,1671,1881437,122117406630,64610,64900,65040,430,0.67,64910,300,0.46,63700,65850
67,ومعادن,توسعه‌معادن‌وفلزات‌,1652,11403309,87574396520,7660,7660,7750,90,1.17,7680,20,0.26,7500,7820
68,بجهرم,توسعه مولد نيروگاهي جهرم,1609,15082359,36739210912,2430,2410,2451,21,0.86,2435,5,0.21,2391,2473
69,تسه0001,امتيازتسهيلات مسكن فروردين1400,1605,36524,19086185236,539747,529000,512760,-26987,-5,522566,-17181,-3.18,512760,539955
70,ضسپا3003,اختيارخ خساپا-2000-1400/03/26,1597,81574,8893821000,101,110,112,11,10.89,109,8,7.92,95,121
71,آبادا,توليد نيروي برق آبادان,1557,734051,9043252300,12690,12320,12310,-380,-2.99,12620,-70,-0.55,12310,12400
72,شپلي,پلي اكريل ايران,1526,29068256,234377786096,8183,8020,8300,117,1.43,8063,-120,-1.47,8020,8300
73,وسينا,بانك سينا,1521,36338701,105616624240,2810,2840,2920,110,3.91,2910,100,3.56,2750,2970
74,كاوه,فولاد كاوه جنوب كيش,1512,7351765,159797173420,21990,21760,21510,-480,-2.18,21740,-250,-1.14,21440,22510
75,وكار,بانك‌ كارآفرين‌,1510,52633523,160435555990,2970,3050,3040,70,2.36,3050,80,2.69,2970,3120
76,شبهرن,نفت‌ بهران‌,1492,7251257,86401968440,11900,11580,11900,0,0,11920,20,0.17,11580,12210
77,زگلدشتح,ح.كشت و دام گلدشت نمونه اصفهان,1491,6941541,49044415184,6851,6750,7160,309,4.51,7065,214,3.12,6750,7216
78,فايرا,آلومينيوم‌ايران‌,1460,4286010,80648139340,18070,18880,18490,420,2.32,18820,750,4.15,18200,19150
79,شاراك,پتروشيمي شازند,1422,4277972,113574512850,25610,25860,26500,890,3.48,26550,940,3.67,25810,27130
80,اعتماد,صندوق س.اعتماد آفرين پارسيان-د,1405,23273590,840823950060,36106,36126,36133,27,0.07,36128,22,0.06,36125,36157
81,سفارس,سيمان فارس و خوزستان,1392,5314621,84913737380,16150,15900,16000,-150,-0.93,15980,-170,-1.05,15680,16450
82,فجر,فولاد اميركبيركاشان,1386,1883113,111595673200,60250,60550,59300,-950,-1.58,59260,-990,-1.64,58450,61700
83,دماوند,توليد نيروي برق دماوند,1371,2052651,51779399713,24884,24995,25488,604,2.43,25202,318,1.28,24250,25700
84,رمپنا,گروه مپنا (سهامي عام),1306,8481088,136103740160,16510,16020,16020,-490,-2.97,16050,-460,-2.79,16020,16470
85,ورازي,بيمه رازي,1284,9179124,79685102043,8987,8890,8560,-427,-4.75,8681,-306,-3.4,8538,9122
86,شيران,س. صنايع‌شيميايي‌ايران,1274,2946185,65470438200,22400,22190,22080,-320,-1.43,22260,-140,-0.63,21820,22750
87,كچاد,معدني‌وصنعتي‌چادرملو,1226,4667819,102358313560,21640,21650,21820,180,0.83,21890,250,1.16,21420,22300
88,هرمز,فولاد هرمزگان جنوب,1207,6023115,94158984186,15511,15680,15650,139,0.9,15601,90,0.58,15201,16031
89,تاپيكو,س. نفت و گاز و پتروشيمي تأمين,1171,6503433,71053159130,10880,10750,10920,40,0.37,10910,30,0.28,10700,11130
90,ضخود2014,اختيارخ خودرو-1800-1400/02/08,1152,62328,11215079000,138,145,230,92,66.67,180,42,30.43,145,236
91,البرز,بيمه البرز,1150,17403705,62189447570,3540,3500,3600,60,1.69,3570,30,0.85,3470,3710
92,غگيلا,شيرپاستوريزه پگاه گيلان,1130,16220,399109320,23214,24606,24606,1392,6,23224,10,0.04,24606,24606
93,وپست,پست بانك ايران,1130,11432296,240018066270,21620,20980,20980,-640,-2.96,20990,-630,-2.91,20980,21300
94,وهور,مديريت انرژي اميد  تابان هور,1121,29004301,60349152648,2139,2075,2080,-59,-2.76,2081,-58,-2.71,2075,2138
95,تاصيكو,سرمايه گذاري صدرتامين,1115,5225397,55350945450,10500,10670,10440,-60,-0.57,10540,40,0.38,10300,10890
96,خصدرا,صنعتي‌ دريايي‌ ايران‌,1090,17922154,48378313618,2753,2698,2698,-55,-2,2699,-54,-1.96,2698,2740
97,ونيكي,سرمايه‌گذاري‌ ملي‌ايران‌,1087,5247230,44409440780,8590,8390,8530,-60,-0.7,8500,-90,-1.05,8340,8770
98,كگلح,ح . معدني و صنعتي گل گهر,1077,4549917,49942762050,11050,11050,11060,10,0.09,10980,-70,-0.63,10570,11290
99,مدير,ص.س.مديريت ثروت ص.بازنشستگي-س,1039,4563099,37295786915,8142,8045,8190,48,0.59,8173,31,0.38,8045,8300
100,تسه9912,امتياز تسهيلات مسكن اسفند99,1017,21696,11553108986,547297,540000,525000,-22297,-4.07,532499,-14798,-2.7,519933,573000
101,وصنعت,سرمايه گذاري توسعه صنعت وتجارت,973,7368325,43980115110,5830,5820,6070,240,4.12,5950,120,2.06,5790,6120
102,كگل,معدني و صنعتي گل گهر,954,7051626,98903533350,13980,14200,14150,170,1.22,14020,40,0.29,13600,14390
103,قرن,پديده شيمي قرن,924,622128,38625972480,62960,63300,61700,-1260,-2,62290,-670,-1.06,61080,63400
104,شغدير,پتروشيمي غدير,905,1025239,65887085500,61510,64180,64620,3110,5.06,64270,2760,4.49,62080,65200
105,سامان,بانك سامان,876,8075653,70827603095,8706,8599,8790,84,0.96,8771,65,0.75,8560,8924
106,شپديس,پتروشيمي پرديس,840,1023756,99825641610,97040,98000,97500,460,0.47,97500,460,0.47,96070,98890
107,خكرمان,گروه اقتصادي كرمان خودرو,838,8659517,31326313543,3581,3615,3665,84,2.35,3618,37,1.03,3515,3687
108,كنور,توسعه معدني و صنعتي صبانور,830,2297439,111685543360,45950,46290,48700,2750,5.98,48610,2660,5.79,46290,48700
109,پاكشو,گروه صنعتي پاكشو,828,6634434,42770050820,6480,6330,6430,-50,-0.77,6470,-10,-0.15,6300,6640
110,شلرد,كود شيميايي اوره لردگان,788,7632433,49643189967,6478,6480,6545,67,1.03,6504,26,0.4,6440,6596
111,زاگرس,پتروشيمي زاگرس,767,233240,47919765182,203659,207490,204579,920,0.45,204509,850,0.42,201061,209000
112,سشرق,سيمان‌ شرق‌,755,6073824,38631409970,6540,6350,6350,-190,-2.91,6400,-140,-2.14,6350,6500
113,ارزش,صندوق س ارزش آفرين بيدار-سهام,736,4067559,38002658330,9340,9280,9330,-10,-0.11,9340,0,0,9230,9490
114,شرانل,نفت ايرانول,727,1947122,78153070684,39470,40400,40600,1130,2.86,40138,668,1.69,39890,40800
115,گكوثر,هتل پارسيان كوثر اصفهان,703,7931208,17970465538,2324,2259,2255,-69,-2.97,2302,-22,-0.95,2255,2338
116,ضسپا3002,اختيارخ خساپا-1800-1400/03/26,693,39671,8490958000,192,200,230,38,19.79,214,22,11.46,184,247
117,افق,فروشگاههاي زنجيره اي افق كوروش,677,1094612,77711201360,71240,69400,71360,120,0.17,71020,-220,-0.31,69400,71990
118,همراه,شركت ارتباطات سيار ايران,666,2149005,51782442440,24540,24490,24090,-450,-1.83,24300,-240,-0.98,23810,24720
119,فروي,ذوب روي اصفهان,651,849234,49318415316,59870,58074,58074,-1796,-3,58074,-1796,-3,58074,58074
120,سفانو,سيمان فارس نو,639,980660,36711889400,38460,37310,37310,-1150,-2.99,37640,-820,-2.13,37310,38450
121,كاما,باما,636,2869968,34353516960,12340,11970,11970,-370,-3,12070,-270,-2.19,11970,11970
122,وبانك,سرمايه گذاري گروه توسعه ملي,629,6074981,47855277600,7940,7760,7850,-90,-1.13,7910,-30,-0.38,7760,8090
123,ما,بيمه  ما,626,6633701,49464818420,7180,7180,7420,240,3.34,7450,270,3.76,6970,7610
124,شسپا,نفت سپاهان,621,2001426,30045265290,14750,14760,15020,270,1.83,14890,140,0.95,14760,15150
125,ثمسكن,سرمايه‌گذاري‌ مسكن‌,606,7742515,38138920260,5060,4910,4910,-150,-2.96,4950,-110,-2.17,4910,5070
126,اخابر,مخابرات ايران,601,18156662,177753720980,10090,9790,9790,-300,-2.97,9790,-300,-2.97,9790,9790
127,شصدف,صنعتي دوده فام,586,25089,816797484,30714,32556,32556,1842,6,30742,28,0.09,32556,32556
128,فنورد,نوردوقطعات‌ فولادي‌,586,203160,32069398780,160170,160000,158990,-1180,-0.74,158540,-1630,-1.02,155610,161100
129,سرچشمه,سرمايه گذاري مس سرچشمه,580,4573705,28950206965,6340,6390,6298,-42,-0.66,6334,-6,-0.09,6250,6470
130,وخاور,بانك خاورميانه,578,3870371,33397485550,8260,8450,8670,410,4.96,8500,240,2.91,8270,8750
131,وسكاب,س.ص.بازنشستگي كاركنان بانكها,578,4068092,20083949020,4870,4910,5000,130,2.67,4900,30,0.62,4830,5060
132,كروي,توسعه‌ معادن‌ روي‌ ايران‌,575,1266521,33026826920,26810,26080,26010,-800,-2.98,26290,-520,-1.94,26010,26730
133,وساخت,سرمايه‌ گذاري‌ ساختمان‌ايران‌,571,507223,22637077090,43610,43820,44420,810,1.86,44070,460,1.05,43820,46000
134,خريخت,صنايع‌ريخته‌گري‌ايران‌,566,5654787,16638252300,2990,2950,2960,-30,-1,2970,-20,-0.67,2910,3040
135,حتايد,تايدواترخاورميانه,543,1581533,40817217510,25750,25150,25830,80,0.31,25800,50,0.19,25150,26500
136,كرازي,كارخانجات‌توليدي‌شيشه‌رازي‌,533,1689155,37905306710,23120,22430,22430,-690,-2.98,22580,-540,-2.34,22430,22600
137,فسپا,گروه‌صنعتي‌سپاهان‌,524,1199695,44565765630,37480,38400,37140,-340,-0.91,37180,-300,-0.8,36590,38400
138,والبر,سرمايه‌ گذاري‌ البرز(هلدينگ‌,523,2088042,34198570100,16870,16370,16370,-500,-2.96,16510,-360,-2.13,16370,16800
139,بموتو,موتوژن‌,519,465933,24755224860,54370,54200,53150,-1220,-2.24,53720,-650,-1.2,52740,56000
140,خديزل,بهمن  ديزل,519,2076553,79025299572,39030,37860,39390,360,0.92,38056,-974,-2.5,37860,39899
141,ارفع,شركت آهن و فولاد ارفع,515,1814153,26422265330,14766,14390,14431,-335,-2.27,14690,-76,-0.51,14390,14900
142,سپاها,سيمان‌سپاهان‌,509,3766703,31005566220,8200,8120,8200,0,0,8220,20,0.24,8000,8370
143,كگهر,سنگ آهن گهرزمين,489,859981,37812451823,44530,44500,44335,-195,-0.44,44344,-186,-0.42,43195,45800
144,سمتاز,سيمان ممتازان كرمان,489,776035,18002390682,22640,23300,23319,679,3,23118,478,2.11,22200,23319
145,بپاس,بيمه پاسارگاد,489,765271,67512641626,88137,88138,88480,343,0.39,88193,56,0.06,88135,88500
146,دعبيد,لابراتوارداروسازي‌  دكترعبيدي‌,488,722346,16735028050,22760,22260,23750,990,4.35,22890,130,0.57,22260,23900
147,آكورد,صندوق س. آرمان آتي كوثر-د,485,12867612,409219387735,31784,31800,31803,19,0.06,31802,18,0.06,31790,31815
148,شتولي,تولي‌پرس‌,484,1507492,48913445744,32491,31842,33140,649,2,32447,-44,-0.14,31842,33140
149,ميدكو,هلدينگ صنايع  معدني خاورميانه,477,4503045,147561561681,32595,32898,32930,335,1.03,32769,174,0.53,32595,32956
150,جم پيلن,پلي پروپيلن جم - جم پيلن,458,651288,51785154950,79290,77500,78850,-440,-0.55,79470,180,0.23,77500,81300
151,وثنو,سرمايه گذاري ساختماني نوين,451,2313909,11780710247,4987,4960,5105,118,2.37,5054,67,1.34,4960,5150
152,حسينا,توسعه خدمات دريايي وبندري سينا,451,352783,21912917630,62332,62360,61615,-717,-1.15,62231,-101,-0.16,61051,64840
153,وتوس,توسعه‌شهري‌توس‌گستر,448,4732156,63364903140,13800,13390,13390,-410,-2.97,13390,-410,-2.97,13390,13540
154,قشرين,قند شيرين خراسان,433,3214871,42540204704,13501,13231,13231,-270,-2,13232,-269,-1.99,13231,13429
155,پارند,صندوق س. پارند پايدار سپهر,426,10964784,124236186590,11326,11338,11340,14,0.12,11330,4,0.04,11327,11340
156,شيراز,پتروشيمي‌شيراز,425,1056377,55662679040,54190,55760,52570,-1620,-2.99,53320,-870,-1.61,52570,55760
157,تنوين,تامين سرمايه نوين,425,2552917,18404495110,7050,7100,7320,270,3.83,7110,60,0.85,7100,7320
158,پارسان,گسترش نفت و گاز پارسيان,413,1727071,32322034360,18990,19530,18850,-140,-0.74,18910,-80,-0.42,18530,19530
159,پارسيان,بيمه پارسيان,411,2835589,27528240580,9920,9630,9860,-60,-0.6,9800,-120,-1.21,9630,10040
160,تسه9908,امتياز تسهيلات مسكن آبان99,405,10371,5503669395,541655,525122,545000,3345,0.62,530679,-10976,-2.03,514573,545000
161,واحيا,م .صنايع و معادن احياء سپاهان,402,482671,64325312572,130771,130030,133000,2229,1.7,133269,2498,1.91,130030,134694
162,سيدكو,سرمايه گذاري توسعه صنايع سيمان,399,2288368,13382346030,5950,5800,5790,-160,-2.69,5920,-30,-0.5,5780,6020
163,تيپيكو,سرمايه گذاري دارويي تامين,390,785036,29055045220,36940,38200,36930,-10,-0.03,36970,30,0.08,36440,38480
164,شفن,پتروشيمي فناوران,390,96793,30920844720,318420,320000,317420,-1000,-0.31,318740,320,0.1,316700,322500
165,وتوسم,سرمايه‌گذاري‌توسعه‌ملي‌,385,3446900,27512801710,8220,7980,7980,-240,-2.92,8080,-140,-1.7,7980,8160
166,خزاميا,زامياد,374,6949887,62340486390,9240,8970,8970,-270,-2.92,8970,-270,-2.92,8970,8970
167,وسپه,سرمايه‌گذاري‌ سپه‌,373,2676271,17261647420,6520,6400,6400,-120,-1.84,6500,-20,-0.31,6390,6590
168,امين يكم2,صندوق درآمد ثابت امين يكم فردا,370,37000000,37000000,10075,1,1,-10074,-99.99,1,-10074,-99.99,1,1
169,آريان,سرمايه گذاري پارس آريان,369,2607369,25834999179,9858,9720,9990,132,1.34,9875,17,0.17,9720,10090
170,فسازان,غلتك سازان سپاهان,362,562547,18777922390,33400,33500,33160,-240,-0.72,33390,-10,-0.03,32500,34500
171,شبصير,توليدات پتروشيمي قائد بصير,362,326553,22697572261,67112,69590,68000,888,1.32,68173,1061,1.58,67170,71138
172,سبزوا,سيمان لار سبزوار,361,7455333,24490768905,3386,3285,3285,-101,-2.98,3334,-52,-1.54,3285,3285
173,زشريف,كشت وصنعت شريف آباد,357,2132138,10914023180,5252,5260,5095,-157,-2.99,5222,-30,-0.57,5095,5330
174,ضسپا3004,اختيارخ خساپا-2500-1400/03/26,353,18660,762465000,39,44,47,8,20.51,41,2,5.13,34,54
175,شكف,كف,352,269064,27629791766,103159,101096,105222,2063,2,102689,-470,-0.46,101096,105222
176,كرماشا,صنايع پتروشيمي كرمانشاه,352,958859,33174260640,35190,35320,34430,-760,-2.16,34790,-400,-1.14,34300,35950
177,سپ,پرداخت الكترونيك سامان كيش,346,1669469,34886629020,20710,20190,20700,-10,-0.05,20840,130,0.63,20190,21560
178,تسه9911,امتياز تسهيلات مسكن بهمن99,344,4435,2363585869,540950,522000,520000,-20950,-3.87,532939,-8011,-1.48,513903,544700
179,خودكفا,اقتصادي و خودكفايي آزادگان,341,1466062,26282093474,18673,17927,17927,-746,-4,18163,-510,-2.73,17927,17927
180,طلا,صندوق س.پشتوانه طلاي لوتوس,332,794208,56353941908,70816,70700,70969,153,0.22,70956,140,0.2,70402,71250
181,ونفت,سرمايه‌گذاري‌ صنعت‌ نفت‌,329,940406,13555503050,14450,14650,14200,-250,-1.73,14440,-10,-0.07,14100,14800
182,سباقر,سيمان باقران,325,688659,11018648470,15925,15610,15852,-73,-0.46,15968,43,0.27,15607,16402
183,تسه9802,امتياز تسهيلات مسكن ارديبهشت98,319,5232,2240318439,430469,445000,425999,-4470,-1.04,428195,-2274,-0.53,408946,451877
184,غگلپا,شير پاستوريزه پگاه گلپايگان,316,175933,11350641566,66315,64356,64326,-1989,-3,65871,-444,-0.67,64326,66760
185,شساخت,مهندسي و ساختمان صنايع نفت,313,788780,30570620159,39053,38300,38600,-453,-1.16,38821,-232,-0.59,38300,39860
186,جم,پتروشيمي جم,311,842977,30606844400,35500,35830,36500,1000,2.82,35740,240,0.68,35830,36600
187,كاريس,صندوق س.سپهر كاريزما-س,310,2121878,22509964959,10563,10640,10648,85,0.8,10609,46,0.44,10555,10760
188,كاردان,صندوق س تجارت شاخصي كاردان,310,93305,14147463950,151330,152290,151020,-310,-0.2,151630,300,0.2,149400,154770
189,گوهران,سرمايه گذاري توسعه گوهران اميد,308,830806,5814448122,7005,6993,7020,15,0.21,7004,-1,-0.01,6842,7140
190,فخاس,فولاد خراسان,307,747051,19333192190,26670,25870,25870,-800,-3,26510,-160,-0.6,25870,26660
191,تصميم,صندوق س با درآمد ثابت تصميم,305,1692933,27474277174,16218,16227,16227,9,0.06,16229,11,0.07,16226,16248
192,ياقوت,صندوق س ياقوت آگاه-ثابت,295,1908990,23504460428,12308,12311,12322,14,0.11,12313,5,0.04,12310,12330
193,ثباغ,شهر سازي و خانه سازي باغميشه,290,760893,11670488331,15799,15326,15330,-469,-2.97,15686,-113,-0.72,15326,15700
194,وبشهر,توسعه‌ صنايع‌ بهشهر(هلدينگ,283,1827004,19436474480,10940,10620,10620,-320,-2.93,10820,-120,-1.1,10620,10970
195,معيار,سرمايه گذاري معيار صنعت پارس,275,437580,25526574834,56708,57900,58409,1701,3,58336,1628,2.87,57300,58409
196,سكرما,سيمان‌ كرمان‌,273,480815,7513197400,15930,15470,15920,-10,-0.06,15880,-50,-0.31,15460,16450
197,بساما,بيمه سامان,270,1636377,36584565453,23048,22357,22358,-690,-2.99,22527,-521,-2.26,22357,22359
198,مبين,مبين انرژي خليج فارس,264,1134094,17871738580,15660,15240,15740,80,0.51,15670,10,0.06,15240,16100
199,دالبرح,ح . البرزدارو,258,658368,6611400670,10000,9850,10000,0,0,10040,40,0.4,9850,10190
200,سپيدما,صندوق س. سپيد دماوند-د,255,12651387,129385788415,10221,10230,10230,9,0.09,10227,6,0.06,10226,10231
201,وصندوق,سرمايه‌گذاري‌صندوق‌بازنشستگي‌,254,1498625,21726370810,14480,14500,14610,130,0.9,14480,0,0,14160,14900
202,بترانس,ايران‌ ترانسفو,254,3992855,11140065450,2870,2790,2790,-80,-2.79,2850,-20,-0.7,2790,2790
203,سخوز,سيمان خوزستان,246,382788,8268448680,21940,21920,21570,-370,-1.69,21880,-60,-0.27,21410,22270
204,دسبحانح,ح. سبحان دارو,246,412589,6466950330,18550,16290,15320,-3230,-17.41,15670,-2880,-15.53,15320,16290
205,سكه0012پ01,سكه تمام بهارتحويلي 1روزه رفاه,244,91400,90023683200,985396,981000,983400,-1996,-0.2,984942,-454,-0.05,980200,989780
206,شكبير,پتروشيمي اميركبير,240,669362,57537253662,87694,85941,85941,-1753,-2,86662,-1032,-1.18,85941,88000
207,تسه9803,امتياز تسهيلات مسكن خرداد98,236,2954,1530482094,523567,500102,510500,-13067,-2.5,518105,-5462,-1.04,500102,530000
208,تايرا,تراكتورسازي‌ايران‌,236,583680,15699898240,27470,26650,26650,-820,-2.99,27280,-190,-0.69,26650,27820
209,تسه9910,امتياز تسهيلات مسكن دي99,233,2661,1415741659,540965,531100,516013,-24952,-4.61,532034,-8931,-1.65,515000,550000
210,شصفها,پتروشيمي‌ اصفهان‌,227,225768,28458319044,123735,126209,126209,2474,2,126051,2316,1.87,123118,126209
211,افران,صندوق س افرا نماد پايدار-ثابت,225,4019248,52999677413,13179,13186,13191,12,0.09,13186,7,0.05,13185,13191
212,فيروزه,صندوق شاخص30 شركت فيروزه- سهام,225,135559,17935541300,131690,132500,132510,820,0.62,132310,620,0.47,130550,133970
213,تسه9909,امتياز تسهيلات مسكن آذر99,224,2743,1456383838,542304,522500,520000,-22304,-4.11,530946,-11358,-2.09,516220,569419
214,بخاور,بيمه زندگي خاورميانه,220,2033676,13571473641,6823,6820,6619,-204,-2.99,6781,-42,-0.62,6619,6820
215,بمپنا,توليد برق عسلويه  مپنا,215,162130,11144483141,70844,68719,68719,-2125,-3,70357,-487,-0.69,68719,70850
216,آساس,صندوق س.آسمان آرماني سهام-س,211,59095,9935454433,166496,167050,168500,2004,1.2,168127,1631,0.98,166000,169830
217,وحكمت,بيمه حكمت صبا,210,1385871,4867496145,3542,3484,3517,-25,-0.71,3534,-8,-0.23,3477,3580
218,شنفت,نفت‌ پارس‌,204,174454,8134470250,47870,48220,46800,-1070,-2.24,47660,-210,-0.44,46440,48220
219,شاوان,پالايش نفت لاوان,196,154272,12694210375,84691,82151,82151,-2540,-3,84043,-648,-0.77,82151,83970
220,اطلس,صندوق س.توسعه اندوخته آينده-س,194,44311,9079275004,203421,206000,205299,1878,0.92,204899,1478,0.73,203500,207001
221,وسپهر,سرمايه گذاري مالي سپهرصادرات,191,740738,7488120442,10421,10109,10109,-312,-2.99,10401,-20,-0.19,10109,10109
222,تسه9810,امتياز تسهيلات مسكن دي98,190,4269,2259171122,540436,518000,517500,-22936,-4.24,529204,-11232,-2.08,513415,539999
223,نهال,صندوق س. طلاي سرخ نوويرا,183,412796,3941088158,9814,9625,9521,-293,-2.99,9547,-267,-2.72,9450,9736
224,كزغال,زغال سنگ پروده طبس,183,1866982,59741557018,32988,31999,31999,-989,-3,31999,-989,-3,31999,31999
225,ضجار2003,اختيارخ وتجارت-3000-1400/02/22,181,8662,488185000,26,50,60,34,130.77,56,30,115.38,41,70
226,ارمغان,ص سرمايه گذاري ارمغان ايرانيان,180,5358378,54636114676,10184,10190,10206,22,0.22,10196,12,0.12,10181,10206
227,فولاژ,فولاد آلياژي ايران,178,966542,18112997080,19310,18740,18740,-570,-2.95,19170,-140,-0.73,18740,18740
228,شخارك,پتروشيمي‌ خارك‌,174,173025,7587622850,44070,43700,43890,-180,-0.41,44050,-20,-0.05,43180,44300
229,ثاميد,توسعه و عمران اميد,173,2480731,3820325740,1580,1540,1540,-40,-2.53,1580,0,0,1540,1540
230,ضخود7076,اختيارخ خودرو-2500-1400/07/07,172,7357,1583798000,202,220,219,17,8.42,215,13,6.44,200,257
231,شلعابح,ح . لعابيران‌,171,1584902,19392045900,12990,14000,12220,-770,-5.93,12240,-750,-5.77,12220,14000
232,زپارس,ملي كشت و صنعت و دامپروري پارس,170,274219,41270025740,154850,150210,150210,-4640,-3,151010,-3840,-2.48,150210,155000
233,وبازار,صندوق س شاخصي بازارآشنا,165,874053,7942411320,9130,9150,9180,50,0.55,9090,-40,-0.44,8860,9200
234,اتكام,شركت بيمه اتكايي امين,164,1511566,7035366034,4796,4653,4653,-143,-2.98,4775,-21,-0.44,4653,4877
235,سشمال,سيمان‌ شمال‌,163,2050435,20729897850,10420,10110,10110,-310,-2.98,10280,-140,-1.34,10110,10110
236,كيان2,صندوق س. با درآمد ثابت كيان,162,16200000,16200000,28161,1,1,-28160,-100,1,-28160,-100,1,1
237,تسه9902,امتياز تسهيلات مسكن ارديبهشت99,160,4174,2250590103,535875,511100,555000,19125,3.57,539193,3318,0.62,509082,555000
238,فاراك,ماشين‌ سازي‌ اراك‌,160,2373864,5578580400,2420,2350,2350,-70,-2.89,2410,-10,-0.41,2350,2350
239,سحرخيز,صندوق س. گروه زعفران سحرخيز,157,670838,6394648926,9601,9563,9570,-31,-0.32,9532,-69,-0.72,9500,9638
240,ونيرو,سرمايه‌گذاري‌نيرو,155,4832566,12274717640,2610,2540,2540,-70,-2.68,2590,-20,-0.77,2540,2540
241,ضخود7077,اختيارخ خودرو-3000-1400/07/07,152,7400,711997000,80,99,108,28,35,96,16,20,71,120
242,لبوتان,گروه‌صنعتي‌بوتان‌,150,58488,3540444030,60520,58770,61400,880,1.45,60520,0,0,58770,61940
243,ضخود7075,اختيارخ خودرو-2000-1400/07/07,149,4376,1646320000,354,292,390,36,10.17,376,22,6.21,156,410
244,واعتبار,سرمايه گذاري اعتبار ايران,148,729065,5893282050,7910,7960,8150,240,3.03,7930,20,0.25,7790,8180
245,وسبحان,سرمايه گذاري سبحان,148,10127323,29693311036,3022,2932,2932,-90,-2.98,2966,-56,-1.85,2932,2932
246,عيار,صندوق س. پشتوانه طلاي مفيد,147,119699,2981236575,24861,24760,24912,51,0.21,24906,45,0.18,24760,25090
247,خراسان,پتروشيمي خراسان,145,186001,13087510240,69590,69500,69990,400,0.57,69790,200,0.29,68430,71910
248,درازك,دارويي‌ رازك‌,142,339394,10526709400,31930,30980,31300,-630,-1.97,31730,-200,-0.63,30980,31800
249,سپاس,صندوق س. پاداش سهامداري توسعه1,141,4196917,42528084825,10127,10137,10133,6,0.06,10133,6,0.06,10133,10137
250,ضجار2002,اختيارخ وتجارت-2500-1400/02/22,140,5332,1125793000,116,100,247,131,112.93,211,95,81.9,100,250
251,پارس,پتروشيمي پارس,140,149384,22042108900,146000,146000,146020,20,0.01,146340,340,0.23,145050,148890
252,بكهنوج,توليد برق ماهتاب كهنوج,139,2355754,3773917908,1651,1602,1602,-49,-2.97,1647,-4,-0.24,1602,1602
253,تسه9907,امتياز تسهيلات مسكن مهر99,138,1739,915186690,541744,514687,527000,-14744,-2.72,526272,-15472,-2.86,514687,550000
254,دتماد,توليدمواداوليه‌داروپخش‌,135,477610,20848199730,45000,43650,43650,-1350,-3,44410,-590,-1.31,43650,44420
255,گوهر,صندوق سكه طلاي كيان,133,373582,18123792291,48402,47711,48400,-2,0,48514,112,0.23,47711,49199
256,ساينا,صنايع بهداشتي ساينا,133,112241,16556787220,151640,147091,147091,-4549,-3,150215,-1425,-0.94,147091,154990
257,دالبر,البرزدارو,129,1078078,15589037680,14900,14460,14460,-440,-2.95,14760,-140,-0.94,14460,14500
258,شوينده,مديريت صنعت شوينده ت.ص.بهشهر,129,432013,10973613410,26180,25400,25400,-780,-2.98,26000,-180,-0.69,25400,25450
259,كارين,صندوق س نگين سامان-ثابت,129,3500386,35163566570,10039,10044,10044,5,0.05,10046,7,0.07,10043,10047
260,ساوه,سيمان ساوه,128,811874,46016206446,58431,56679,56679,-1752,-3,56760,-1671,-2.86,56679,56679
261,ساروج,بين المللي ساروج بوشهر,127,477621,8853951590,18695,18322,18700,5,0.03,18623,-72,-0.39,18322,19180
262,لوتوس,تامين سرمايه لوتوس پارسيان,125,367569,3400874220,9360,9210,9300,-60,-0.64,9350,-10,-0.11,9190,9410
263,زرين,صندوق س. سهام زرين كوروش-س,125,174821,1655196426,9537,9373,9465,-72,-0.75,9468,-69,-0.72,9373,9610
264,خاتم,صندوق س خاتم ايساتيس پويا-ثابت,121,2603256,28688613081,11015,11021,11031,16,0.15,11020,5,0.05,11016,11034
265,تسه9904,امتياز تسهيلات مسكن تير99,118,2136,1159300081,542565,560000,515437,-27128,-5,542743,178,0.03,515437,569600
266,كبافق,معادن‌ بافق‌,111,435179,20827666940,49340,47860,47860,-1480,-3,48700,-640,-1.3,47860,47860
267,صايند,صندوق س. گنجينه آينده روشن-د,109,2267490,22480690490,9912,9916,9860,-52,-0.52,9914,2,0.02,9860,9920
268,ثاخت,بين‌المللي‌توسعه‌ساختمان,104,909024,2190747840,2480,2410,2410,-70,-2.82,2480,0,0,2410,2410
269,فردا,صندوق س آواي فرداي زاگرس-ثابت,104,2899204,30699790463,10584,10590,10591,7,0.07,10589,5,0.05,10589,10591
270,وپخش,داروپخش‌ (هلدينگ‌,102,27436,2619207730,96610,94060,93720,-2890,-2.99,96550,-60,-0.06,93720,97770
271,بفجر,فجر انرژي خليج فارس,100,370343,7866867750,21640,21710,21200,-440,-2.03,21580,-60,-0.28,21040,21710
272,مارون,پتروشيمي مارون,100,20182,3019864416,152219,151850,150859,-1360,-0.89,152137,-82,-0.05,148110,151850
273,آكورد2,صندوق س. آرمان آتي كوثر-د,100,10000000,10000000,31784,1,1,-31783,-100,1,-31783,-100,1,1
274,انرژي3,سايراشخاص بورس انرژي,96,10263,2506327230,251760,244210,244210,-7550,-3,251440,-320,-0.13,244210,244210
275,شاروم,پتروشيمي اروميه,93,507068,9566344888,19449,18866,18866,-583,-3,19333,-116,-0.6,18866,18866
276,تسه9903,امتياز تسهيلات مسكن خرداد99,91,741,394933874,540500,567525,513476,-27024,-5,532974,-7526,-1.39,513476,567525
277,تسه9905,امتياز تسهيلات مسكن مرداد99,91,986,528913540,546899,528000,519555,-27344,-5,536423,-10476,-1.92,519555,574243
278,ضجار2004,اختيارخ وتجارت-3500-1400/02/22,90,6465,149171000,18,20,21,3,16.67,23,5,27.78,15,29
279,اوصتا,صندوق انديشه ورزان صباتامين -د,90,2621065,48430226930,18475,18483,18484,9,0.05,18477,2,0.01,18431,18484
280,خمحركه,نيرو محركه‌,89,329938,1474822860,4600,4470,4470,-130,-2.83,4600,0,0,4470,4470
281,اخزا910,اسنادخزانه-م10بودجه99-020807,89,253210,153855730181,606564,605000,606255,-309,-0.05,607621,1057,0.17,604199,608120
282,زعف0008پ08,زعفران0008نگين روستا(پ),87,15900,2080152791,131864,131500,128450,-3414,-2.59,130827,-1037,-0.79,128450,132990
283,تسه9906,امتياز تسهيلات مسكن شهريور99,85,830,439697017,538708,512500,525000,-13708,-2.54,529755,-8953,-1.66,511774,565640
284,زعف0008پ05,زعفران0008نگين زرين(پ),84,22180,2872981399,131658,130201,128250,-3408,-2.59,129530,-2128,-1.62,128000,132500
285,وآرين,شركت توسعه اقتصادي آرين,84,620636,2148021196,3531,3461,3461,-70,-1.98,3523,-8,-0.23,3461,3461
286,وملي,گروه‌ صنعتي‌ ملي‌ (هلدينگ‌,83,16178,2687651140,171260,166130,166130,-5130,-3,170970,-290,-0.17,166130,166130
287,سپيدار,سپيدار سيستم آسيا,82,35095,2005398490,58909,57142,57142,-1767,-3,58836,-73,-0.12,57142,57142
288,سكه0012پ04,سكه تمام بهارتحويلي1روز صادرات,81,35100,34558679900,984969,982000,981000,-3969,-0.4,984578,-391,-0.04,981000,988700
289,آساميد,صندوق س.مشترك آسمان اميد -د,80,3966487,47379084169,11939,11950,11946,7,0.06,11945,6,0.05,11944,11952
290,ضشنا2002,اختيارخ شپنا-12000-1400/02/27,80,3113,1030441000,414,180,326,-88,-21.26,331,-83,-20.05,180,500
291,سخاش,سيمان‌خاش‌,80,254479,37998804280,153930,149320,149320,-4610,-2.99,150270,-3660,-2.38,149320,149320
292,اخزا909,اسنادخزانه-م9بودجه99-020316,79,388326,255321657820,655899,655033,659098,3199,0.49,657493,1594,0.24,654000,659098
293,چدن,توليدي چدن سازان,76,83956,1993115440,24470,23740,23740,-730,-2.98,24440,-30,-0.12,23740,23740
294,اتكاي,بيمه اتكايي ايرانيان,76,274304,4544603352,17068,16556,16680,-388,-2.27,17020,-48,-0.28,16556,16748
295,فافزا,فولاد افزا سپاهان,76,55532,2852770449,52412,52411,51364,-1048,-2,52260,-152,-0.29,51364,52411
296,ختوقا,قطعات‌ اتومبيل‌ ايران‌,74,552272,1375157280,2560,2490,2490,-70,-2.73,2560,0,0,2490,2490
297,كخاك,صنايع‌خاك‌چيني‌ايران‌,73,66265,2627721510,40660,39450,39450,-1210,-2.98,40610,-50,-0.12,39450,40640
298,آتيمس,صندوق س.آرمان آتيه درخشان مس-س,73,12027,2141717722,177863,177000,178490,627,0.35,178076,213,0.12,177000,181150
299,دمعيار,صندوق س. توازن معيار-د,72,5427968,54496780576,10036,10044,10038,2,0.02,10040,4,0.04,10038,10044
300,تسه9901,امتياز تسهيلات مسكن فروردين99,72,962,523446819,539913,513000,540000,87,0.02,544123,4210,0.78,513000,566000
301,بورس,بورس اوراق بهادار تهران,72,430388,14706357960,35220,34170,34170,-1050,-2.98,34940,-280,-0.8,34170,34170
302,دارا,صندوق س. دارا الگوريتم-د,71,1276498,12765544888,9995,10003,10010,15,0.15,10000,5,0.05,9989,10010
303,وبوعلي,سرمايه‌گذاري‌بوعلي‌,71,302676,1698012360,5780,5610,5610,-170,-2.94,5770,-10,-0.17,5610,5610
304,پتاير,ايران‌ تاير,70,301116,1071972960,3670,3560,3560,-110,-3,3670,0,0,3560,3560
305,اخزا902,اسنادخزانه-م2بودجه99-011019,68,154305,110012658959,712720,710255,713499,779,0.11,712956,236,0.03,710255,714000
306,واميد,گروه مديريت سرمايه گذاري اميد,68,1745662,21349446260,12600,12230,12230,-370,-2.94,12530,-70,-0.56,12230,12230
307,دارو,كارخانجات‌داروپخش‌,68,36893,1205384470,33670,32660,32660,-1010,-3,33650,-20,-0.06,32660,32990
308,تسه9806,امتياز تسهيلات مسكن شهريور98,67,1189,632981541,541883,568977,530005,-11878,-2.19,532365,-9518,-1.76,514789,568977
309,دلر,داروسازي‌ اكسير,66,146825,5085223720,35670,34600,34600,-1070,-3,35560,-110,-0.31,34600,35810
310,چكاپا,گروه صنايع كاغذ پارس,65,204112,1028724480,5190,5040,5040,-150,-2.89,5190,0,0,5040,5040
311,تسه9804,امتياز تسهيلات مسكن تير98,65,866,465361264,539337,516744,541900,2563,0.48,537369,-1968,-0.36,516744,549998
312,سكه0011پ02,سكه تمام بهارتحويلي 1روزه ملت,65,11200,11023339200,984972,990000,981000,-3972,-0.4,984227,-745,-0.08,981000,990000
313,تكمبا,كمباين‌ سازي‌ ايران‌,64,1481693,11423853030,7940,7710,7710,-230,-2.9,7890,-50,-0.63,7710,7710
314,زر,صندوق س.پشتوانه سكه طلاي زر,64,22738,952751541,41714,41714,41880,166,0.4,41901,187,0.45,41620,42000
315,تسه9812,امتياز تسهيلات مسكن اسفند98,63,685,366495176,544330,519130,540000,-4330,-0.8,535029,-9301,-1.71,519130,570000
316,غپينو,پارس‌ مينو,63,570239,3512672240,6350,6160,6160,-190,-2.99,6340,-10,-0.16,6160,6160
317,تسه9811,امتياز تسهيلات مسكن بهمن98,62,441,232982656,539312,513000,512347,-26965,-5,528305,-11007,-2.04,512347,560000
318,ودي,بيمه  دي,61,1179260,24357615300,21293,20655,20655,-638,-3,20970,-323,-1.52,20655,20655
319,دسبحا,گروه دارويي سبحان,61,238603,4450454710,19220,18650,18650,-570,-2.97,19170,-50,-0.26,18650,18800
320,سقاين,سيمان‌ قائن‌,61,450753,31561725060,72180,70020,70020,-2160,-2.99,70770,-1410,-1.95,70020,70020
321,اخزا903,اسنادخزانه-م3بودجه99-011110,60,54021,38036803208,703942,702002,703813,-129,-0.02,704111,169,0.02,702002,705400
322,ضملت3001,اختيارخ وبملت-3500-1400/03/19,60,1206,1559594000,893,1100,1200,307,34.38,1293,400,44.79,1060,1389
323,كوير,توليدي فولاد سپيد فراب كوير,60,1037142,20234640420,20110,19510,19510,-600,-2.98,19970,-140,-0.7,19510,19510
324,تسه9805,امتياز تسهيلات مسكن مرداد98,60,632,340328883,546523,520009,528100,-18423,-3.37,538495,-8028,-1.47,520009,554998
325,ثرود,سرمايه‌گذاري مسكن زاينده رود,60,196052,4020830468,21143,20509,20509,-634,-3,21090,-53,-0.25,20509,20509
326,ورنا,سرمايه‌گذاري‌ رنا(هلدينگ‌,59,585337,3125699580,5500,5340,5340,-160,-2.91,5490,-10,-0.18,5340,5340
327,افق ملت,صندوق س در سهام افق ملت,58,21535,2646516450,121850,123980,123760,1910,1.57,122890,1040,0.85,122060,123980
328,دكپسول,توليد ژلاتين كپسول ايران,58,269442,8680074030,33211,32215,32215,-996,-3,33032,-179,-0.54,32215,32215
329,ثبهساز,بهساز كاشانه تهران,57,365634,819020160,2300,2240,2240,-60,-2.61,2300,0,0,2240,2240
330,سدشت,صنايع سيمان دشتستان,57,151952,11145679200,69200,73350,73350,4150,6,70050,850,1.23,73350,73350
331,زعف0008پ10,زعفران0008نگين طلاي سرخ(پ),56,18089,2424958964,134983,135000,135590,607,0.45,134057,-926,-0.69,132500,135590
332,ستران,سيمان‌ تهران‌,56,76691,1747020980,23480,22780,22780,-700,-2.98,23450,-30,-0.13,22780,22780
333,هنوري102,اختيارف ت نوري73761-01/02/15,56,1000000,121000000,1000,121,121,-879,-87.9,121,-879,-87.9,121,121
334,ولساپا,ليزينگ رايان‌ سايپا,55,536970,1755891900,3370,3270,3270,-100,-2.97,3370,0,0,3270,3270
335,اخزا815,اسنادخزانه-م15بودجه98-010406,54,38934,31094857903,795155,793520,800000,4845,0.61,798656,3501,0.44,793520,800000
336,ضخود7072,اختيارخ خودرو-1400-1400/07/07,54,2538,2015574000,767,780,850,83,10.82,794,27,3.52,760,990
337,غزر,صنعتي زر ماكارون,54,67110,1715331600,26350,25560,25560,-790,-3,26320,-30,-0.11,25560,25560
338,ثروتم,صندوق س. ثروت آفرين پارسيان-س,54,109590,8062296080,73262,73610,74300,1038,1.42,73568,306,0.42,73090,74660
339,وكادو,تكادو,53,364209,5730100197,16388,15733,15733,-655,-4,16188,-200,-1.22,15733,15733
340,زعف0008پ20,زعفران0008نگين وحدت جام(پ),51,26417,3411879901,129751,131000,128000,-1751,-1.35,129155,-596,-0.46,128000,131010
341,قپيرا,فرآورده‌هاي‌غدايي‌وقندپيرانشهر,51,18359,1845005860,103110,100020,100020,-3090,-3,103010,-100,-0.1,100020,103110
342,وايرا,سرمايه گذاري صنايع ايران,50,820370,10160282450,12901,12385,12385,-516,-4,12619,-282,-2.19,12385,12385
343,تسه9808,امتياز تسهيلات مسكن آبان98,50,540,285044540,534749,510001,510002,-24747,-4.63,527860,-6889,-1.29,510001,550000
344,فيروزا,صندوق بادرآمد ثابت فيروزه آسيا,50,834737,18946975253,22620,22605,22660,40,0.18,22698,78,0.34,22605,22718
345,لپارس,پارس‌ الكتريك‌,49,51176,4596628320,92590,89820,89820,-2770,-2.99,92330,-260,-0.28,89820,89820
346,همبين102,اختيارف ت مبين19752-01/02/10,49,1100000,565400000,1000,514,514,-486,-48.6,514,-486,-48.6,514,514
347,وپويا,سرمايه گذاري پويا,48,825468,5244198204,6549,6353,6353,-196,-2.99,6528,-21,-0.32,6353,6353
348,اخزا901,اسنادخزانه-م1بودجه99-010621,48,32298,24568958602,760003,758012,760721,718,0.09,760696,693,0.09,758012,762000
349,وآيند,بانك  آينده,48,72903,1170093150,16377,16050,16050,-327,-2,16373,-4,-0.02,16050,16050
350,تسه9809,امتياز تسهيلات مسكن آذر98,48,397,208943348,538332,521211,511416,-26916,-5,526306,-12026,-2.23,511416,530001
351,فرابورس,فرابورس ايران,46,38570,1173337970,31361,30421,30421,-940,-3,31338,-23,-0.07,30421,30421
352,وسديد,گروه ‌صنعتي‌سديد,45,316377,883008207,2907,2791,2791,-116,-3.99,2904,-3,-0.1,2791,2791
353,تليسه,دامداري تليسه نمونه,44,170750,721418750,4355,4225,4225,-130,-2.99,4353,-2,-0.05,4225,4225
354,زملارد,كشاورزي و دامپروري ملارد شير,44,133493,4903731862,37870,36734,36734,-1136,-3,37754,-116,-0.31,36734,36734
355,اخزا908,اسنادخزانه-م8بودجه99-020606,44,203479,128475229250,627487,627000,630900,3413,0.54,631393,3906,0.62,627000,632800
356,تمحركه,ماشين سازي نيرو محركه,43,156396,3848123580,25630,24605,24605,-1025,-4,25424,-206,-0.8,24605,24605
357,تسه9807,امتياز تسهيلات مسكن مهر98,42,412,220803406,541688,516000,550000,8312,1.53,535931,-5757,-1.06,515777,550000
358,غشهداب,كشت و صنعت شهداب ناب خراسان,42,386842,1489341700,3969,3850,3850,-119,-3,3965,-4,-0.1,3850,3850
359,نوين,بيمه نوين,42,377684,2175082156,5937,5759,5759,-178,-3,5929,-8,-0.13,5759,5759
360,فسرب,ملي‌ سرب‌وروي‌ ايران‌,42,11785,901670350,78870,76510,76510,-2360,-2.99,78830,-40,-0.05,76510,76510
361,چكارن,كارتن‌ ايران‌,41,191051,619005240,3330,3240,3240,-90,-2.7,3330,0,0,3240,3240
362,ضصاد3001,اختيارخ وبصادر-2000-1400/03/12,41,1543,632815000,296,450,420,124,41.89,410,114,38.51,380,450
363,ضملي3002,اختيارخ فملي-10000-1400/03/02,40,548,1178555000,2126,3000,2200,74,3.48,2151,25,1.18,2000,3000
364,كالا,بورس كالاي ايران,40,40709,1282333500,32470,31500,31500,-970,-2.99,32440,-30,-0.09,31500,31500
365,سكه0112پ03,سكه تمام بهارتحويلي1روزه سامان,40,22400,22048231400,984840,985000,981001,-3839,-0.39,984296,-544,-0.06,981001,989000
366,دابور,داروسازي‌ ابوريحان‌,39,507725,19039687500,38650,37500,37500,-1150,-2.98,38190,-460,-1.19,37500,37500
367,فوكا,فولاد كاويان,39,69123,791734842,11931,11454,11454,-477,-4,11917,-14,-0.12,11454,11454
368,رتاپ,تجارت الكترونيك  پارسيان,39,120784,811668480,6920,6720,6720,-200,-2.89,6920,0,0,6720,6720
369,فراز,صندوق س.سهام فراز داريك-س,39,75464,772958061,10238,10242,10242,4,0.04,10243,5,0.05,10242,10250
370,جوين,كشت و صنعت جوين,38,355574,1711022088,5012,4812,4812,-200,-3.99,4994,-18,-0.36,4812,4812
371,ضملت3002,اختيارخ وبملت-4000-1400/03/19,38,1240,980825000,512,720,900,388,75.78,791,279,54.49,611,900
372,گنجين,صندوق س. گنجينه يكم آويد-د,37,269738,3429837613,12713,12720,12718,5,0.04,12715,2,0.02,12714,12720
373,سجام,مجتمع سيمان غرب آسيا,37,127697,550884858,4402,4314,4314,-88,-2,4399,-3,-0.07,4314,4314
374,ولملت,واسپاري ملت,37,1951217,15395102130,8130,7890,7890,-240,-2.95,8050,-80,-0.98,7890,7890
375,بكام,كارخانجات توليدي شهيد قندي,36,198694,762984960,3950,3840,3840,-110,-2.78,3950,0,0,3840,3840
376,ثشاهد,سرمايه‌ گذاري‌ شاهد,36,30891,528545010,17630,17110,17110,-520,-2.95,17620,-10,-0.06,17110,17110
377,پارند2,صندوق س. پارند پايدار سپهر,35,3500000,3500000,11326,1,1,-11325,-99.99,1,-11325,-99.99,1,1
378,غگرجي,بيسكويت‌  گرجي‌,35,702482,12602527080,18490,17940,17940,-550,-2.97,18350,-140,-0.76,17940,17940
379,سيستم,همكاران سيستم,34,166336,4153409920,25740,24970,24970,-770,-2.99,25670,-70,-0.27,24970,24970
380,دزهراوي,داروسازي‌زهراوي‌,34,105553,891922850,8710,8450,8450,-260,-2.99,8710,0,0,8450,8450
381,ريشمك,توليد و صادرات ريشمك,34,104656,5783918496,56975,55266,55266,-1709,-3,56771,-204,-0.36,55266,55266
382,دسبحان,سبحان دارو,34,717753,13242542850,19020,18450,18450,-570,-3,18860,-160,-0.84,18450,18450
383,خكاوه,سايپا ديزل,34,452748,1574657544,3622,3478,3478,-144,-3.98,3610,-12,-0.33,3478,3478
384,صنوين,صندوق سرمايه‌گذاري صنوين-مختلط,34,9414,981420640,102980,104750,104000,1020,0.99,104250,1270,1.23,104000,104750
385,زفكا,كشت و دامداري فكا,33,1122003,14094601686,12950,12562,12562,-388,-3,12836,-114,-0.88,12562,12562
386,خفولا,خدمات فني فولاد يزد,33,38930,1636150040,43779,42028,42028,-1751,-4,43630,-149,-0.34,42028,42028
387,شفارا,پتروشيمي فارابي,33,870947,3255599886,3814,3738,3738,-76,-1.99,3801,-13,-0.34,3738,3738
388,ثفارس,عمران‌وتوسعه‌فارس‌,32,548843,5351219250,10050,9750,9750,-300,-2.99,10020,-30,-0.3,9750,9750
389,وثوق,سرمايه گذاري وثوق امين,32,148269,2676107181,18417,18049,18049,-368,-2,18367,-50,-0.27,18049,18049
390,شپترو,پتروشيمي آبادان,31,190385,918036470,4920,4822,4822,-98,-1.99,4915,-5,-0.1,4822,4822
391,شگل,گلتاش‌,31,404534,3968478540,10110,9810,9810,-300,-2.97,10090,-20,-0.2,9810,9810
392,بذر,صندوق س بذر اميد آفرين-سهام,30,23812,2262195060,94440,95800,94000,-440,-0.47,95000,560,0.59,94000,95800
393,اميد,تامين سرمايه اميد,30,185196,1394525880,7760,7530,7530,-230,-2.96,7750,-10,-0.13,7530,7530
394,اخزا818,اسنادخزانه-م18بودجه98-010614,30,14826,11395533026,772916,763549,768134,-4782,-0.62,768618,-4298,-0.56,763549,771000
395,كي بي سي,شركت كي بي سي,29,250801,6730746437,27667,26837,26837,-830,-3,27552,-115,-0.42,26837,26837
396,زعف0008پ11,زعفران0008نگين سحرخيز(پ),29,13439,1762666922,132517,130515,131000,-1517,-1.14,131161,-1356,-1.02,128310,132860
397,وگردش,بانك گردشگري,29,34164,558547236,17030,16349,16349,-681,-4,17026,-4,-0.02,16349,16349
398,وصنا,گروه‌صنايع‌بهشهرايران‌,29,213609,1170577320,5640,5480,5480,-160,-2.84,5640,0,0,5480,5480
399,ولپارس,ليزينگ پارسيان,28,119350,580041000,5010,4860,4860,-150,-2.99,5010,0,0,4860,4860
400,وآذر,سرمايه‌گذاري‌توسعه‌آذربايجان‌,28,20010,1638218700,84400,81870,81870,-2530,-3,84310,-90,-0.11,81870,81870
401,سمگا,گروه سرمايه گذاري ميراث فرهنگي,27,26990,751563540,28707,27846,27846,-861,-3,28694,-13,-0.05,27846,27846
402,پلوله,گازلوله‌,27,315533,8921380042,27451,28274,28274,823,3,27792,341,1.24,28274,28274
403,دامين,داروسازي‌ امين‌,27,135409,687877720,5230,5080,5080,-150,-2.87,5230,0,0,5080,5080
404,حريل,ريل پردازسير,26,459092,2488737732,5588,5421,5421,-167,-2.99,5579,-9,-0.16,5421,5421
405,زگلدشت,كشت و دام گلدشت نمونه اصفهان,26,230989,3135675675,13994,13575,13575,-419,-2.99,13967,-27,-0.19,13575,13575
406,وتوصا,گروه س توسعه صنعتي ايران,25,253923,3047076000,12370,12000,12000,-370,-2.99,12350,-20,-0.16,12000,12000
407,دفرا,فرآورده‌هاي‌ تزريقي‌ ايران‌,25,120000,3052800000,26220,25440,25440,-780,-2.97,26170,-50,-0.19,25440,25440
408,ساربيل,سيمان آرتا اردبيل,25,192073,10039655710,53880,52270,52270,-1610,-2.99,53540,-340,-0.63,52270,52270
409,شدوص,دوده‌ صنعتي‌ پارس‌,25,17458,450765560,27460,25820,25820,-1640,-5.97,27440,-20,-0.07,25820,25820
410,كيسون,شركت كيسون,25,68128,752064992,11498,11039,11039,-459,-3.99,11482,-16,-0.14,11039,11039
411,كماسه,تامين‌ ماسه‌ ريخته‌گري‌,25,12486,530155560,43770,42460,42460,-1310,-2.99,43760,-10,-0.02,42460,42460
412,ضپاس2002,اختيارخ وپارس-3000-1400/02/29,24,1486,74344000,36,75,35,-1,-2.78,50,14,38.89,35,75
413,شجم,صنايع پتروشيمي تخت جمشيد,24,286877,2842377316,10320,9908,9908,-412,-3.99,10275,-45,-0.44,9908,9908
414,وكارح,ح . بانك‌ كارآفرين‌,24,5076100,9393797000,1910,1910,1850,-60,-3.14,1850,-60,-3.14,1850,1910
415,الماس,صندوق س.امين تدبيرگران فردا-س,24,2461,265596600,107793,107500,108800,1007,0.93,107922,129,0.12,107500,108800
416,وبهمن,سرمايه‌گذاري‌بهمن‌,24,527010,7451921400,14570,14140,14140,-430,-2.95,14500,-70,-0.48,14140,14140
417,پكرمان,گروه‌ صنعتي‌ بارز,24,69550,1717189500,25450,24690,24690,-760,-2.99,25420,-30,-0.12,24690,24690
418,ضپاس2001,اختيارخ وپارس-2500-1400/02/29,24,657,135087000,127,148,199,72,56.69,206,79,62.2,70,501
419,خرينگ,رينگ‌سازي‌مشهد,23,20012,1019211160,52500,50930,50930,-1570,-2.99,52470,-30,-0.06,50930,50930
420,شپارس,بين‌ المللي‌ محصولات‌  پارس‌,23,78971,1711301570,22330,21670,21670,-660,-2.96,22310,-20,-0.09,21670,21670
421,ولانا,شركت ليزينگ آريا دانا,23,31426,1250251984,40595,39784,39784,-811,-2,40541,-54,-0.13,39784,39784
422,ضملي3003,اختيارخ فملي-12000-1400/03/02,22,127,109050000,878,950,850,-28,-3.19,859,-19,-2.16,753,950
423,ضخود2006,اختيارخ خودرو-2500-1400/02/08,22,1098,1098000,1,1,1,0,0,1,0,0,1,1
424,ضخود2009,اختيارخ خودرو-4000-1400/02/08,21,2100,2100000,1,1,1,0,0,1,0,0,1,1
425,دتوليد,داروسازي توليد دارو,21,9204,237426384,26593,25796,25796,-797,-3,26589,-4,-0.02,25796,25796
426,شستان,پتروشيمي گلستان,21,88900,338086700,3880,3803,3803,-77,-1.98,3877,-3,-0.08,3803,3803
427,پكوير,كوير تاير,21,178426,2230325000,12880,12500,12500,-380,-2.95,12860,-20,-0.16,12500,12500
428,شسينا,صنايع‌شيميايي‌سينا,21,2799,359811450,132520,128550,128550,-3970,-3,132490,-30,-0.02,128550,128550
429,كهمدا,شيشه‌ همدان‌,21,248962,2457254940,10170,9870,9870,-300,-2.95,10150,-20,-0.2,9870,9870
430,اخزا814,اسنادخزانه-م14بودجه98-010318,21,60470,48904083859,804872,805000,808995,4123,0.51,808733,3861,0.48,805000,808995
431,وپترو,سرمايه‌گذاري صنايع پتروشيمي‌,21,146723,1967555430,13820,13410,13410,-410,-2.97,13800,-20,-0.14,13410,13410
432,كمنگنز,معادن‌منگنزايران‌,20,9485,814002700,88470,85820,85820,-2650,-3,88430,-40,-0.05,85820,85820
433,اخزا811,اسنادخزانه-م11بودجه98-001013,20,84182,73651797676,873089,877500,873122,33,0,874911,1822,0.21,873102,877500
434,غصينو,صنعتي مينو,20,341982,22528406232,67913,65876,65876,-2037,-3,67440,-473,-0.7,65876,65876
435,دانا,بيمه دانا,20,39839,256563160,6630,6440,6440,-190,-2.87,6630,0,0,6440,6440
436,سهگمت,سيمان‌هگمتان‌,20,306812,7409509800,24890,24150,24150,-740,-2.97,24780,-110,-0.44,24150,24150
437,گوهر2,صندوق سكه طلاي كيان,20,200000,200000,48402,1,1,-48401,-100,1,-48401,-100,1,1
438,ساروم,سيمان‌اروميه‌,20,5342,210047440,40530,39320,39320,-1210,-2.99,40520,-10,-0.02,39320,39320
439,بميلا,توسعه بازرگاني آهن وفولادميلاد,20,96998,1336535442,14060,13779,13779,-281,-2,14042,-18,-0.13,13779,13779
440,اخزا905,اسنادخزانه-م5بودجه99-020218,20,31049,20677513756,666501,673900,666510,9,0,665964,-537,-0.08,665320,673900
441,خمهر,مهركام‌پارس‌,19,101924,241559880,2440,2370,2370,-70,-2.87,2440,0,0,2370,2370
442,پرديس,سرمايه گذاري پرديس,19,44818,236190860,5430,5270,5270,-160,-2.95,5430,0,0,5270,5270
443,كوثر,بيمه كوثر,19,22917,326154744,14672,14232,14232,-440,-3,14669,-3,-0.02,14232,14232
444,شپاكسا,پاكسان‌,19,206640,5500756800,27440,26620,26620,-820,-2.99,27350,-90,-0.33,26620,26620
445,واتي,سرمايه‌ گذاري‌ آتيه‌ دماوند,19,81222,818717760,10390,10080,10080,-310,-2.98,10380,-10,-0.1,10080,10080
446,ومشان,س. فني و مهندسي مشانير,18,15854,1096097998,72017,69137,69137,-2880,-4,71853,-164,-0.23,69137,69137
447,حفارس,حمل و نقل بين المللي خليج فارس,18,141272,662565680,4830,4690,4690,-140,-2.9,4830,0,0,4690,4690
448,غپاك,لبنيات‌ پاك‌,18,52746,1580797620,30890,29970,29970,-920,-2.98,30860,-30,-0.1,29970,29970
449,ولتجار,واسپاري تجارت وسرمايه ايرانيان,18,91488,725042400,8255,7925,7925,-330,-4,8243,-12,-0.15,7925,7925
450,شلعاب,لعابيران‌,18,32983,701548410,21920,21270,21270,-650,-2.97,21910,-10,-0.05,21270,21270
451,اخزا722,اسنادخزانه-م22بودجه97-000428,18,71345,68216171539,956338,956000,954600,-1738,-0.18,956145,-193,-0.02,954600,956999
452,زعف0008پ16,زعفران0008نگين بيرجند(پ),18,5761,739099638,130641,129000,128002,-2639,-2.02,128294,-2347,-1.8,127802,130000
453,سپر,صندوق س سپر سرمايه بيدار- ثابت,18,54855,645065229,11756,11759,11759,3,0.03,11759,3,0.03,11759,11760
454,ختور,رادياتور ايران‌,18,11055,210708300,19640,19060,19060,-580,-2.95,19640,0,0,19060,19060
455,تبرك,گروه كارخانجات صنعتي تبرك,17,28129,540864412,19822,19228,19228,-594,-3,19815,-7,-0.04,19228,19228
456,اخزا812,اسنادخزانه-م12بودجه98-001111,17,13256,11465439598,864217,859500,865000,783,0.09,864925,708,0.08,859500,876999
457,داروح,ح . كارخانجات‌داروپخش,17,14323,356967330,26420,26320,24840,-1580,-5.98,24920,-1500,-5.68,24840,26320
458,پسهند,صنايع‌ لاستيكي‌  سهند,17,8553,342205530,41240,40010,40010,-1230,-2.98,41230,-10,-0.02,40010,40010
459,غويتا,ويتانا,17,17388,303038064,17966,17428,17428,-538,-2.99,17963,-3,-0.02,17428,17428
460,ضسپا3005,اختيارخ خساپا-3000-1400/03/26,17,1401,15225000,7,25,10,3,42.86,11,4,57.14,10,25
461,زعف0008پ18,زعفران0008نگين بهرامن(پ),16,1518,204223500,133980,133400,132500,-1480,-1.1,134535,555,0.41,132500,135490
462,بزاگرس,نيروگاه زاگرس كوثر,16,50728,352305960,7159,6945,6945,-214,-2.99,7157,-2,-0.03,6945,6945
463,آسام,صندوق س.آرمان سپهر آشنا-م,16,8500,882613900,102895,103500,104400,1505,1.46,103837,942,0.92,101023,104400
464,وسرمد,بيمه  سرمد,16,46516,278398260,6234,5985,5985,-249,-3.99,6230,-4,-0.06,5985,5985
465,سصوفي,سيمان‌ صوفيان‌,16,21966,423943800,19890,19300,19300,-590,-2.97,19880,-10,-0.05,19300,19300
466,دقاضيح,ح . داروسازي شهيد قاضي,16,53258,1656047688,31954,32900,30676,-1278,-4,31095,-859,-2.69,30676,32900
467,آپ,آسان پرداخت پرشين,16,47385,800806500,17420,16900,16900,-520,-2.99,17410,-10,-0.06,16900,16900
468,سغرب,سيمان‌غرب‌,16,36996,1272662400,35460,34400,34400,-1060,-2.99,35430,-30,-0.08,34400,34400
469,ضفلا3003,اختيارخ فولاد-7133-1400/03/19,16,215,593170000,2846,3155,2700,-146,-5.13,2759,-87,-3.06,2500,3155
470,اخزا810,اسنادخزانه-م10بودجه98-001006,16,30181,26534391467,873285,874000,874855,1570,0.18,879175,5890,0.67,874000,880999
471,دتوزيع,توزيع دارو پخش,15,219285,10920612285,51341,49801,49801,-1540,-3,50989,-352,-0.69,49801,49801
472,ضشنا2003,اختيارخ شپنا-14000-1400/02/27,15,840,62620000,99,80,77,-22,-22.22,75,-24,-24.24,70,80
473,ضملت3003,اختيارخ وبملت-4500-1400/03/19,15,441,229408000,183,399,500,317,173.22,520,337,184.15,340,599
474,شراز,پالايش نفت شيراز,15,3846,413779602,110914,107587,107587,-3327,-3,110885,-29,-0.03,107587,107587
475,كحافظ,كاشي‌ وسراميك‌ حافظ‌,15,60208,700821120,11990,11640,11640,-350,-2.92,11980,-10,-0.08,11640,11640
476,اعتلا,شركت سرمايه گذاري اعتلاء البرز,14,31294,220434936,7261,7044,7044,-217,-2.99,7260,-1,-0.01,7044,7044
477,چخزر,صنايع چوب خزر كاسپين,14,4472,233916904,53924,52307,52307,-1617,-3,53916,-8,-0.01,52307,52307
478,كلر,كلر پارس,14,3341,428279449,132153,128189,128189,-3964,-3,132117,-36,-0.03,128189,128189
479,كگاز,شيشه‌ و گاز,14,7549,137542780,18780,18220,18220,-560,-2.98,18780,0,0,18220,18220
480,هپارس102,اختيارف ت پارس-177010-01/02/05,14,150000,150000,1,1,1,0,0,1,0,0,1,1
481,فلوله,لوله‌وماشين‌سازي‌ايران‌,14,19374,416734740,22170,21510,21510,-660,-2.98,22160,-10,-0.05,21510,21510
482,اخزا907,اسنادخزانه-م7بودجه99-020704,13,26457,16327076206,617040,617000,618000,960,0.16,617117,77,0.01,612251,618010
483,اخزا817,اسنادخزانه-م17بودجه98-010512,13,55723,43703677078,780871,784990,780800,-71,-0.01,784302,3431,0.44,780017,785000
484,وجامي,سرمايه گذاري جامي,13,15842,229471370,15088,14485,14485,-603,-4,15081,-7,-0.05,14485,14485
485,خشرق,الكتريك‌ خودرو شرق‌,13,41568,603151680,14950,14510,14510,-440,-2.94,14940,-10,-0.07,14510,14510
486,رافزا,رايان هم افزا,13,1240,128410680,106759,103557,103557,-3202,-3,106750,-9,-0.01,103557,103557
487,كپارس,كاشي‌ پارس‌,13,6648,992612880,153920,149310,149310,-4610,-3,153820,-100,-0.06,149310,149310
488,ختراك,ريخته‌گري‌ تراكتورسازي‌ ايران‌,13,47323,714577300,15560,15100,15100,-460,-2.96,15550,-10,-0.06,15100,15100
489,خبازرس,بازرسي مهندسي و صنعتي ايران,13,158357,4924902700,31734,31100,31100,-634,-2,31572,-162,-0.51,31100,31100
490,اراد50,مرابحه عام دولت5-ش.خ0302,13,178600,178600040000,1000000,1000000,1000001,1,0,1000000,0,0,1000000,1000001
491,ولبهمن,شركت بهمن ليزينگ,13,527793,3949475019,7714,7483,7483,-231,-2.99,7695,-19,-0.25,7483,7483
492,لكما,كارخانجات‌مخابراتي‌ايران‌,13,13965,83664315,6113,5991,5991,-122,-2,6112,-1,-0.02,5991,5991
493,شكربن,كربن‌ ايران‌,13,50649,4303139040,87580,84960,84960,-2620,-2.99,87340,-240,-0.27,84960,84960
494,زشگزا,شير و گوشت زاگرس شهركرد,13,24712,197473592,8238,7991,7991,-247,-3,8237,-1,-0.01,7991,7991
495,باران,بيمه زندگي باران50%تاديه,13,114505,446913015,3718,3903,3903,185,4.98,3722,4,0.11,3903,3903
496,سمايه,بانك سرمايه,12,49852,244573912,5006,4906,4906,-100,-2,5005,-1,-0.02,4906,4906
497,اخزا809,اسنادخزانه-م9بودجه98-000923,12,848,748514695,881081,881000,883890,2809,0.32,882682,1601,0.18,881000,883890
498,كپرور,فرآوري زغال سنگ پروده طبس,12,5558,198448390,36809,35705,35705,-1104,-3,36804,-5,-0.01,35705,35705
499,شاملا,معدني‌ املاح‌  ايران‌,12,11040,537427200,50180,48680,48680,-1500,-2.99,50160,-20,-0.04,48680,48680
500,غبهنوش,بهنوش‌ ايران‌,12,4091,283997220,71560,69420,69420,-2140,-2.99,71550,-10,-0.01,69420,69420
501,شكلر,نيروكلر,12,9039,422030910,48130,46690,46690,-1440,-2.99,48120,-10,-0.02,46690,46690
502,سخند,صندوق س.سپهرخبرگان نفت-د,12,138940,1405264420,10113,10113,10118,5,0.05,10114,1,0.01,10113,10118
503,زبينا,كشاورزي و دامپروري بينالود,12,55842,211697022,3908,3791,3791,-117,-2.99,3907,-1,-0.03,3791,3791
504,بنو,بيمه تجارت نو,11,12035,372158305,31879,30923,30923,-956,-3,31872,-7,-0.02,30923,30923
505,هجرتح,ح . پخش هجرت,11,12238,252936307,21240,22514,20603,-637,-3,20668,-572,-2.69,20603,22514
506,اخزا904,اسنادخزانه-م4بودجه99-011215,11,5943,4130308019,694504,697990,694000,-504,-0.07,694987,483,0.07,694000,697990
507,وسمازن,س.سهام عدالت استان مازندران,11,232772,221133400,970,950,950,-20,-2.06,970,0,0,950,950
508,اخزا821,اسنادخزانه-م21بودجه98-020906,11,3248,1938689485,598245,596006,599111,866,0.14,596887,-1358,-0.23,595520,600999
509,فزرين,زرين معدن آسيا,11,35315,924687960,26993,26184,26184,-809,-3,26978,-15,-0.06,26184,26184
510,زدشت,كشت و صنعت دشت خرم دره,11,13735,392202925,29438,28555,28555,-883,-3,29431,-7,-0.02,28555,28555
511,كيميا,معدني كيمياي زنجان گستران,11,32511,558181359,17700,17169,17169,-531,-3,17694,-6,-0.03,17169,17169
512,ضشنا2001,اختيارخ شپنا-10000-1400/02/27,11,155,144492000,1098,1030,961,-137,-12.48,932,-166,-15.12,801,1030
513,رنيك,جنرال مكانيك,10,4863,105269361,22316,21647,21647,-669,-3,22315,-1,0,21647,21647
514,ضجار2001,اختيارخ وتجارت-2000-1400/02/22,10,267,125115000,548,385,717,169,30.84,469,-79,-14.42,385,798
515,هجرت,پخش هجرت,10,109756,2994802216,28129,27286,27286,-843,-3,28077,-52,-0.18,27286,27286
516,كدما,معدني‌ دماوند,10,553,81263350,151490,146950,146950,-4540,-3,151480,-10,-0.01,146950,146950
517,گدنا,تهيه توزيع غذاي دنا آفرين فدك,10,1913,62962569,33930,32913,32913,-1017,-3,33929,-1,0,32913,32913
518,وبيمه,سرمايه‌ گذاري‌ صنعت‌ بيمه‌,10,58798,159930560,2800,2720,2720,-80,-2.86,2800,0,0,2720,2720
519,تپكو,توليدتجهيزات‌سنگين‌هپكو,10,35901,190670211,5419,5311,5311,-108,-1.99,5419,0,0,5311,5311
520,لسرما,سرما آفرين‌,10,11073,260215500,24220,23500,23500,-720,-2.97,24220,0,0,23500,23500
521,جهرم,پتروشيمي جهرم,10,52247,90909780,1775,1740,1740,-35,-1.97,1775,0,0,1740,1740
522,فپنتا,سپنتا,10,1235,487676800,407090,394880,394880,-12210,-3,406970,-120,-0.03,394880,394880
523,ضملت3004,اختيارخ وبملت-5000-1400/03/19,10,246,49818000,100,133,250,150,150,203,103,103,133,258
524,ددام,داروسازي زاگرس فارمد پارس,10,250256,5340463040,22000,21340,21340,-660,-3,21930,-70,-0.32,21340,21340
525,ثنور,سرمايه گذاري كوه نور,9,42367,404054079,9731,9537,9537,-194,-1.99,9727,-4,-0.04,9537,9537
526,ضصاد3004,اختيارخ وبصادر-3500-1400/03/12,9,290,5800000,23,20,20,-3,-13.04,20,-3,-13.04,20,20
527,اخزا806,اسنادخزانه-م6بودجه98-000519,9,34397,32536376161,946386,942022,945356,-1030,-0.11,945907,-479,-0.05,942022,946000
528,وسهمدا,شركت س استان همدان,9,94168,81926160,890,870,870,-20,-2.25,890,0,0,870,870
529,برن0003پ01,برنج طارم0003تجارت مازندران(پ),9,988,271775000,274917,274500,275000,83,0.03,275076,159,0.06,274500,275500
530,خلنت,لنت‌ ترمزايران‌,9,9718,591243120,62720,60840,60840,-1880,-3,62700,-20,-0.03,60840,60840
531,شپاس,نفت پاسارگاد,9,8272,172686272,21521,20876,20876,-645,-3,21519,-2,-0.01,20876,20876
532,دلقما,دارويي‌ لقمان‌,9,3467,86987030,25860,25090,25090,-770,-2.98,25860,0,0,25090,25090
533,قصفها,قنداصفهان‌,9,1603,243672030,156710,152010,152010,-4700,-3,156690,-20,-0.01,152010,152010
534,ضملي7002,اختيارخ فملي-10000-1400/07/11,8,174,635200000,3573,3500,3300,-273,-7.64,3651,78,2.18,3300,3900
535,بايكا,كارخانجات كابلسازي ‌ايران‌,8,12383,510191983,42041,41201,41201,-840,-2,42019,-22,-0.05,41201,41201
536,قاسم,قاسم ايران,8,10795,136772650,13061,12670,12670,-391,-2.99,13060,-1,-0.01,12670,12670
537,اخزا906,اسنادخزانه-م6بودجه99-020321,8,4241,3217681900,756298,735000,769900,13602,1.8,758708,2410,0.32,735000,769900
538,ضشنا8004,اختيارخ شپنا-12000-1400/08/16,8,187,299200000,1,1600,1600,1599,159900,1600,1599,159900,1600,1600
539,بنيرو,نيروترانس‌,8,77595,1134438900,15070,14620,14620,-450,-2.99,15060,-10,-0.07,14620,14620
540,ومعلم,بيمه معلم,8,33912,164066256,4987,4838,4838,-149,-2.99,4986,-1,-0.02,4838,4838
541,تكنو,تكنوتار,8,49240,1051766400,22020,21360,21360,-660,-3,22010,-10,-0.05,21360,21360
542,قيستو,شركت قند بيستون,8,605305,11300439045,18303,18669,18669,366,2,18669,366,2,18669,18669
543,غديس,پاكديس,8,5000,65165000,13436,13033,13033,-403,-3,13435,-1,-0.01,13033,13033
544,ضصاد3003,اختيارخ وبصادر-3000-1400/03/12,8,402,15922000,31,35,40,9,29.03,40,9,29.03,35,45
545,فروس,فروسيليس‌ ايران‌,8,42409,217134080,5270,5120,5120,-150,-2.85,5270,0,0,5120,5120
546,تاپكيش,تجارت الكترونيك پارسيان كيش,8,11013,194489580,18206,17660,17660,-546,-3,18204,-2,-0.01,17660,17660
547,لابسا,آبسال‌,8,21987,1130131800,52980,51400,51400,-1580,-2.98,52940,-40,-0.08,51400,51400
548,ضخود7074,اختيارخ خودرو-1800-1400/07/07,8,329,156926000,457,499,480,23,5.03,477,20,4.38,450,499
549,اخزا813,اسنادخزانه-م13بودجه98-010219,7,131,106952981,816483,813511,817001,518,0.06,816435,-48,-0.01,813511,824998
550,وسخوز,شركت س استان خوزستان,7,42490,40365500,970,950,950,-20,-2.06,970,0,0,950,950
551,حتوكا,حمل‌ونقل‌توكا,7,5264,156604000,30660,29750,29750,-910,-2.97,30660,0,0,29750,29750
552,ملت,بيمه ملت,7,6387,96763050,15610,15150,15150,-460,-2.95,15610,0,0,15150,15150
553,فاما,صنعتي‌ آما,7,33555,604325550,18560,18010,18010,-550,-2.96,18550,-10,-0.05,18010,18010
554,خزر,فنرسازي‌زر,7,2611,120523760,47580,46160,46160,-1420,-2.98,47580,0,0,46160,46160
555,اخزا914,اسنادخزانه-م14بودجه99-021025,7,7951,4611724306,580418,580000,580012,-406,-0.07,580018,-400,-0.07,580000,580100
556,مرقام,ايران‌ارقام‌,7,10461,198131340,19520,18940,18940,-580,-2.97,19520,0,0,18940,18940
557,كهرام,توليدي گرانيت بهسرام,7,3175,346192475,113580,109037,109037,-4543,-4,113498,-82,-0.07,109037,109037
558,رطب0002پ01,رطب مضافتي0002افشارتعاون بم(پ),7,550,81628000,155278,149500,147515,-7763,-5,148415,-6863,-4.42,147515,149500
559,ضغدر3002,اختيارخ وغدير-8200-1400/03/26,7,83,209480000,2457,2500,2600,143,5.82,2524,67,2.73,2495,2600
560,وگستر,گسترش سرمايه گذاري ايرانيان,7,30417,568980402,19284,18706,18706,-578,-3,19277,-7,-0.04,18706,18706
561,قثابت,قند ثابت‌ خراسان‌,6,4705,308836200,67670,65640,65640,-2030,-3,67660,-10,-0.01,65640,65640
562,عيار2,صندوق س. پشتوانه طلاي مفيد,6,60000,60000,24861,1,1,-24860,-100,1,-24860,-100,1,1
563,وتوكا,سرمايه‌گذاري‌توكافولاد(هلدينگ,6,11357,131741200,11950,11600,11600,-350,-2.93,11950,0,0,11600,11600
564,نمرينو,ايران‌ مرينوس‌,6,1333,146510030,113300,109910,109910,-3390,-2.99,113290,-10,-0.01,109910,109910
565,كسرام,پارس‌ سرام‌,6,6934,56026720,8320,8080,8080,-240,-2.88,8320,0,0,8080,8080
566,ولغدر,ليزينگ‌خودروغدير,6,13000,310310000,24600,23870,23870,-730,-2.97,24600,0,0,23870,23870
567,وآفري,بيمه كارآفرين,6,30225,98442825,3323,3257,3257,-66,-1.99,3323,0,0,3257,3257
568,فمراد,آلومراد,6,4913,685707410,143880,139570,139570,-4310,-3,143820,-60,-0.04,139570,139570
569,داوه,داروسازي آوه سينا,6,13943,273017883,20186,19581,19581,-605,-3,20183,-3,-0.01,19581,19581
570,كسرا,سراميك‌هاي‌صنعتي‌اردكان‌,6,14421,291304200,20820,20200,20200,-620,-2.98,20820,0,0,20200,20200
571,ضپنا2003,اختيارخ رمپنا-16000-1400/02/12,6,68,7211000,228,100,100,-128,-56.14,106,-122,-53.51,100,111
572,نگين,ص.س. زمين و ساختمان نگين شهرري,6,1406,67585050,48470,48450,47540,-930,-1.92,48070,-400,-0.83,47540,48790
573,اخزا911,اسنادخزانه-م11بودجه99-020906,6,698,417234474,595836,594729,597786,1950,0.33,597757,1921,0.32,594729,597808
574,قنيشا,قند  نيشابور,6,6351,410084070,66560,64570,64570,-1990,-2.99,66540,-20,-0.03,64570,64570
575,طلا2,صندوق س.پشتوانه طلاي لوتوس,6,600000,600000,70816,1,1,-70815,-100,1,-70815,-100,1,1
576,اخزا718,اسنادخزانه-م18بودجه97-000525,6,26307,24806793168,945866,943000,942292,-3574,-0.38,942973,-2893,-0.31,942292,943000
577,آگاس2,صندوق س.هستي بخش آگاه-س,6,1000000,1000000,65034,1,1,-65033,-100,1,-65033,-100,1,1
578,كاذر,فرآورده‌هاي‌نسوزآذر,6,1375,43670000,32740,31760,31760,-980,-2.99,32740,0,0,31760,31760
579,اخزا713,اسنادخزانه-م13بودجه97-000518,6,57206,54145364600,945105,945106,947500,2395,0.25,946498,1393,0.15,945106,948000
580,وارس,سرمايه گذاري ارس صبا,6,36589,618793168,17257,16912,16912,-345,-2,17246,-11,-0.06,16912,16912
581,طخود2013,اختيارف خودرو-7000-1400/02/08,6,600,2990000000,1,5000,4900,4899,489900,4983,4982,498200,4900,5000
582,غشصفا,شيرپاستوريزه‌پگاه‌اصفهان‌,6,2301,62495160,28000,27160,27160,-840,-3,28000,0,0,27160,27160
583,دفارا,داروسازي‌ فارابي‌,5,519,32447880,64450,62520,62520,-1930,-2.99,64450,0,0,62520,62520
584,واحصا,احياء صنايع خراسان,5,405,28288035,72757,69847,69847,-2910,-4,72753,-4,-0.01,69847,69847
585,غشوكو,شوكو پارس,5,1708,65407860,39890,38295,38295,-1595,-4,39885,-5,-0.01,38295,38295
586,دبالك,مواد اوليه دارويي البرز بالك,5,9188,185625164,20827,20203,20203,-624,-3,20825,-2,-0.01,20203,20203
587,آبين,كشت و صنعت آبشيرين,5,24826,102506554,4213,4129,4129,-84,-1.99,4212,-1,-0.02,4129,4129
588,زعف0008پ09,زعفران0008نگين نوين(پ),5,1628,212215926,130123,129993,128120,-2003,-1.54,130354,231,0.18,128120,131000
589,دسينا,داروسازي‌ سينا,5,3310,76659600,23870,23160,23160,-710,-2.97,23870,0,0,23160,23160
590,پخش,پخش البرز,5,2497,77541838,32014,31054,31054,-960,-3,32012,-2,-0.01,31054,31054
591,بالاس,مهندسي ساختمان تاسيسات راه آهن,5,1438,80467604,57688,55958,55958,-1730,-3,57685,-3,-0.01,55958,55958
592,پست0008پ08,پسته فندقي32-30مه ولات0008(پ),5,33,52428033,1603333,1551605,1643997,40664,2.54,1588728,-14605,-0.91,1551605,1649990
593,فسا,پتروشيمي فسا,5,17635,30614360,1771,1736,1736,-35,-1.98,1771,0,0,1736,1736
594,فرآور,فرآوري‌موادمعدني‌ايران‌,5,3290,111991600,35090,34040,34040,-1050,-2.99,35090,0,0,34040,34040
595,غشهد,شهد ايران ‌,5,10742,75838520,7270,7060,7060,-210,-2.89,7270,0,0,7060,7060
596,خنصير,مهندسي‌نصيرماشين‌,5,2783,292910750,108500,105250,105250,-3250,-3,108480,-20,-0.02,105250,105250
597,آينده,بازرگاني آينده سازان بهشت پارس,5,4325,82469100,19862,19068,19068,-794,-4,19859,-3,-0.02,19068,19068
598,ضخود2007,اختيارخ خودرو-3000-1400/02/08,5,306,306000,1,1,1,0,0,1,0,0,1,1
599,دشيمي,شيمي‌ داروئي‌ داروپخش‌,5,1306,38696780,30540,29630,29630,-910,-2.98,30540,0,0,29630,29630
600,غالبر,لبنيات‌ كالبر,5,10187,199868940,20220,19620,19620,-600,-2.97,20220,0,0,19620,19620
601,دسانكو,داروسازي سبحان انكولوژي,5,6895,98922565,14790,14347,14347,-443,-3,14789,-1,-0.01,14347,14347
602,غنوش,نوش‌ مازندران‌,5,3487,192377790,56870,55170,55170,-1700,-2.99,56860,-10,-0.02,55170,55170
603,اخزا808,اسنادخزانه-م8بودجه98-000817,5,734,660487610,899410,900000,899205,-205,-0.02,899847,437,0.05,899205,900000
604,تپمپي,پمپ‌ سازي‌ ايران‌,5,4071,76656930,19410,18830,18830,-580,-2.99,19410,0,0,18830,18830
605,خاذين,سايپاآذين‌,5,28231,130144910,4750,4610,4610,-140,-2.95,4750,0,0,4610,4610
606,گكيش,توريستي ورفاهي آبادگران كيش,5,25687,1221519598,48524,47554,47554,-970,-2,48463,-61,-0.13,47554,47554
607,شتوكا,توكا رنگ فولاد سپاهان,5,855,44094915,53168,51573,51573,-1595,-3,53167,-1,0,51573,51573
608,توريل,توکاريل,5,7973,193464845,25015,24265,24265,-750,-3,25012,-3,-0.01,24265,24265
609,ضغدر3003,اختيارخ وغدير-9200-1400/03/26,4,130,232100000,1796,1735,1800,4,0.22,1785,-11,-0.61,1735,1800
610,وسكرد,شركت س استان كردستان,4,118313,84002230,730,710,710,-20,-2.74,730,0,0,710,710
611,قشكر,شكرشاهرود,4,15610,58225300,3840,3730,3730,-110,-2.86,3840,0,0,3730,3730
612,ضترا3002,اختيارخ شتران-8000-1400/03/09,4,20,16105000,1159,500,1000,-159,-13.72,805,-354,-30.54,500,1000
613,حآسا,آسيا سير ارس,4,1176,51205392,44888,43542,43542,-1346,-3,44887,-1,0,43542,43542
614,غبشهر,صنعتي‌ بهشهر,4,2128,52284960,25320,24570,24570,-750,-2.96,25320,0,0,24570,24570
615,اخزا720,اسنادخزانه-م20بودجه97-000324,4,437,426514221,976000,976007,976005,5,0,976005,5,0,976005,976007
616,زكوثر,سرمايه گذاري كشاورزي كوثر,4,2840,59668400,21650,21010,21010,-640,-2.96,21650,0,0,21010,21010
617,اراد61,مرابحه عام دولت61-ش.خ0309,4,100000,100000000000,1000000,1000000,1000000,0,0,1000000,0,0,1000000,1000000
618,اخزا816,اسنادخزانه-م16بودجه98-010503,4,114,89171974,789113,778000,783000,-6113,-0.77,782210,-6903,-0.87,778000,787000
619,وسنا,سرمايه گذاري نيروگاهي ايران,4,3684,55495776,15691,15064,15064,-627,-4,15689,-2,-0.01,15064,15064
620,كفرا,فراورده‌ هاي‌ نسوزايران‌,4,2013,92577870,47410,45990,45990,-1420,-3,47410,0,0,45990,45990
621,چكاوه,صنايع‌كاغذسازي‌كاوه‌,4,12424,222016880,18420,17870,17870,-550,-2.99,18420,0,0,17870,17870
622,اخزا804,اسنادخزانه-م4بودجه98-000421,4,69,66136113,959999,958116,960296,297,0.03,958494,-1505,-0.16,958115,960296
623,سيمرغ,سيمرغ,4,6569,116468370,18270,17730,17730,-540,-2.96,18270,0,0,17730,17730
624,غشان,شيرپاستوريزه‌پگاه‌خراسان‌,4,7523,56121580,7690,7460,7460,-230,-2.99,7690,0,0,7460,7460
625,ضپاس2005,اختيارخ وپارس-4500-1400/02/29,4,15,19000,6,1,1,-5,-83.33,1,-5,-83.33,1,2
626,خوساز,محورسازان‌ايران‌خودرو,4,4896,38090880,8020,7780,7780,-240,-2.99,8020,0,0,7780,7780
627,غفارس,شير پاستوريزه پگاه فارس,4,16241,288911149,18339,17789,17789,-550,-3,18336,-3,-0.02,17789,17789
628,ضسپا3001,اختيارخ خساپا-1600-1400/03/26,4,114,36374000,457,382,310,-147,-32.17,319,-138,-30.2,310,382
629,وآوا,سرمايه گذاري آوا نوين,4,7321,63158267,8893,8627,8627,-266,-2.99,8893,0,0,8627,8627
630,غدام,خوراك‌  دام‌ پارس‌,4,480,183758400,394660,382830,382830,-11830,-3,394620,-40,-0.01,382830,382830
631,غمينو,شركت صنايع غذايي مينو شرق,4,10319,114417072,11430,11088,11088,-342,-2.99,11429,-1,-0.01,11088,11088
632,ضفلا3005,اختيارخ فولاد-9986-1400/03/19,4,126,57964000,449,489,100,-349,-77.73,460,11,2.45,100,495
633,اخزا820,اسنادخزانه-م20بودجه98-020806,4,30427,18509616000,604647,608000,609000,4353,0.72,608329,3682,0.61,608000,609000
634,زقيام,كشت و دام قيام اصفهان,4,6855,192632355,28970,28101,28101,-869,-3,28967,-3,-0.01,28101,28101
635,افران2,صندوق س افرا نماد پايدار-ثابت,4,3200000,3200000,13179,1,1,-13178,-99.99,1,-13178,-99.99,1,1
636,ضملت3000,اختيارخ وبملت-3000-1400/03/19,4,20,31956000,1444,1666,1300,-144,-9.97,1598,154,10.66,1300,1700
637,ضملي3004,اختيارخ فملي-14000-1400/03/02,4,80,19450000,181,200,345,164,90.61,243,62,34.25,200,345
638,كمينا,شيشه سازي مينا,4,1370,33088240,25158,24152,24152,-1006,-4,25156,-2,-0.01,24152,24152
639,ضملي3001,اختيارخ فملي-9000-1400/03/02,4,25,79545000,3000,3450,3000,0,0,3182,182,6.07,3000,3450
640,وهنر,گروه توسعه هنر ايران,4,161868,1326508260,8362,8195,8195,-167,-2,8351,-11,-0.13,8195,8195
641,تكشا,گسترش‌صنايع‌وخدمات‌كشاورزي‌,4,798,35981820,46480,45090,45090,-1390,-2.99,46480,0,0,45090,45090
642,غشاذر,پگاه‌آذربايجان‌غربي‌,3,1071,10388700,10000,9700,9700,-300,-3,10000,0,0,9700,9700
643,خموتور,موتورسازان‌تراكتورسازي‌ايران‌,3,55000,799700000,14980,14540,14540,-440,-2.94,14970,-10,-0.07,14540,14540
644,پلاسك,پلاسكوكار,3,3600,26100000,7470,7250,7250,-220,-2.95,7470,0,0,7250,7250
645,ثپرديس,سرمايه گذاري مسكن پرديس,3,2055,20254080,10160,9856,9856,-304,-2.99,10160,0,0,9856,9856
646,تملي807,تسهيلات مسكن ب. ملي-مهر98,3,19,11688716,630119,630119,598614,-31505,-5,615196,-14923,-2.37,598614,630119
647,سخواف,سيمان مجد خواف,3,6235,102939850,16846,16510,16510,-336,-1.99,16844,-2,-0.01,16510,16510
648,غمارگ,مارگارين‌,3,2552,77836000,31440,30500,30500,-940,-2.99,31440,0,0,30500,30500
649,ضشنا2004,اختيارخ شپنا-16000-1400/02/27,3,3,64000,47,12,40,-7,-14.89,21,-26,-55.32,12,40
650,تكنار,مجتمع معادن مس تكنار,3,227,26162204,117604,115252,115252,-2352,-2,117601,-3,0,115252,115252
651,وساشرقي,شركت س استان آذربايجان شرقي,3,17500,16625000,970,950,950,-20,-2.06,970,0,0,950,950
652,تشتاد,صنايع توليدي اشتاد ايران‌,3,6666,102509748,15691,15378,15378,-313,-1.99,15689,-2,-0.01,15378,15378
653,وسكرمان,س.سهام عدالت استان كرمان,3,15167,15167000,1030,1000,1000,-30,-2.91,1030,0,0,1000,1000
654,اپرداز,آتيه داده پرداز,3,2140,44278740,21330,20691,20691,-639,-3,21329,-1,0,20691,20691
655,زنگان,صنعت روي زنگان,3,750,76008750,104479,101345,101345,-3134,-3,104474,-5,0,101345,101345
656,اوان,مبين وان كيش,3,378,20029086,54625,52987,52987,-1638,-3,54624,-1,0,52987,52987
657,ضپاس2003,اختيارخ وپارس-3500-1400/02/29,3,3,69000,5,23,23,18,360,23,18,360,23,23
658,شرق1400,مشاركت ليزينگ ايران وشرق140010,3,24,23995380,1008000,999800,999820,-8180,-0.81,999807,-8193,-0.81,999800,999820
659,مفاخر,توسعه فناوري اطلاعات خوارزمي,3,161,10128188,64853,62908,62908,-1945,-3,64853,0,0,62908,62908
660,ضصاد3000,اختيارخ وبصادر-1800-1400/03/12,3,51,33130000,550,650,630,80,14.55,650,100,18.18,630,650
661,خكمك,كمك‌فنرايندامين‌,3,2990,78696800,27130,26320,26320,-810,-2.99,27130,0,0,26320,26320
662,ضفلا3004,اختيارخ فولاد-8560-1400/03/19,3,40,49100000,1017,1460,1150,133,13.08,1227,210,20.65,1150,1460
663,آ س پ,آ.س.پ,3,7500,117397500,16137,15653,15653,-484,-3,16136,-1,-0.01,15653,15653
664,فولاي,صنايع فولاد آلياژي يزد,3,2103,103694724,50832,49308,49308,-1524,-3,50829,-3,-0.01,49308,49308
665,سنير,سيمان‌ سفيد ني‌ريز,3,79,19110890,249390,241910,241910,-7480,-3,249390,0,0,241910,241910
666,ضچاد7031,اختيارخ كچاد-16000-1400/07/04,3,5,43900000,1,9000,8500,8499,849900,8780,8779,877900,8500,9000
667,سبهان,سيمان‌ بهبهان‌,3,127,17517110,142190,137930,137930,-4260,-3,142190,0,0,137930,137930
668,فجام,جام‌دارو,3,7882,79056460,10330,10030,10030,-300,-2.9,10330,0,0,10030,10030
669,ضشنا8001,اختيارخ شپنا-8000-1400/08/16,3,14,60200000,4400,4300,4300,-100,-2.27,4300,-100,-2.27,4300,4300
670,اشاد10,مشاركت دولتي10-شرايط خاص001226,3,3800,3622699900,962333,941500,964000,1667,0.17,953342,-8991,-0.93,941500,964000
671,كسعدي,كاشي‌ سعدي‌,3,761,15767920,21360,20720,20720,-640,-3,21360,0,0,20720,20720
672,كساوه,صنايع‌ كاشي‌ و سراميك‌ سينا,3,680,46546000,70560,68450,68450,-2110,-2.99,70560,0,0,68450,68450
673,صينا205,صكوك منفعت سينا دارو-3ماهه 19%,3,4469,4334930000,990000,970000,970000,-20000,-2.02,970000,-20000,-2.02,970000,970000
674,داراب,پتروشيمي داراب,3,6500,15613000,2451,2402,2402,-49,-2,2451,0,0,2402,2402
675,ضبدر3001,اختيارخ شبندر-16000-1400/03/30,3,3,20664000,10000,6888,6888,-3112,-31.12,6888,-3112,-31.12,6888,6888
676,غاذر,كشت‌وصنعت‌پياذر,3,585,31747950,55940,54270,54270,-1670,-2.99,55940,0,0,54270,54270
677,اخزا805,اسنادخزانه-م5بودجه98-000422,2,11481,11004559500,961556,958500,962000,444,0.05,958502,-3054,-0.32,958500,962000
678,ضسپا3000,اختيارخ خساپا-1400-1400/03/26,2,15,7700000,599,500,600,1,0.17,513,-86,-14.36,500,600
679,كهمداح,ح . شيشه‌ همدان‌,2,2750,21175000,7700,7700,7700,0,0,7700,0,0,7700,7700
680,شفا,سرمايه گذاري شفادارو,2,447,20186520,46550,45160,45160,-1390,-2.99,46550,0,0,45160,45160
681,دروز,داروسازي‌ روزدارو,2,3007,103681360,35540,34480,34480,-1060,-2.98,35540,0,0,34480,34480
682,سفار,سيمان‌فارس‌,2,3570,531216000,153400,148800,148800,-4600,-3,153350,-50,-0.03,148800,148800
683,اخزا721,اسنادخزانه-م21بودجه97-000728,2,1893,1723745094,908000,907402,914158,6158,0.68,910589,2589,0.29,907402,914158
684,ضخود7073,اختيارخ خودرو-1600-1400/07/07,2,41,29930000,610,730,730,120,19.67,730,120,19.67,730,730
685,قمرو,قند مرودشت‌,2,344,12342720,36980,35880,35880,-1100,-2.97,36980,0,0,35880,35880
686,كترام,توليدي‌ كاشي‌ تكسرام‌,2,951,44773080,48530,47080,47080,-1450,-2.99,48530,0,0,47080,47080
687,چافست,افست‌,2,1560,25131600,16600,16110,16110,-490,-2.95,16600,0,0,16110,16110
688,ضپنا2000,اختيارخ رمپنا-10000-1400/02/12,2,2,11700000,6550,6000,5700,-850,-12.98,5850,-700,-10.69,5700,6000
689,كاسپين,داروسازي كاسپين تامين,2,150000,3768450000,25900,25123,25123,-777,-3,25839,-61,-0.24,25123,25123
690,قجام,فرآوردههاي غذايي وقندتربت‌جام‌,2,2111,34065207,16466,16137,16137,-329,-2,16465,-1,-0.01,16137,16137
691,حخزر,كشتيراني درياي خزر,2,100000,2789700000,28759,27897,27897,-862,-3,28709,-50,-0.17,27897,27897
692,ضملي3000,اختيارخ فملي-8000-1400/03/02,2,11,43853000,3991,4000,3853,-138,-3.46,3987,-4,-0.1,3853,4000
693,ضشنا2000,اختيارخ شپنا-9000-1400/02/27,2,2,3554000,2030,1777,1777,-253,-12.46,1777,-253,-12.46,1777,1777
694,دجابر,داروسازي‌ جابرابن‌حيان‌,2,1253,24608920,20240,19640,19640,-600,-2.96,20240,0,0,19640,19640
695,وساغربي,شركت س استان آذربايجان غربي,2,16854,12640500,770,750,750,-20,-2.6,770,0,0,750,750
696,حرهشا,رهشاد سپاهان (سهامي عام,2,209,13289265,64882,63585,63585,-1297,-2,64880,-2,0,63585,63585
697,ثجوان,تامين مسكن جوانان,2,1000,10663000,11107,10663,10663,-444,-4,11107,0,0,10663,10663
698,ضمخا2000,اختيارخ اخابر-9000-1400/02/29,2,100,85000000,1000,850,850,-150,-15,850,-150,-15,850,850
699,وسينا2,بانك سينا,2,253000000,733700000000,2810,2900,2900,90,3.2,2900,90,3.2,2900,2900
700,سيلام,سيمان‌ ايلام‌,2,1210,13152700,11200,10870,10870,-330,-2.95,11200,0,0,10870,10870
701,ولراز,ليزينگ رازي,2,209,11251097,56076,53833,53833,-2243,-4,56075,-1,0,53833,53833
702,ثغرب,شركت سرمايه گذاري مسكن شمالغرب,2,1450,11199800,7962,7724,7724,-238,-2.99,7962,0,0,7724,7724
703,نهال2,صندوق س. طلاي سرخ نوويرا,2,200000,200000,9814,1,1,-9813,-99.99,1,-9813,-99.99,1,1
704,گواهي ظرفيت,گواهي ظرفيت نقدي,2,1450000,21700700000,14966,14966,14966,0,0,14966,0,0,14966,14966
705,حپترو,حمل و نقل پتروشيمي( سهامي عام,2,195,10198500,53910,52300,52300,-1610,-2.99,53910,0,0,52300,52300
706,ثعمرا,عمران و توسعه شاهد,2,872,11038648,13050,12659,12659,-391,-3,13050,0,0,12659,12659
707,زعف0008پ12,زعفران0008پوشالمعمول سحرخيز(پ),2,135,12495600,95563,91000,94900,-663,-0.69,92560,-3003,-3.14,91000,94900
708,ضپنا2004,اختيارخ رمپنا-18000-1400/02/12,2,10,54000,76,6,5,-71,-93.42,5,-71,-93.42,5,6
709,اخزا716,اسنادخزانه-م16بودجه97-000407,2,405,391311810,969046,966202,966202,-2844,-0.29,966202,-2844,-0.29,966202,966202
710,سنفت001,سلف موازي استاندارد سنفت001,2,17520,20016056880,1141497,1142469,1142469,972,0.09,1142469,972,0.09,1142469,1142469
711,فسديد,لوله‌وتجهيزات‌ سديد - ورشكسته,2,640,70793600,112872,110615,110615,-2257,-2,112839,-33,-0.03,110615,110615
712,پست0008پ04,پسته فندقي32-30سبزدانه0008(پ),2,33,50542965,1612214,1531605,1531605,-80609,-5,1531605,-80609,-5,1531605,1531605
713,رتكو,كنترل‌خوردگي‌تكين‌كو,2,790,13848700,18070,17530,17530,-540,-2.99,18070,0,0,17530,17530
714,زماهان,مجتمع توليد گوشت مرغ ماهان,2,733,14647539,20601,19983,19983,-618,-3,20601,0,0,19983,19983
715,اخزا807,اسنادخزانه-م7بودجه98-000719,2,1066,974838000,911052,914217,918500,7448,0.82,914482,3430,0.38,914217,918500
716,زمگسا,كشاورزي‌ ودامپروي‌ مگسال‌,2,360,11347200,32490,31520,31520,-970,-2.99,32490,0,0,31520,31520
717,ضبدر3003,اختيارخ شبندر-20000-1400/03/30,2,22,78740000,3538,3600,3370,-168,-4.75,3579,41,1.16,3370,3600
718,ضپاس2000,اختيارخ وپارس-2000-1400/02/29,2,32,15668000,516,490,489,-27,-5.23,490,-26,-5.04,489,490
719,نبروج,نساجي بروجرد,2,5571,33036030,5814,5930,5930,116,2,5814,0,0,5930,5930
720,سصفها,سيمان‌اصفهان‌,2,407,50130190,126970,123170,123170,-3800,-2.99,126970,0,0,123170,123170
721,زنجان,صنايع كشاورزي وكود زنجان,2,10598,97109474,9350,9163,9163,-187,-2,9349,-1,-0.01,9163,9163
722,وپسا,س. پتروشيمي ساختمان  خليج فارس,2,12000,35364000,3007,2947,2947,-60,-2,3007,0,0,2947,2947
723,داسوه,داروسازي‌ اسوه‌,2,299,10829780,37330,36220,36220,-1110,-2.97,37330,0,0,36220,36220
724,تملي701,تسهيلات مسكن ب. ملي-فروردين97,2,29,17762336,610175,625000,579667,-30508,-5,612494,2319,0.38,579667,625000
725,سخزر,سيمان‌ خزر,2,582,17198100,30460,29550,29550,-910,-2.99,30460,0,0,29550,29550
726,وسفارس,شركت س استان فارس,2,6700,6700000,1030,1000,1000,-30,-2.91,1030,0,0,1000,1000
727,قشير,قند شيروان قوچان و بجنورد,2,700,17439800,25684,24914,24914,-770,-3,25684,0,0,24914,24914
728,غبهار,كشت وصنعت بهاران گلبهار خراسان,2,161,5393017,34180,33497,33497,-683,-2,34180,0,0,33497,33497
729,پاسا,ايران‌ياساتايرورابر,2,546,14130480,26680,25880,25880,-800,-3,26680,0,0,25880,25880
730,فنرژي,گسترش صنايع انرژي آذرآب,2,540,10058040,19006,18626,18626,-380,-2,19006,0,0,18626,18626
731,دشيري,شيرين دارو,2,75,17348850,236038,231318,231318,-4720,-2,236034,-4,0,231318,231318
732,ضمخا7066,اختيارخ اخابر-12000-1400/07/28,2,12,13440000,1019,1120,1120,101,9.91,1120,101,9.91,1120,1120
733,چفيبر,فيبر ايران‌,2,1748,23528080,13870,13460,13460,-410,-2.96,13870,0,0,13460,13460
734,ضصاد3002,اختيارخ وبصادر-2500-1400/03/12,2,100,14900000,166,170,100,-66,-39.76,149,-17,-10.24,100,170
735,نطرين,عطرين نخ قم,2,1465,17240120,12131,11768,11768,-363,-2.99,12131,0,0,11768,11768
736,ثامان,سامان‌ گستراصفهان‌,2,2230,51713700,23900,23190,23190,-710,-2.97,23900,0,0,23190,23190
737,سبجنو,سيمان‌ بجنورد,2,90,5187600,59420,57640,57640,-1780,-3,59420,0,0,57640,57640
738,سكرد,سيمان كردستان,2,1200,11400000,9790,9500,9500,-290,-2.96,9790,0,0,9500,9500
739,لخزر,پارس‌ خزر,2,178,32200200,186490,180900,180900,-5590,-3,186490,0,0,180900,180900
740,اخزا9082,اسنادخزانه-م8بودجه99-020606,2,1200000,742332000000,627487,618610,618610,-8877,-1.41,618610,-8877,-1.41,618610,618610
741,لخانه,لوازم‌ خانگي‌ پارس‌,2,400,10742400,27974,26856,26856,-1118,-4,27973,-1,0,26856,26856
742,تملي702,تسهيلات مسكن ب. ملي-ارديبهشت97,2,13,6396000,510338,492000,492000,-18338,-3.59,492000,-18338,-3.59,492000,492000
743,كمرجان,بازرگاني و توليدي مرجان كار,2,97,13824925,146932,142525,142525,-4407,-3,146931,-1,0,142525,142525
744,وسرضوي,س.سهام عدالت استان خراسان رضوي,2,9800,9800000,1030,1000,1000,-30,-2.91,1030,0,0,1000,1000
745,پرداخت,به پرداخت ملت,2,1001,31721690,32670,31690,31690,-980,-3,32670,0,0,31690,31690
746,ثاباد,توريستي ورفاهي آبادگران ايران,2,3000,157770000,54210,52590,52590,-1620,-2.99,54200,-10,-0.02,52590,52590
747,فلات,گروه صنايع معادن فلات ايرانيان,2,998,15302334,15645,15333,15333,-312,-1.99,15645,0,0,15333,15333
748,اراد51,مرابحه عام دولت5-ش.خ 0010,1,1000,980000000,989667,980000,980000,-9667,-0.98,980000,-9667,-0.98,980000,980000
749,وسيلام,شركت س استان ايلام,1,10000,12100000,1240,1210,1210,-30,-2.42,1240,0,0,1210,1210
750,گپارس,امور رفاهي كارگزاران پارس,1,26,5316454,208652,204479,204479,-4173,-2,208651,-1,0,204479,204479
751,سايرا,ايرانيت‌,1,122,5026644,42918,41202,41202,-1716,-4,42917,-1,0,41202,41202
752,افاد82,منفعت دولت8-ش.خاص لوتوس0205,1,5000,4200000000,830000,840000,840000,10000,1.2,840000,10000,1.2,840000,840000
753,فولاد2,فولاد مباركه اصفهان,1,9000000,116100000000,12660,12900,12900,240,1.9,12900,240,1.9,12900,12900
754,خفناور,مهندسي صنعتي روان فن آور,1,145,6882135,48431,47463,47463,-968,-2,48431,0,0,47463,47463
755,آريان2,سرمايه گذاري پارس آريان,1,15000000,148065000000,9858,9871,9871,13,0.13,9871,13,0.13,9871,9871
756,وغدير2,سرمايه‌گذاري‌غدير(هلدينگ‌,1,18620000,189924000000,10200,10200,10200,0,0,10200,0,0,10200,10200
757,پلاست,كارخانجات توليدي پلاستيران,1,100,7033900,71774,70339,70339,-1435,-2,71773,-1,0,70339,70339
758,افرا,افرانت,1,1222,40653496,34296,33268,33268,-1028,-3,34295,-1,0,33268,33268
759,شزنگ,تجهيزنيروي‌زنگان‌,1,238,54712154,234574,229883,229883,-4691,-2,234561,-13,-0.01,229883,229883
760,طخود2005,اختيارف خودرو-2000-1400/02/08,1,50,500000,104,10,10,-94,-90.38,10,-94,-90.38,10,10
761,ثعتما,س. ساختماني اعتماد گستر,1,100,6582800,67171,65828,65828,-1343,-2,67171,0,0,65828,65828
762,غگلستا,شير پاستوريزه پگاه گلستان,1,183,5062695,28520,27665,27665,-855,-3,28520,0,0,27665,27665
763,دقاضي,داروسازي شهيد قاضي,1,124,5255492,43247,42383,42383,-864,-2,43247,0,0,42383,42383
764,سدبير,س. تدبيرگران فارس وخوزستان,1,2000,173468000,89416,86734,86734,-2682,-3,89406,-10,-0.01,86734,86734
765,بالبر,كابل‌ البرز,1,600,34380000,59070,57300,57300,-1770,-3,59070,0,0,57300,57300
766,ساذري,آذريت‌,1,50,301200,5849,6024,6024,175,2.99,5849,0,0,6024,6024
767,كقزوي,شيشه‌ قزوين‌,1,506,5079228,10242,10038,10038,-204,-1.99,10242,0,0,10038,10038
768,سميعا002,سلف موازي استاندارد سميعا002,1,46400,60010697600,1292202,1293334,1293334,1132,0.09,1293334,1132,0.09,1293334,1293334
769,داريك,صندوق س.اعتماد داريك-د,1,50,527350,10545,10547,10547,2,0.02,10547,2,0.02,10547,10547
770,ضغدر3000,اختيارخ وغدير-6200-1400/03/26,1,66,264000000,4183,4000,4000,-183,-4.37,4000,-183,-4.37,4000,4000
771,ضملي3008,اختيارخ فملي-24000-1400/03/02,1,1,22000,11,22,22,11,100,22,11,100,22,22
772,وسكهبو,س.عدالت ا. كهگيلويه وبويراحمد,1,4751,5226100,1130,1100,1100,-30,-2.65,1130,0,0,1100,1100
773,افاد84,منفعت دولت8-ش.خاص ساير0205,1,1000,970000000,924000,970000,970000,46000,4.98,970000,46000,4.98,970000,970000
774,وپاسار2,بانك  پاسارگاد,1,145000000,2032900000000,13700,14020,14020,320,2.34,14020,320,2.34,14020,14020
775,وسصفا,شركت س استان اصفهان,1,5000,5200000,1070,1040,1040,-30,-2.8,1070,0,0,1040,1040
776,خعمرا,توسعه و عمران شهرستان نائين,1,600,14322000,22734,23870,23870,1136,5,22735,1,0,23870,23870
777,ثشرق,سرمايه گذاري مسكن شمال شرق,1,750,5017500,6890,6690,6690,-200,-2.9,6890,0,0,6690,6690
778,ضترا3000,اختيارخ شتران-6000-1400/03/09,1,1,2780000,2601,2780,2780,179,6.88,2780,179,6.88,2780,2780
779,زكشت,كشاورزي مكانيزه اصفهان كشت,1,129,5051769,40372,39161,39161,-1211,-3,40372,0,0,39161,39161
780,شفن2,پتروشيمي فناوران,1,63000,20084400000,318420,318800,318800,380,0.12,318800,380,0.12,318800,318800
781,سپ2,پرداخت الكترونيك سامان كيش,1,24000000,497040000000,20710,20710,20710,0,0,20710,0,0,20710,20710
782,وساربيل,شركت س استان اردبيل,1,6000,7500000,1280,1250,1250,-30,-2.34,1280,0,0,1250,1250
783,خپويش,سازه‌ پويش‌,1,1702,99601040,60320,58520,58520,-1800,-2.98,60320,0,0,58520,58520
784,وحافظ,بيمه حافظ,1,160,10318080,65804,64488,64488,-1316,-2,65803,-1,0,64488,64488
785,تملي612,تسهيلات مسكن بانك ملي-اسفند96,1,10,5477920,576623,547792,547792,-28831,-5,547792,-28831,-5,547792,547792
786,لپيام,گسترش صنايع پيام,1,100,5377800,54875,53778,53778,-1097,-2,54875,0,0,53778,53778
787,پست0008پ02,پسته فندقي32-30طلاسبززرند0008,1,4,6126416,1744696,1531604,1531604,-213092,-12.21,1531604,-213092,-12.21,1531604,1531604
788,ساراب2,سيمان‌ داراب‌,1,7290000,148059900000,20390,20310,20310,-80,-0.39,20310,-80,-0.39,20310,20310
789,غدشت,دشت‌ مرغاب‌,1,71,19846630,288170,279530,279530,-8640,-3,288170,0,0,279530,279530
790,وايران,ليزينگ ايرانيان,1,1000,12210000,12580,12210,12210,-370,-2.94,12580,0,0,12210,12210
791,اراد63,مرابحه عام دولت63-ش.خ0309,1,600,600000000,1000000,1000000,1000000,0,0,1000000,0,0,1000000,1000000
792,اراد414,مرابحه عام دولت4-ش.خ 0006,1,360000,357300000000,992500,992500,992500,0,0,992500,0,0,992500,992500
793,زير0003پ04,زيره سبز0003شركت مينوبذر(پ),1,230,123165460,510002,535502,535502,25500,5,535502,25500,5,535502,535502
794,فالوم,آلومتك‌,1,144,5123376,36305,35579,35579,-726,-2,36305,0,0,35579,35579
795,وليز,ليزينگ‌ايران‌,1,1100,10186000,9540,9260,9260,-280,-2.94,9540,0,0,9260,9260
796,پارسان2,گسترش نفت و گاز پارسيان,1,10000000,189900000000,18990,18990,18990,0,0,18990,0,0,18990,18990
797,وسيستا,شركت س استان سيستان وبلوچستان,1,9589,7095860,760,740,740,-20,-2.63,760,0,0,740,740
798,ضپيك7042,اختيارخ تاپيكو-10000-00/07/18,1,20,44000000,2200,2200,2200,0,0,2200,0,0,2200,2200
799,حسير,ريل سير كوثر,1,300,5063700,17401,16879,16879,-522,-3,17401,0,0,16879,16879
800,سلامت6,مرابحه سلامت6واجدشرايط خاص1400,1,9100,9054500000,995000,995000,995000,0,0,995000,0,0,995000,995000
801,ضسپا3006,اختيارخ خساپا-3500-1400/03/26,1,10,220000,26,22,22,-4,-15.38,22,-4,-15.38,22,22
802,قهكمت,قندهكمتان‌,1,1250,55875000,46080,44700,44700,-1380,-2.99,46080,0,0,44700,44700
803,شتهران,داروسازي تهران شيمي,1,7000,56112000,7708,8016,8016,308,4,7710,2,0.03,8016,8016
804,ثنوسا,نوسازي‌وساختمان‌تهران‌,1,400,5044000,13000,12610,12610,-390,-3,13000,0,0,12610,12610
805,اراد42,مرابحه عام دولت4-ش.خ 0106,1,10000,10075000000,1056250,1007500,1007500,-48750,-4.62,1007500,-48750,-4.62,1007500,1007500
806,غپونه,نوش پونه مشهد,1,485,8855615,18631,18259,18259,-372,-2,18631,0,0,18259,18259
807,خچرخش,چرخشگر,1,282,5002680,18280,17740,17740,-540,-2.95,18280,0,0,17740,17740
808,اراد55,مرابحه عام دولت5-ش.خ 0209,1,100,97000000,950000,970000,970000,20000,2.11,970000,20000,2.11,970000,970000
809,وتعاون,بيمه  تعاون,1,1000,6183000,6309,6183,6183,-126,-2,6309,0,0,6183,6183
810,ركيش,كارت اعتباري ايران كيش,1,17274,398511180,23780,23070,23070,-710,-2.99,23770,-10,-0.04,23070,23070
811,صخود0004,صكوك رهني خودرو0004- 3ماهه 16%,1,1000,1000000000,985000,1000000,1000000,15000,1.52,1000000,15000,1.52,1000000,1000000
812,خفنر,فنرسازي‌خاور,1,693,5828130,8660,8410,8410,-250,-2.89,8660,0,0,8410,8410
813,سهرمز,سيمان‌هرمزگان‌,1,400,9688000,24960,24220,24220,-740,-2.96,24960,0,0,24220,24220
814,آساميد4,صندوق س.مشترك آسمان اميد -د,1,41700000,498273300000,11939,11949,11949,10,0.08,11949,10,0.08,11949,11949
815,ضخوز7038,اختيارخ فخوز-14000-1400/07/14,1,2,9000000,1,4500,4500,4499,449900,4500,4499,449900,4500,4500
816,فلامي,لاميران‌,1,5000,217450000,44830,43490,43490,-1340,-2.99,44820,-10,-0.02,43490,43490
817,مبين016,اجاره اعتماد مبين اميد011019,1,1000,960000000,945000,960000,960000,15000,1.59,960000,15000,1.59,960000,960000
818,ثنظام,س. ساختماني نظام مهندسي ايران,1,109,5068500,47448,46500,46500,-948,-2,47448,0,0,46500,46500
819,غچين,كشت‌ و صنعت‌ چين‌ چين,1,350,6741000,19850,19260,19260,-590,-2.97,19850,0,0,19260,19260
820,غپآذر,شير پگاه آذربايجان شرقي,1,1,63767,65739,63767,63767,-1972,-3,65739,0,0,63767,63767
821,ثتوسا,س.توسعه و عمران استان اردبيل,1,137,5339849,39772,38977,38977,-795,-2,39772,0,0,38977,38977
822,ضفار3002,اختيارخ فارس-10000-1400/03/05,1,1,10000,201,10,10,-191,-95.02,10,-191,-95.02,10,10
823,ثاژن,سخت آژند,1,600,5587200,9699,9312,9312,-387,-3.99,9699,0,0,9312,9312
824,سپيدما4,صندوق س. سپيد دماوند-د,1,15000000,153405000000,10221,10227,10227,6,0.06,10227,6,0.06,10227,10227
825,سنوين,سرمايه گذاري اقتصاد نوين,1,1000,8959000,9141,8959,8959,-182,-1.99,9141,0,0,8959,8959
826,قشهد,شهد,1,255,5054100,20430,19820,19820,-610,-2.99,20430,0,0,19820,19820
827,بساما2,بيمه سامان,1,19000000,437912000000,23048,23048,23048,0,0,23048,0,0,23048,23048
